STNAME,CTYNAME,AGEGRP,TOT_POP,TOT_MALE,TOT_FEMALE
Alabama,Autauga County,0,55601,26995,28606
Alabama,Autauga County,1,3364,1728,1636
Alabama,Autauga County,2,3423,1779,1644
Alabama,Autauga County,3,3882,1977,1905
Alabama,Autauga County,4,3755,1913,1842
Alabama,Autauga County,5,3173,1629,1544
Alabama,Autauga County,6,3705,1830,1875
Alabama,Autauga County,7,3461,1659,1802
Alabama,Autauga County,8,3628,1767,1861
Alabama,Autauga County,9,3616,1717,1899
Alabama,Autauga County,10,3966,1912,2054
Alabama,Autauga County,11,3811,1845,1966
Alabama,Autauga County,12,3927,1956,1971
Alabama,Autauga County,13,3237,1496,1741
Alabama,Autauga County,14,2589,1228,1361
Alabama,Autauga County,15,2311,1019,1292
Alabama,Autauga County,16,1739,724,1015
Alabama,Autauga County,17,1143,487,656
Alabama,Autauga County,18,871,329,542
Alabama,Baldwin County,0,218022,105657,112365
Alabama,Baldwin County,1,11955,6135,5820
Alabama,Baldwin County,2,12802,6519,6283
Alabama,Baldwin County,3,13981,7049,6932
Alabama,Baldwin County,4,12932,6398,6534
Alabama,Baldwin County,5,11108,5632,5476
Alabama,Baldwin County,6,12471,6145,6326
Alabama,Baldwin County,7,12057,5941,6116
Alabama,Baldwin County,8,13156,6318,6838
Alabama,Baldwin County,9,12877,6261,6616
Alabama,Baldwin County,10,14461,7038,7423
Alabama,Baldwin County,11,14242,6817,7425
Alabama,Baldwin County,12,15744,7416,8328
Alabama,Baldwin County,13,15665,7307,8358
Alabama,Baldwin County,14,14267,6622,7645
Alabama,Baldwin County,15,12471,5974,6497
Alabama,Baldwin County,16,8465,3946,4519
Alabama,Baldwin County,17,5064,2384,2680
Alabama,Baldwin County,18,4304,1755,2549
Alabama,Barbour County,0,24881,13133,11748
Alabama,Barbour County,1,1284,656,628
Alabama,Barbour County,2,1448,717,731
Alabama,Barbour County,3,1509,775,734
Alabama,Barbour County,4,1451,759,692
Alabama,Barbour County,5,1472,871,601
Alabama,Barbour County,6,1796,1133,663
Alabama,Barbour County,7,1670,992,678
Alabama,Barbour County,8,1531,923,608
Alabama,Barbour County,9,1450,867,583
Alabama,Barbour County,10,1624,929,695
Alabama,Barbour County,11,1603,847,756
Alabama,Barbour County,12,1675,826,849
Alabama,Barbour County,13,1536,749,787
Alabama,Barbour County,14,1540,701,839
Alabama,Barbour County,15,1337,608,729
Alabama,Barbour County,16,907,401,506
Alabama,Barbour County,17,576,231,345
Alabama,Barbour County,18,472,148,324
Alabama,Bibb County,0,22400,11921,10479
Alabama,Bibb County,1,1285,656,629
Alabama,Bibb County,2,1171,610,561
Alabama,Bibb County,3,1326,711,615
Alabama,Bibb County,4,1270,683,587
Alabama,Bibb County,5,1303,767,536
Alabama,Bibb County,6,1726,994,732
Alabama,Bibb County,7,1601,960,641
Alabama,Bibb County,8,1512,912,600
Alabama,Bibb County,9,1440,796,644
Alabama,Bibb County,10,1598,886,712
Alabama,Bibb County,11,1581,847,734
Alabama,Bibb County,12,1534,801,733
Alabama,Bibb County,13,1363,671,692
Alabama,Bibb County,14,1182,576,606
Alabama,Bibb County,15,992,455,537
Alabama,Bibb County,16,731,323,408
Alabama,Bibb County,17,422,165,257
Alabama,Bibb County,18,363,108,255
Alabama,Blount County,0,57840,28500,29340
Alabama,Blount County,1,3460,1723,1737
Alabama,Blount County,2,3635,1838,1797
Alabama,Blount County,3,3902,1923,1979
Alabama,Blount County,4,3668,1882,1786
Alabama,Blount County,5,3178,1680,1498
Alabama,Blount County,6,3564,1791,1773
Alabama,Blount County,7,3370,1687,1683
Alabama,Blount County,8,3514,1775,1739
Alabama,Blount County,9,3553,1739,1814
Alabama,Blount County,10,3921,1969,1952
Alabama,Blount County,11,3897,1923,1974
Alabama,Blount County,12,3947,2034,1913
Alabama,Blount County,13,3683,1785,1898
Alabama,Blount County,14,3282,1564,1718
Alabama,Blount County,15,2961,1329,1632
Alabama,Blount County,16,1970,899,1071
Alabama,Blount County,17,1303,588,715
Alabama,Blount County,18,1032,371,661
Alabama,Bullock County,0,10138,5527,4611
Alabama,Bullock County,1,600,287,313
Alabama,Bullock County,2,598,303,295
Alabama,Bullock County,3,601,340,261
Alabama,Bullock County,4,529,268,261
Alabama,Bullock County,5,626,368,258
Alabama,Bullock County,6,769,486,283
Alabama,Bullock County,7,757,474,283
Alabama,Bullock County,8,689,419,270
Alabama,Bullock County,9,620,375,245
Alabama,Bullock County,10,654,406,248
Alabama,Bullock County,11,604,335,269
Alabama,Bullock County,12,752,393,359
Alabama,Bullock County,13,678,357,321
Alabama,Bullock County,14,541,264,277
Alabama,Bullock County,15,407,176,231
Alabama,Bullock County,16,296,123,173
Alabama,Bullock County,17,233,100,133
Alabama,Bullock County,18,184,53,131
Alabama,Butler County,0,19680,9165,10515
Alabama,Butler County,1,1119,564,555
Alabama,Butler County,2,1232,658,574
Alabama,Butler County,3,1288,695,593
Alabama,Butler County,4,1173,626,547
Alabama,Butler County,5,1090,554,536
Alabama,Butler County,6,1196,593,603
Alabama,Butler County,7,1083,453,630
Alabama,Butler County,8,1254,584,670
Alabama,Butler County,9,1136,491,645
Alabama,Butler County,10,1182,541,641
Alabama,Butler County,11,1131,495,636
Alabama,Butler County,12,1360,597,763
Alabama,Butler County,13,1441,680,761
Alabama,Butler County,14,1242,560,682
Alabama,Butler County,15,958,457,501
Alabama,Butler County,16,702,282,420
Alabama,Butler County,17,508,198,310
Alabama,Butler County,18,585,137,448
Alabama,Calhoun County,0,114277,54914,59363
Alabama,Calhoun County,1,6580,3339,3241
Alabama,Calhoun County,2,6561,3330,3231
Alabama,Calhoun County,3,7146,3730,3416
Alabama,Calhoun County,4,7491,3768,3723
Alabama,Calhoun County,5,7286,3635,3651
Alabama,Calhoun County,6,8177,4050,4127
Alabama,Calhoun County,7,6882,3329,3553
Alabama,Calhoun County,8,6983,3376,3607
Alabama,Calhoun County,9,6663,3240,3423
Alabama,Calhoun County,10,7064,3419,3645
Alabama,Calhoun County,11,7239,3545,3694
Alabama,Calhoun County,12,8086,3838,4248
Alabama,Calhoun County,13,7872,3730,4142
Alabama,Calhoun County,14,6769,3054,3715
Alabama,Calhoun County,15,5307,2405,2902
Alabama,Calhoun County,16,3672,1579,2093
Alabama,Calhoun County,17,2388,916,1472
Alabama,Calhoun County,18,2111,631,1480
Alabama,Chambers County,0,33615,16093,17522
Alabama,Chambers County,1,1929,1011,918
Alabama,Chambers County,2,1940,948,992
Alabama,Chambers County,3,1926,957,969
Alabama,Chambers County,4,1886,1022,864
Alabama,Chambers County,5,2007,995,1012
Alabama,Chambers County,6,2373,1181,1192
Alabama,Chambers County,7,1858,878,980
Alabama,Chambers County,8,1876,909,967
Alabama,Chambers County,9,1899,906,993
Alabama,Chambers County,10,2179,1054,1125
Alabama,Chambers County,11,2230,1090,1140
Alabama,Chambers County,12,2531,1215,1316
Alabama,Chambers County,13,2419,1139,1280
Alabama,Chambers County,14,2073,963,1110
Alabama,Chambers County,15,1767,791,976
Alabama,Chambers County,16,1205,519,686
Alabama,Chambers County,17,768,317,451
Alabama,Chambers County,18,749,198,551
Alabama,Cherokee County,0,26032,12896,13136
Alabama,Cherokee County,1,1206,608,598
Alabama,Cherokee County,2,1348,712,636
Alabama,Cherokee County,3,1482,750,732
Alabama,Cherokee County,4,1499,746,753
Alabama,Cherokee County,5,1304,685,619
Alabama,Cherokee County,6,1548,821,727
Alabama,Cherokee County,7,1206,575,631
Alabama,Cherokee County,8,1298,635,663
Alabama,Cherokee County,9,1471,731,740
Alabama,Cherokee County,10,1733,863,870
Alabama,Cherokee County,11,1857,980,877
Alabama,Cherokee County,12,2016,991,1025
Alabama,Cherokee County,13,2084,1010,1074
Alabama,Cherokee County,14,1862,935,927
Alabama,Cherokee County,15,1683,799,884
Alabama,Cherokee County,16,1152,535,617
Alabama,Cherokee County,17,747,336,411
Alabama,Cherokee County,18,536,184,352
Alabama,Chilton County,0,44153,21668,22485
Alabama,Chilton County,1,2730,1373,1357
Alabama,Chilton County,2,2922,1455,1467
Alabama,Chilton County,3,2971,1463,1508
Alabama,Chilton County,4,2847,1460,1387
Alabama,Chilton County,5,2549,1292,1257
Alabama,Chilton County,6,3017,1543,1474
Alabama,Chilton County,7,2554,1273,1281
Alabama,Chilton County,8,2679,1308,1371
Alabama,Chilton County,9,2776,1341,1435
Alabama,Chilton County,10,2879,1498,1381
Alabama,Chilton County,11,2934,1448,1486
Alabama,Chilton County,12,2998,1492,1506
Alabama,Chilton County,13,2886,1352,1534
Alabama,Chilton County,14,2473,1174,1299
Alabama,Chilton County,15,1988,919,1069
Alabama,Chilton County,16,1346,625,721
Alabama,Chilton County,17,835,355,480
Alabama,Chilton County,18,769,297,472
Alabama,Choctaw County,0,12841,6070,6771
Alabama,Choctaw County,1,673,338,335
Alabama,Choctaw County,2,651,325,326
Alabama,Choctaw County,3,740,406,334
Alabama,Choctaw County,4,749,384,365
Alabama,Choctaw County,5,694,336,358
Alabama,Choctaw County,6,708,335,373
Alabama,Choctaw County,7,596,286,310
Alabama,Choctaw County,8,693,319,374
Alabama,Choctaw County,9,689,322,367
Alabama,Choctaw County,10,789,365,424
Alabama,Choctaw County,11,894,421,473
Alabama,Choctaw County,12,1053,503,550
Alabama,Choctaw County,13,959,443,516
Alabama,Choctaw County,14,865,383,482
Alabama,Choctaw County,15,803,348,455
Alabama,Choctaw County,16,568,274,294
Alabama,Choctaw County,17,364,150,214
Alabama,Choctaw County,18,353,132,221
Alabama,Clarke County,0,23920,11328,12592
Alabama,Clarke County,1,1386,689,697
Alabama,Clarke County,2,1318,675,643
Alabama,Clarke County,3,1471,749,722
Alabama,Clarke County,4,1574,781,793
Alabama,Clarke County,5,1433,715,718
Alabama,Clarke County,6,1478,712,766
Alabama,Clarke County,7,1150,551,599
Alabama,Clarke County,8,1407,655,752
Alabama,Clarke County,9,1381,632,749
Alabama,Clarke County,10,1490,702,788
Alabama,Clarke County,11,1630,763,867
Alabama,Clarke County,12,1789,844,945
Alabama,Clarke County,13,1660,773,887
Alabama,Clarke County,14,1336,642,694
Alabama,Clarke County,15,1261,583,678
Alabama,Clarke County,16,959,418,541
Alabama,Clarke County,17,605,255,350
Alabama,Clarke County,18,592,189,403
Alabama,Clay County,0,13275,6492,6783
Alabama,Clay County,1,687,362,325
Alabama,Clay County,2,733,376,357
Alabama,Clay County,3,769,403,366
Alabama,Clay County,4,795,425,370
Alabama,Clay County,5,780,403,377
Alabama,Clay County,6,763,363,400
Alabama,Clay County,7,683,320,363
Alabama,Clay County,8,772,381,391
Alabama,Clay County,9,734,350,384
Alabama,Clay County,10,870,435,435
Alabama,Clay County,11,979,486,493
Alabama,Clay County,12,1012,500,512
Alabama,Clay County,13,947,457,490
Alabama,Clay County,14,852,411,441
Alabama,Clay County,15,673,320,353
Alabama,Clay County,16,541,236,305
Alabama,Clay County,17,373,144,229
Alabama,Clay County,18,312,120,192
Alabama,Cleburne County,0,14987,7421,7566
Alabama,Cleburne County,1,894,453,441
Alabama,Cleburne County,2,935,483,452
Alabama,Cleburne County,3,987,496,491
Alabama,Cleburne County,4,918,534,384
Alabama,Cleburne County,5,744,390,354
Alabama,Cleburne County,6,943,482,461
Alabama,Cleburne County,7,807,384,423
Alabama,Cleburne County,8,858,422,436
Alabama,Cleburne County,9,894,450,444
Alabama,Cleburne County,10,1036,519,517
Alabama,Cleburne County,11,1040,519,521
Alabama,Cleburne County,12,1073,541,532
Alabama,Cleburne County,13,943,431,512
Alabama,Cleburne County,14,908,448,460
Alabama,Cleburne County,15,784,357,427
Alabama,Cleburne County,16,574,283,291
Alabama,Cleburne County,17,310,122,188
Alabama,Cleburne County,18,339,107,232
Alabama,Coffee County,0,51909,25521,26388
Alabama,Coffee County,1,3211,1657,1554
Alabama,Coffee County,2,3394,1719,1675
Alabama,Coffee County,3,3498,1820,1678
Alabama,Coffee County,4,3330,1734,1596
Alabama,Coffee County,5,2985,1514,1471
Alabama,Coffee County,6,3327,1671,1656
Alabama,Coffee County,7,3270,1699,1571
Alabama,Coffee County,8,3316,1591,1725
Alabama,Coffee County,9,3344,1685,1659
Alabama,Coffee County,10,3552,1752,1800
Alabama,Coffee County,11,3373,1682,1691
Alabama,Coffee County,12,3289,1636,1653
Alabama,Coffee County,13,3219,1515,1704
Alabama,Coffee County,14,2739,1293,1446
Alabama,Coffee County,15,2439,1134,1305
Alabama,Coffee County,16,1524,637,887
Alabama,Coffee County,17,1129,466,663
Alabama,Coffee County,18,970,316,654
Alabama,Colbert County,0,54762,26259,28503
Alabama,Colbert County,1,3108,1549,1559
Alabama,Colbert County,2,3140,1579,1561
Alabama,Colbert County,3,3199,1642,1557
Alabama,Colbert County,4,3119,1567,1552
Alabama,Colbert County,5,3113,1554,1559
Alabama,Colbert County,6,3698,1862,1836
Alabama,Colbert County,7,3239,1544,1695
Alabama,Colbert County,8,3185,1553,1632
Alabama,Colbert County,9,3136,1526,1610
Alabama,Colbert County,10,3530,1680,1850
Alabama,Colbert County,11,3636,1755,1881
Alabama,Colbert County,12,3872,1837,2035
Alabama,Colbert County,13,3873,1864,2009
Alabama,Colbert County,14,3417,1599,1818
Alabama,Colbert County,15,2718,1196,1522
Alabama,Colbert County,16,2129,912,1217
Alabama,Colbert County,17,1364,548,816
Alabama,Colbert County,18,1286,492,794
Alabama,Conecuh County,0,12277,5881,6396
Alabama,Conecuh County,1,652,312,340
Alabama,Conecuh County,2,715,343,372
Alabama,Conecuh County,3,726,382,344
Alabama,Conecuh County,4,708,354,354
Alabama,Conecuh County,5,687,344,343
Alabama,Conecuh County,6,723,364,359
Alabama,Conecuh County,7,634,305,329
Alabama,Conecuh County,8,626,288,338
Alabama,Conecuh County,9,639,293,346
Alabama,Conecuh County,10,696,330,366
Alabama,Conecuh County,11,792,361,431
Alabama,Conecuh County,12,962,478,484
Alabama,Conecuh County,13,955,465,490
Alabama,Conecuh County,14,771,359,412
Alabama,Conecuh County,15,782,372,410
Alabama,Conecuh County,16,526,240,286
Alabama,Conecuh County,17,358,154,204
Alabama,Conecuh County,18,325,137,188
Alabama,Coosa County,0,10715,5399,5316
Alabama,Coosa County,1,488,264,224
Alabama,Coosa County,2,440,249,191
Alabama,Coosa County,3,519,247,272
Alabama,Coosa County,4,504,263,241
Alabama,Coosa County,5,557,304,253
Alabama,Coosa County,6,608,333,275
Alabama,Coosa County,7,492,228,264
Alabama,Coosa County,8,536,280,256
Alabama,Coosa County,9,598,305,293
Alabama,Coosa County,10,781,359,422
Alabama,Coosa County,11,783,413,370
Alabama,Coosa County,12,967,462,505
Alabama,Coosa County,13,961,525,436
Alabama,Coosa County,14,785,395,390
Alabama,Coosa County,15,662,303,359
Alabama,Coosa County,16,475,242,233
Alabama,Coosa County,17,289,126,163
Alabama,Coosa County,18,270,101,169
Alabama,Covington County,0,36986,17896,19090
Alabama,Covington County,1,2203,1111,1092
Alabama,Covington County,2,2235,1180,1055
Alabama,Covington County,3,2293,1161,1132
Alabama,Covington County,4,2104,1069,1035
Alabama,Covington County,5,1862,941,921
Alabama,Covington County,6,2325,1182,1143
Alabama,Covington County,7,2017,957,1060
Alabama,Covington County,8,2077,994,1083
Alabama,Covington County,9,1952,957,995
Alabama,Covington County,10,2226,1121,1105
Alabama,Covington County,11,2403,1147,1256
Alabama,Covington County,12,2738,1349,1389
Alabama,Covington County,13,2761,1335,1426
Alabama,Covington County,14,2276,1091,1185
Alabama,Covington County,15,2050,955,1095
Alabama,Covington County,16,1458,637,821
Alabama,Covington County,17,1027,393,634
Alabama,Covington County,18,979,316,663
Alabama,Crenshaw County,0,13824,6674,7150
Alabama,Crenshaw County,1,798,410,388
Alabama,Crenshaw County,2,884,468,416
Alabama,Crenshaw County,3,914,457,457
Alabama,Crenshaw County,4,850,440,410
Alabama,Crenshaw County,5,757,367,390
Alabama,Crenshaw County,6,892,436,456
Alabama,Crenshaw County,7,749,359,390
Alabama,Crenshaw County,8,808,384,424
Alabama,Crenshaw County,9,777,380,397
Alabama,Crenshaw County,10,871,428,443
Alabama,Crenshaw County,11,896,407,489
Alabama,Crenshaw County,12,1017,520,497
Alabama,Crenshaw County,13,982,475,507
Alabama,Crenshaw County,14,846,394,452
Alabama,Crenshaw County,15,759,345,414
Alabama,Crenshaw County,16,422,201,221
Alabama,Crenshaw County,17,299,119,180
Alabama,Crenshaw County,18,303,84,219
Alabama,Cullman County,0,83442,41245,42197
Alabama,Cullman County,1,5162,2588,2574
Alabama,Cullman County,2,5114,2584,2530
Alabama,Cullman County,3,5220,2729,2491
Alabama,Cullman County,4,5036,2577,2459
Alabama,Cullman County,5,4599,2359,2240
Alabama,Cullman County,6,5790,2878,2912
Alabama,Cullman County,7,4980,2588,2392
Alabama,Cullman County,8,4946,2478,2468
Alabama,Cullman County,9,5077,2567,2510
Alabama,Cullman County,10,5258,2616,2642
Alabama,Cullman County,11,5442,2784,2658
Alabama,Cullman County,12,5792,2864,2928
Alabama,Cullman County,13,5580,2723,2857
Alabama,Cullman County,14,4872,2314,2558
Alabama,Cullman County,15,4205,1935,2270
Alabama,Cullman County,16,3016,1339,1677
Alabama,Cullman County,17,1903,792,1111
Alabama,Cullman County,18,1450,530,920
Alabama,Dale County,0,48956,24023,24933
Alabama,Dale County,1,3268,1651,1617
Alabama,Dale County,2,3118,1628,1490
Alabama,Dale County,3,2984,1521,1463
Alabama,Dale County,4,2934,1505,1429
Alabama,Dale County,5,3189,1716,1473
Alabama,Dale County,6,3824,2001,1823
Alabama,Dale County,7,3373,1688,1685
Alabama,Dale County,8,2939,1418,1521
Alabama,Dale County,9,2734,1302,1432
Alabama,Dale County,10,2954,1418,1536
Alabama,Dale County,11,2949,1442,1507
Alabama,Dale County,12,3273,1565,1708
Alabama,Dale County,13,3147,1487,1660
Alabama,Dale County,14,2603,1289,1314
Alabama,Dale County,15,2175,971,1204
Alabama,Dale County,16,1577,674,903
Alabama,Dale County,17,1017,409,608
Alabama,Dale County,18,898,338,560
Alabama,Dallas County,0,38310,17685,20625
Alabama,Dallas County,1,2335,1149,1186
Alabama,Dallas County,2,2432,1230,1202
Alabama,Dallas County,3,2703,1385,1318
Alabama,Dallas County,4,2642,1338,1304
Alabama,Dallas County,5,2369,1130,1239
Alabama,Dallas County,6,2384,1082,1302
Alabama,Dallas County,7,2099,975,1124
Alabama,Dallas County,8,2199,980,1219
Alabama,Dallas County,9,2047,876,1171
Alabama,Dallas County,10,2107,943,1164
Alabama,Dallas County,11,2415,1122,1293
Alabama,Dallas County,12,2844,1262,1582
Alabama,Dallas County,13,2813,1281,1532
Alabama,Dallas County,14,2299,1073,1226
Alabama,Dallas County,15,1839,817,1022
Alabama,Dallas County,16,1220,524,696
Alabama,Dallas County,17,862,325,537
Alabama,Dallas County,18,701,193,508
Alabama,DeKalb County,0,71385,35428,35957
Alabama,DeKalb County,1,4237,2210,2027
Alabama,DeKalb County,2,4692,2377,2315
Alabama,DeKalb County,3,5213,2674,2539
Alabama,DeKalb County,4,4796,2513,2283
Alabama,DeKalb County,5,4058,2130,1928
Alabama,DeKalb County,6,4542,2289,2253
Alabama,DeKalb County,7,3963,2033,1930
Alabama,DeKalb County,8,4256,2097,2159
Alabama,DeKalb County,9,4505,2254,2251
Alabama,DeKalb County,10,4839,2450,2389
Alabama,DeKalb County,11,4642,2295,2347
Alabama,DeKalb County,12,4755,2362,2393
Alabama,DeKalb County,13,4565,2215,2350
Alabama,DeKalb County,14,4030,1922,2108
Alabama,DeKalb County,15,3345,1584,1761
Alabama,DeKalb County,16,2279,1028,1251
Alabama,DeKalb County,17,1461,597,864
Alabama,DeKalb County,18,1207,398,809
Alabama,Elmore County,0,81887,39585,42302
Alabama,Elmore County,1,4713,2387,2326
Alabama,Elmore County,2,4922,2604,2318
Alabama,Elmore County,3,5264,2625,2639
Alabama,Elmore County,4,5095,2630,2465
Alabama,Elmore County,5,5054,2617,2437
Alabama,Elmore County,6,6089,2979,3110
Alabama,Elmore County,7,5478,2611,2867
Alabama,Elmore County,8,5529,2596,2933
Alabama,Elmore County,9,5302,2500,2802
Alabama,Elmore County,10,5701,2659,3042
Alabama,Elmore County,11,5571,2682,2889
Alabama,Elmore County,12,5631,2677,2954
Alabama,Elmore County,13,5138,2426,2712
Alabama,Elmore County,14,4113,1911,2202
Alabama,Elmore County,15,3432,1627,1805
Alabama,Elmore County,16,2326,1087,1239
Alabama,Elmore County,17,1365,606,759
Alabama,Elmore County,18,1164,361,803
Alabama,Escambia County,0,36748,18628,18120
Alabama,Escambia County,1,2187,1111,1076
Alabama,Escambia County,2,2339,1192,1147
Alabama,Escambia County,3,2284,1126,1158
Alabama,Escambia County,4,2143,1041,1102
Alabama,Escambia County,5,2076,1138,938
Alabama,Escambia County,6,2681,1504,1177
Alabama,Escambia County,7,2291,1313,978
Alabama,Escambia County,8,2315,1293,1022
Alabama,Escambia County,9,2259,1257,1002
Alabama,Escambia County,10,2436,1298,1138
Alabama,Escambia County,11,2340,1248,1092
Alabama,Escambia County,12,2523,1250,1273
Alabama,Escambia County,13,2278,1074,1204
Alabama,Escambia County,14,2041,921,1120
Alabama,Escambia County,15,1745,778,967
Alabama,Escambia County,16,1309,548,761
Alabama,Escambia County,17,818,318,500
Alabama,Escambia County,18,683,218,465
Alabama,Etowah County,0,102501,49653,52848
Alabama,Etowah County,1,5902,3058,2844
Alabama,Etowah County,2,5934,3107,2827
Alabama,Etowah County,3,6122,3077,3045
Alabama,Etowah County,4,6321,3255,3066
Alabama,Etowah County,5,6120,3144,2976
Alabama,Etowah County,6,6708,3331,3377
Alabama,Etowah County,7,5711,2796,2915
Alabama,Etowah County,8,6141,2939,3202
Alabama,Etowah County,9,6146,2956,3190
Alabama,Etowah County,10,7161,3521,3640
Alabama,Etowah County,11,6713,3286,3427
Alabama,Etowah County,12,7013,3373,3640
Alabama,Etowah County,13,7022,3323,3699
Alabama,Etowah County,14,6424,2964,3460
Alabama,Etowah County,15,5207,2403,2804
Alabama,Etowah County,16,3605,1542,2063
Alabama,Etowah County,17,2268,942,1326
Alabama,Etowah County,18,1983,636,1347
Alabama,Fayette County,0,16433,8023,8410
Alabama,Fayette County,1,921,465,456
Alabama,Fayette County,2,957,500,457
Alabama,Fayette County,3,1002,512,490
Alabama,Fayette County,4,941,496,445
Alabama,Fayette County,5,951,489,462
Alabama,Fayette County,6,1015,531,484
Alabama,Fayette County,7,871,412,459
Alabama,Fayette County,8,906,468,438
Alabama,Fayette County,9,906,441,465
Alabama,Fayette County,10,1088,527,561
Alabama,Fayette County,11,1039,506,533
Alabama,Fayette County,12,1196,595,601
Alabama,Fayette County,13,1168,561,607
Alabama,Fayette County,14,1090,504,586
Alabama,Fayette County,15,897,398,499
Alabama,Fayette County,16,698,308,390
Alabama,Fayette County,17,447,194,253
Alabama,Fayette County,18,340,116,224
Alabama,Franklin County,0,31363,15823,15540
Alabama,Franklin County,1,2084,1078,1006
Alabama,Franklin County,2,2098,1077,1021
Alabama,Franklin County,3,2187,1105,1082
Alabama,Franklin County,4,2028,1082,946
Alabama,Franklin County,5,1827,995,832
Alabama,Franklin County,6,2094,1104,990
Alabama,Franklin County,7,1793,960,833
Alabama,Franklin County,8,1861,962,899
Alabama,Franklin County,9,2017,1059,958
Alabama,Franklin County,10,2124,1112,1012
Alabama,Franklin County,11,2031,1016,1015
Alabama,Franklin County,12,2010,999,1011
Alabama,Franklin County,13,1913,923,990
Alabama,Franklin County,14,1641,764,877
Alabama,Franklin County,15,1364,653,711
Alabama,Franklin County,16,1025,428,597
Alabama,Franklin County,17,701,297,404
Alabama,Franklin County,18,565,209,356
Alabama,Geneva County,0,26314,12846,13468
Alabama,Geneva County,1,1422,707,715
Alabama,Geneva County,2,1559,800,759
Alabama,Geneva County,3,1701,868,833
Alabama,Geneva County,4,1635,852,783
Alabama,Geneva County,5,1322,680,642
Alabama,Geneva County,6,1537,769,768
Alabama,Geneva County,7,1437,678,759
Alabama,Geneva County,8,1516,763,753
Alabama,Geneva County,9,1511,735,776
Alabama,Geneva County,10,1738,821,917
Alabama,Geneva County,11,1820,949,871
Alabama,Geneva County,12,1807,871,936
Alabama,Geneva County,13,1968,970,998
Alabama,Geneva County,14,1675,816,859
Alabama,Geneva County,15,1421,684,737
Alabama,Geneva County,16,993,426,567
Alabama,Geneva County,17,674,257,417
Alabama,Geneva County,18,578,200,378
Alabama,Greene County,0,8233,3887,4346
Alabama,Greene County,1,475,241,234
Alabama,Greene County,2,518,277,241
Alabama,Greene County,3,515,256,259
Alabama,Greene County,4,483,236,247
Alabama,Greene County,5,465,232,233
Alabama,Greene County,6,531,273,258
Alabama,Greene County,7,421,215,206
Alabama,Greene County,8,445,206,239
Alabama,Greene County,9,384,191,193
Alabama,Greene County,10,414,194,220
Alabama,Greene County,11,481,209,272
Alabama,Greene County,12,617,275,342
Alabama,Greene County,13,647,298,349
Alabama,Greene County,14,640,290,350
Alabama,Greene County,15,432,179,253
Alabama,Greene County,16,318,147,171
Alabama,Greene County,17,206,93,113
Alabama,Greene County,18,241,75,166
Alabama,Hale County,0,14726,7008,7718
Alabama,Hale County,1,979,539,440
Alabama,Hale County,2,909,467,442
Alabama,Hale County,3,956,498,458
Alabama,Hale County,4,910,461,449
Alabama,Hale County,5,933,429,504
Alabama,Hale County,6,951,477,474
Alabama,Hale County,7,783,375,408
Alabama,Hale County,8,840,369,471
Alabama,Hale County,9,795,352,443
Alabama,Hale County,10,806,389,417
Alabama,Hale County,11,916,405,511
Alabama,Hale County,12,1106,517,589
Alabama,Hale County,13,1013,482,531
Alabama,Hale County,14,923,455,468
Alabama,Hale County,15,715,341,374
Alabama,Hale County,16,486,216,270
Alabama,Hale County,17,355,130,225
Alabama,Hale County,18,350,106,244
Alabama,Henry County,0,17209,8300,8909
Alabama,Henry County,1,915,485,430
Alabama,Henry County,2,926,456,470
Alabama,Henry County,3,1060,566,494
Alabama,Henry County,4,990,505,485
Alabama,Henry County,5,851,463,388
Alabama,Henry County,6,961,472,489
Alabama,Henry County,7,891,431,460
Alabama,Henry County,8,1023,494,529
Alabama,Henry County,9,1028,502,526
Alabama,Henry County,10,1129,543,586
Alabama,Henry County,11,1135,555,580
Alabama,Henry County,12,1112,521,591
Alabama,Henry County,13,1278,596,682
Alabama,Henry County,14,1290,574,716
Alabama,Henry County,15,1072,513,559
Alabama,Henry County,16,662,305,357
Alabama,Henry County,17,463,206,257
Alabama,Henry County,18,423,113,310
Alabama,Houston County,0,104722,50286,54436
Alabama,Houston County,1,6350,3315,3035
Alabama,Houston County,2,6528,3363,3165
Alabama,Houston County,3,6887,3616,3271
Alabama,Houston County,4,6606,3373,3233
Alabama,Houston County,5,5834,2920,2914
Alabama,Houston County,6,6980,3361,3619
Alabama,Houston County,7,6668,3198,3470
Alabama,Houston County,8,6634,3190,3444
Alabama,Houston County,9,6244,2894,3350
Alabama,Houston County,10,6732,3214,3518
Alabama,Houston County,11,6752,3278,3474
Alabama,Houston County,12,7167,3364,3803
Alabama,Houston County,13,6701,3144,3557
Alabama,Houston County,14,5936,2721,3215
Alabama,Houston County,15,4985,2285,2700
Alabama,Houston County,16,3373,1448,1925
Alabama,Houston County,17,2308,917,1391
Alabama,Houston County,18,2037,685,1352
Alabama,Jackson County,0,51736,25390,26346
Alabama,Jackson County,1,2776,1442,1334
Alabama,Jackson County,2,2856,1517,1339
Alabama,Jackson County,3,3151,1664,1487
Alabama,Jackson County,4,3107,1592,1515
Alabama,Jackson County,5,2745,1383,1362
Alabama,Jackson County,6,3219,1627,1592
Alabama,Jackson County,7,2645,1314,1331
Alabama,Jackson County,8,2991,1406,1585
Alabama,Jackson County,9,3208,1583,1625
Alabama,Jackson County,10,3518,1794,1724
Alabama,Jackson County,11,3442,1704,1738
Alabama,Jackson County,12,3763,1835,1928
Alabama,Jackson County,13,3942,1914,2028
Alabama,Jackson County,14,3266,1543,1723
Alabama,Jackson County,15,2814,1280,1534
Alabama,Jackson County,16,2044,953,1091
Alabama,Jackson County,17,1292,520,772
Alabama,Jackson County,18,957,319,638
Alabama,Jefferson County,0,659300,311591,347709
Alabama,Jefferson County,1,41882,21278,20604
Alabama,Jefferson County,2,41984,21557,20427
Alabama,Jefferson County,3,41913,21167,20746
Alabama,Jefferson County,4,40910,20365,20545
Alabama,Jefferson County,5,41674,20402,21272
Alabama,Jefferson County,6,50181,24187,25994
Alabama,Jefferson County,7,45744,21677,24067
Alabama,Jefferson County,8,43846,20763,23083
Alabama,Jefferson County,9,39621,18730,20891
Alabama,Jefferson County,10,40600,19460,21140
Alabama,Jefferson County,11,39767,18738,21029
Alabama,Jefferson County,12,44002,20513,23489
Alabama,Jefferson County,13,42629,19337,23292
Alabama,Jefferson County,14,35993,16204,19789
Alabama,Jefferson County,15,25592,11322,14270
Alabama,Jefferson County,16,17412,7178,10234
Alabama,Jefferson County,17,12107,4555,7552
Alabama,Jefferson County,18,13443,4158,9285
Alabama,Lamar County,0,13844,6767,7077
Alabama,Lamar County,1,743,383,360
Alabama,Lamar County,2,755,378,377
Alabama,Lamar County,3,916,461,455
Alabama,Lamar County,4,829,451,378
Alabama,Lamar County,5,707,361,346
Alabama,Lamar County,6,756,374,382
Alabama,Lamar County,7,740,350,390
Alabama,Lamar County,8,731,358,373
Alabama,Lamar County,9,835,406,429
Alabama,Lamar County,10,928,471,457
Alabama,Lamar County,11,884,439,445
Alabama,Lamar County,12,1019,511,508
Alabama,Lamar County,13,1003,485,518
Alabama,Lamar County,14,848,434,414
Alabama,Lamar County,15,800,376,424
Alabama,Lamar County,16,598,261,337
Alabama,Lamar County,17,426,167,259
Alabama,Lamar County,18,326,101,225
Alabama,Lauderdale County,0,92387,44327,48060
Alabama,Lauderdale County,1,4734,2456,2278
Alabama,Lauderdale County,2,4836,2481,2355
Alabama,Lauderdale County,3,5325,2627,2698
Alabama,Lauderdale County,4,6016,3016,3000
Alabama,Lauderdale County,5,7668,3723,3945
Alabama,Lauderdale County,6,5905,2981,2924
Alabama,Lauderdale County,7,5102,2582,2520
Alabama,Lauderdale County,8,5112,2473,2639
Alabama,Lauderdale County,9,4815,2357,2458
Alabama,Lauderdale County,10,5738,2795,2943
Alabama,Lauderdale County,11,5919,2841,3078
Alabama,Lauderdale County,12,6260,2996,3264
Alabama,Lauderdale County,13,6394,2977,3417
Alabama,Lauderdale County,14,5746,2665,3081
Alabama,Lauderdale County,15,4849,2193,2656
Alabama,Lauderdale County,16,3561,1547,2014
Alabama,Lauderdale County,17,2312,923,1389
Alabama,Lauderdale County,18,2095,694,1401
Alabama,Lawrence County,0,32957,16047,16910
Alabama,Lawrence County,1,1810,940,870
Alabama,Lawrence County,2,1957,983,974
Alabama,Lawrence County,3,2106,1078,1028
Alabama,Lawrence County,4,1912,991,921
Alabama,Lawrence County,5,1780,902,878
Alabama,Lawrence County,6,2136,1089,1047
Alabama,Lawrence County,7,1829,890,939
Alabama,Lawrence County,8,1817,864,953
Alabama,Lawrence County,9,1882,933,949
Alabama,Lawrence County,10,2263,1109,1154
Alabama,Lawrence County,11,2442,1194,1248
Alabama,Lawrence County,12,2572,1232,1340
Alabama,Lawrence County,13,2300,1096,1204
Alabama,Lawrence County,14,1961,927,1034
Alabama,Lawrence County,15,1705,760,945
Alabama,Lawrence County,16,1225,580,645
Alabama,Lawrence County,17,702,292,410
Alabama,Lawrence County,18,558,187,371
Alabama,Lee County,0,163941,80639,83302
Alabama,Lee County,1,9629,4934,4695
Alabama,Lee County,2,9551,4856,4695
Alabama,Lee County,3,10043,5163,4880
Alabama,Lee County,4,13355,6641,6714
Alabama,Lee County,5,21876,11495,10381
Alabama,Lee County,6,12706,6409,6297
Alabama,Lee County,7,10547,5062,5485
Alabama,Lee County,8,10381,5029,5352
Alabama,Lee County,9,9361,4510,4851
Alabama,Lee County,10,10004,4783,5221
Alabama,Lee County,11,9324,4561,4763
Alabama,Lee County,12,9428,4597,4831
Alabama,Lee County,13,8255,3866,4389
Alabama,Lee County,14,6850,3169,3681
Alabama,Lee County,15,5310,2494,2816
Alabama,Lee County,16,3409,1524,1885
Alabama,Lee County,17,2111,923,1188
Alabama,Lee County,18,1801,623,1178
Alabama,Limestone County,0,96174,48156,48018
Alabama,Limestone County,1,5393,2760,2633
Alabama,Limestone County,2,5968,2949,3019
Alabama,Limestone County,3,6388,3239,3149
Alabama,Limestone County,4,6007,3105,2902
Alabama,Limestone County,5,5183,2702,2481
Alabama,Limestone County,6,6187,3210,2977
Alabama,Limestone County,7,6352,3234,3118
Alabama,Limestone County,8,6652,3456,3196
Alabama,Limestone County,9,6428,3319,3109
Alabama,Limestone County,10,6969,3533,3436
Alabama,Limestone County,11,7112,3603,3509
Alabama,Limestone County,12,7031,3600,3431
Alabama,Limestone County,13,5896,2878,3018
Alabama,Limestone County,14,4845,2369,2476
Alabama,Limestone County,15,3977,1820,2157
Alabama,Limestone County,16,2693,1212,1481
Alabama,Limestone County,17,1702,725,977
Alabama,Limestone County,18,1391,442,949
Alabama,Lowndes County,0,9974,4670,5304
Alabama,Lowndes County,1,614,311,303
Alabama,Lowndes County,2,662,316,346
Alabama,Lowndes County,3,606,289,317
Alabama,Lowndes County,4,558,293,265
Alabama,Lowndes County,5,575,285,290
Alabama,Lowndes County,6,711,329,382
Alabama,Lowndes County,7,533,260,273
Alabama,Lowndes County,8,561,261,300
Alabama,Lowndes County,9,503,241,262
Alabama,Lowndes County,10,580,268,312
Alabama,Lowndes County,11,690,324,366
Alabama,Lowndes County,12,769,344,425
Alabama,Lowndes County,13,732,359,373
Alabama,Lowndes County,14,579,267,312
Alabama,Lowndes County,15,490,205,285
Alabama,Lowndes County,16,376,167,209
Alabama,Lowndes County,17,220,90,130
Alabama,Lowndes County,18,215,61,154
Alabama,Macon County,0,18439,8383,10056
Alabama,Macon County,1,855,425,430
Alabama,Macon County,2,839,425,414
Alabama,Macon County,3,838,414,424
Alabama,Macon County,4,1669,774,895
Alabama,Macon County,5,2195,968,1227
Alabama,Macon County,6,1242,600,642
Alabama,Macon County,7,837,378,459
Alabama,Macon County,8,834,408,426
Alabama,Macon County,9,823,381,442
Alabama,Macon County,10,958,425,533
Alabama,Macon County,11,1100,493,607
Alabama,Macon County,12,1255,554,701
Alabama,Macon County,13,1238,566,672
Alabama,Macon County,14,1303,585,718
Alabama,Macon County,15,969,418,551
Alabama,Macon County,16,646,278,368
Alabama,Macon County,17,413,162,251
Alabama,Macon County,18,425,129,296
Alabama,Madison County,0,366519,179074,187445
Alabama,Madison County,1,21403,10934,10469
Alabama,Madison County,2,21675,11109,10566
Alabama,Madison County,3,22960,11718,11242
Alabama,Madison County,4,23962,12188,11774
Alabama,Madison County,5,24647,12421,12226
Alabama,Madison County,6,26312,13368,12944
Alabama,Madison County,7,24897,12441,12456
Alabama,Madison County,8,23465,11575,11890
Alabama,Madison County,9,21173,10135,11038
Alabama,Madison County,10,23274,11137,12137
Alabama,Madison County,11,26096,12717,13379
Alabama,Madison County,12,28379,13960,14419
Alabama,Madison County,13,23151,11229,11922
Alabama,Madison County,14,17730,8271,9459
Alabama,Madison County,15,14047,6331,7716
Alabama,Madison County,16,10104,4347,5757
Alabama,Madison County,17,7021,2894,4127
Alabama,Madison County,18,6223,2299,3924
Alabama,Marengo County,0,19066,8933,10133
Alabama,Marengo County,1,1209,585,624
Alabama,Marengo County,2,1155,553,602
Alabama,Marengo County,3,1228,625,603
Alabama,Marengo County,4,1152,590,562
Alabama,Marengo County,5,1106,564,542
Alabama,Marengo County,6,1226,605,621
Alabama,Marengo County,7,1070,483,587
Alabama,Marengo County,8,1005,464,541
Alabama,Marengo County,9,1078,502,576
Alabama,Marengo County,10,1182,533,649
Alabama,Marengo County,11,1239,587,652
Alabama,Marengo County,12,1332,589,743
Alabama,Marengo County,13,1347,638,709
Alabama,Marengo County,14,1128,548,580
Alabama,Marengo County,15,950,425,525
Alabama,Marengo County,16,693,309,384
Alabama,Marengo County,17,456,172,284
Alabama,Marengo County,18,510,161,349
Alabama,Marion County,0,29763,14686,15077
Alabama,Marion County,1,1597,815,782
Alabama,Marion County,2,1635,848,787
Alabama,Marion County,3,1790,959,831
Alabama,Marion County,4,1792,952,840
Alabama,Marion County,5,1580,826,754
Alabama,Marion County,6,1796,901,895
Alabama,Marion County,7,1596,789,807
Alabama,Marion County,8,1677,819,858
Alabama,Marion County,9,1666,815,851
Alabama,Marion County,10,2042,1051,991
Alabama,Marion County,11,2083,1066,1017
Alabama,Marion County,12,2192,1075,1117
Alabama,Marion County,13,1996,989,1007
Alabama,Marion County,14,1838,880,958
Alabama,Marion County,15,1647,749,898
Alabama,Marion County,16,1260,564,696
Alabama,Marion County,17,875,358,517
Alabama,Marion County,18,701,230,471
Alabama,Marshall County,0,96109,47502,48607
Alabama,Marshall County,1,6769,3447,3322
Alabama,Marshall County,2,6433,3321,3112
Alabama,Marshall County,3,6853,3567,3286
Alabama,Marshall County,4,6072,3147,2925
Alabama,Marshall County,5,5490,2885,2605
Alabama,Marshall County,6,6270,3252,3018
Alabama,Marshall County,7,5701,2885,2816
Alabama,Marshall County,8,5714,2857,2857
Alabama,Marshall County,9,5528,2751,2777
Alabama,Marshall County,10,6222,3089,3133
Alabama,Marshall County,11,6103,3098,3005
Alabama,Marshall County,12,6515,3171,3344
Alabama,Marshall County,13,6064,2953,3111
Alabama,Marshall County,14,5087,2332,2755
Alabama,Marshall County,15,4343,1978,2365
Alabama,Marshall County,16,3282,1442,1840
Alabama,Marshall County,17,1984,776,1208
Alabama,Marshall County,18,1679,551,1128
Alabama,Mobile County,0,413757,197077,216680
Alabama,Mobile County,1,26937,13532,13405
Alabama,Mobile County,2,26470,13369,13101
Alabama,Mobile County,3,26929,13786,13143
Alabama,Mobile County,4,26632,13471,13161
Alabama,Mobile County,5,26777,13217,13560
Alabama,Mobile County,6,30611,14827,15784
Alabama,Mobile County,7,27297,12701,14596
Alabama,Mobile County,8,25747,12286,13461
Alabama,Mobile County,9,23781,11313,12468
Alabama,Mobile County,10,24821,11691,13130
Alabama,Mobile County,11,25702,12239,13463
Alabama,Mobile County,12,28165,13197,14968
Alabama,Mobile County,13,26847,12593,14254
Alabama,Mobile County,14,22367,10333,12034
Alabama,Mobile County,15,17711,7931,9780
Alabama,Mobile County,16,11974,5084,6890
Alabama,Mobile County,17,7751,3118,4633
Alabama,Mobile County,18,7238,2389,4849
Alabama,Monroe County,0,21067,10005,11062
Alabama,Monroe County,1,1105,549,556
Alabama,Monroe County,2,1193,623,570
Alabama,Monroe County,3,1390,713,677
Alabama,Monroe County,4,1386,714,672
Alabama,Monroe County,5,1240,637,603
Alabama,Monroe County,6,1254,620,634
Alabama,Monroe County,7,1010,452,558
Alabama,Monroe County,8,1131,510,621
Alabama,Monroe County,9,1178,526,652
Alabama,Monroe County,10,1328,648,680
Alabama,Monroe County,11,1447,670,777
Alabama,Monroe County,12,1572,725,847
Alabama,Monroe County,13,1558,757,801
Alabama,Monroe County,14,1331,606,725
Alabama,Monroe County,15,1056,510,546
Alabama,Monroe County,16,837,362,475
Alabama,Monroe County,17,484,204,280
Alabama,Monroe County,18,567,179,388
Alabama,Montgomery County,0,225763,106522,119241
Alabama,Montgomery County,1,15223,7761,7462
Alabama,Montgomery County,2,14511,7322,7189
Alabama,Montgomery County,3,14478,7302,7176
Alabama,Montgomery County,4,14843,7651,7192
Alabama,Montgomery County,5,15908,7715,8193
Alabama,Montgomery County,6,17384,8495,8889
Alabama,Montgomery County,7,15399,7305,8094
Alabama,Montgomery County,8,14904,7061,7843
Alabama,Montgomery County,9,13179,6110,7069
Alabama,Montgomery County,10,13806,6391,7415
Alabama,Montgomery County,11,13491,6320,7171
Alabama,Montgomery County,12,14565,6633,7932
Alabama,Montgomery County,13,13899,6195,7704
Alabama,Montgomery County,14,11719,5082,6637
Alabama,Montgomery County,15,8473,3790,4683
Alabama,Montgomery County,16,5868,2488,3380
Alabama,Montgomery County,17,4101,1542,2559
Alabama,Montgomery County,18,4012,1359,2653
Alabama,Morgan County,0,119089,58682,60407
Alabama,Morgan County,1,7124,3648,3476
Alabama,Morgan County,2,7407,3818,3589
Alabama,Morgan County,3,7864,4007,3857
Alabama,Morgan County,4,7414,3839,3575
Alabama,Morgan County,5,6792,3481,3311
Alabama,Morgan County,6,7577,3822,3755
Alabama,Morgan County,7,6973,3557,3416
Alabama,Morgan County,8,7326,3710,3616
Alabama,Morgan County,9,7122,3598,3524
Alabama,Morgan County,10,7883,3952,3931
Alabama,Morgan County,11,8476,4188,4288
Alabama,Morgan County,12,8480,4212,4268
Alabama,Morgan County,13,7848,3751,4097
Alabama,Morgan County,14,6678,3070,3608
Alabama,Morgan County,15,5403,2426,2977
Alabama,Morgan County,16,3973,1767,2206
Alabama,Morgan County,17,2559,1074,1485
Alabama,Morgan County,18,2190,762,1428
Alabama,Perry County,0,9140,4281,4859
Alabama,Perry County,1,500,281,219
Alabama,Perry County,2,532,265,267
Alabama,Perry County,3,551,287,264
Alabama,Perry County,4,900,489,411
Alabama,Perry County,5,830,410,420
Alabama,Perry County,6,516,239,277
Alabama,Perry County,7,441,211,230
Alabama,Perry County,8,456,200,256
Alabama,Perry County,9,457,186,271
Alabama,Perry County,10,503,230,273
Alabama,Perry County,11,497,235,262
Alabama,Perry County,12,549,241,308
Alabama,Perry County,13,634,292,342
Alabama,Perry County,14,497,205,292
Alabama,Perry County,15,443,188,255
Alabama,Perry County,16,361,164,197
Alabama,Perry County,17,238,91,147
Alabama,Perry County,18,235,67,168
Alabama,Pickens County,0,19938,9948,9990
Alabama,Pickens County,1,1056,561,495
Alabama,Pickens County,2,1051,529,522
Alabama,Pickens County,3,1061,570,491
Alabama,Pickens County,4,1200,654,546
Alabama,Pickens County,5,1215,699,516
Alabama,Pickens County,6,1387,714,673
Alabama,Pickens County,7,1306,684,622
Alabama,Pickens County,8,1218,617,601
Alabama,Pickens County,9,1058,509,549
Alabama,Pickens County,10,1313,628,685
Alabama,Pickens County,11,1411,649,762
Alabama,Pickens County,12,1512,779,733
Alabama,Pickens County,13,1357,632,725
Alabama,Pickens County,14,1211,623,588
Alabama,Pickens County,15,929,406,523
Alabama,Pickens County,16,742,333,409
Alabama,Pickens County,17,481,202,279
Alabama,Pickens County,18,430,159,271
Alabama,Pike County,0,33338,16098,17240
Alabama,Pike County,1,1788,935,853
Alabama,Pike County,2,1792,921,871
Alabama,Pike County,3,1725,911,814
Alabama,Pike County,4,2929,1280,1649
Alabama,Pike County,5,5640,2809,2831
Alabama,Pike County,6,2494,1429,1065
Alabama,Pike County,7,1584,773,811
Alabama,Pike County,8,1752,834,918
Alabama,Pike County,9,1560,705,855
Alabama,Pike County,10,1718,807,911
Alabama,Pike County,11,1651,760,891
Alabama,Pike County,12,1870,857,1013
Alabama,Pike County,13,1848,866,982
Alabama,Pike County,14,1502,718,784
Alabama,Pike County,15,1375,639,736
Alabama,Pike County,16,904,410,494
Alabama,Pike County,17,641,271,370
Alabama,Pike County,18,565,173,392
Alabama,Randolph County,0,22725,11056,11669
Alabama,Randolph County,1,1314,676,638
Alabama,Randolph County,2,1316,657,659
Alabama,Randolph County,3,1372,699,673
Alabama,Randolph County,4,1492,797,695
Alabama,Randolph County,5,1308,661,647
Alabama,Randolph County,6,1347,654,693
Alabama,Randolph County,7,1105,534,571
Alabama,Randolph County,8,1212,572,640
Alabama,Randolph County,9,1234,595,639
Alabama,Randolph County,10,1438,682,756
Alabama,Randolph County,11,1604,789,815
Alabama,Randolph County,12,1675,833,842
Alabama,Randolph County,13,1683,824,859
Alabama,Randolph County,14,1443,718,725
Alabama,Randolph County,15,1215,584,631
Alabama,Randolph County,16,894,410,484
Alabama,Randolph County,17,582,219,363
Alabama,Randolph County,18,491,152,339
Alabama,Russell County,0,57781,27745,30036
Alabama,Russell County,1,3972,2030,1942
Alabama,Russell County,2,4017,2071,1946
Alabama,Russell County,3,3768,1931,1837
Alabama,Russell County,4,3496,1817,1679
Alabama,Russell County,5,3504,1709,1795
Alabama,Russell County,6,4759,2329,2430
Alabama,Russell County,7,4029,1885,2144
Alabama,Russell County,8,3773,1828,1945
Alabama,Russell County,9,3450,1677,1773
Alabama,Russell County,10,3582,1703,1879
Alabama,Russell County,11,3756,1812,1944
Alabama,Russell County,12,3874,1884,1990
Alabama,Russell County,13,3521,1621,1900
Alabama,Russell County,14,2811,1254,1557
Alabama,Russell County,15,2188,969,1219
Alabama,Russell County,16,1468,612,856
Alabama,Russell County,17,920,373,547
Alabama,Russell County,18,893,240,653
Alabama,St. Clair County,0,88690,44027,44663
Alabama,St. Clair County,1,5289,2684,2605
Alabama,St. Clair County,2,5596,2949,2647
Alabama,St. Clair County,3,5889,3076,2813
Alabama,St. Clair County,4,5107,2702,2405
Alabama,St. Clair County,5,4520,2372,2148
Alabama,St. Clair County,6,5914,3002,2912
Alabama,St. Clair County,7,5912,2974,2938
Alabama,St. Clair County,8,5740,2878,2862
Alabama,St. Clair County,9,5561,2755,2806
Alabama,St. Clair County,10,6287,3140,3147
Alabama,St. Clair County,11,5967,2996,2971
Alabama,St. Clair County,12,6397,3140,3257
Alabama,St. Clair County,13,5773,2773,3000
Alabama,St. Clair County,14,4937,2259,2678
Alabama,St. Clair County,15,4007,1862,2145
Alabama,St. Clair County,16,2805,1300,1505
Alabama,St. Clair County,17,1688,701,987
Alabama,St. Clair County,18,1301,464,837
Alabama,Shelby County,0,215707,104270,111437
Alabama,Shelby County,1,12461,6158,6303
Alabama,Shelby County,2,13708,6989,6719
Alabama,Shelby County,3,15182,7698,7484
Alabama,Shelby County,4,14435,7245,7190
Alabama,Shelby County,5,12533,6183,6350
Alabama,Shelby County,6,12873,6291,6582
Alabama,Shelby County,7,13290,6345,6945
Alabama,Shelby County,8,14875,7228,7647
Alabama,Shelby County,9,14686,7168,7518
Alabama,Shelby County,10,15967,7754,8213
Alabama,Shelby County,11,14622,7145,7477
Alabama,Shelby County,12,14685,7039,7646
Alabama,Shelby County,13,13303,6297,7006
Alabama,Shelby County,14,11496,5250,6246
Alabama,Shelby County,15,8784,4160,4624
Alabama,Shelby County,16,5813,2563,3250
Alabama,Shelby County,17,3578,1529,2049
Alabama,Shelby County,18,3416,1228,2188
Alabama,Sumter County,0,12691,5802,6889
Alabama,Sumter County,1,728,389,339
Alabama,Sumter County,2,615,307,308
Alabama,Sumter County,3,662,322,340
Alabama,Sumter County,4,1057,508,549
Alabama,Sumter County,5,1821,812,1009
Alabama,Sumter County,6,842,416,426
Alabama,Sumter County,7,527,259,268
Alabama,Sumter County,8,517,233,284
Alabama,Sumter County,9,536,229,307
Alabama,Sumter County,10,660,299,361
Alabama,Sumter County,11,660,287,373
Alabama,Sumter County,12,880,396,484
Alabama,Sumter County,13,900,417,483
Alabama,Sumter County,14,770,370,400
Alabama,Sumter County,15,492,223,269
Alabama,Sumter County,16,388,145,243
Alabama,Sumter County,17,276,97,179
Alabama,Sumter County,18,360,93,267
Alabama,Talladega County,0,79828,38580,41248
Alabama,Talladega County,1,4281,2229,2052
Alabama,Talladega County,2,4506,2296,2210
Alabama,Talladega County,3,4972,2398,2574
Alabama,Talladega County,4,5046,2472,2574
Alabama,Talladega County,5,4750,2310,2440
Alabama,Talladega County,6,5517,2790,2727
Alabama,Talladega County,7,4744,2355,2389
Alabama,Talladega County,8,4854,2362,2492
Alabama,Talladega County,9,4622,2254,2368
Alabama,Talladega County,10,5508,2678,2830
Alabama,Talladega County,11,5366,2636,2730
Alabama,Talladega County,12,5638,2664,2974
Alabama,Talladega County,13,5654,2693,2961
Alabama,Talladega County,14,4771,2274,2497
Alabama,Talladega County,15,3893,1811,2082
Alabama,Talladega County,16,2674,1217,1457
Alabama,Talladega County,17,1675,664,1011
Alabama,Talladega County,18,1357,477,880
Alabama,Tallapoosa County,0,40497,19632,20865
Alabama,Tallapoosa County,1,2235,1139,1096
Alabama,Tallapoosa County,2,2338,1213,1125
Alabama,Tallapoosa County,3,2395,1227,1168
Alabama,Tallapoosa County,4,2232,1132,1100
Alabama,Tallapoosa County,5,2241,1165,1076
Alabama,Tallapoosa County,6,2568,1253,1315
Alabama,Tallapoosa County,7,2056,968,1088
Alabama,Tallapoosa County,8,2063,979,1084
Alabama,Tallapoosa County,9,2074,977,1097
Alabama,Tallapoosa County,10,2568,1194,1374
Alabama,Tallapoosa County,11,2817,1355,1462
Alabama,Tallapoosa County,12,2976,1492,1484
Alabama,Tallapoosa County,13,3203,1536,1667
Alabama,Tallapoosa County,14,2845,1335,1510
Alabama,Tallapoosa County,15,2366,1118,1248
Alabama,Tallapoosa County,16,1673,776,897
Alabama,Tallapoosa County,17,1033,443,590
Alabama,Tallapoosa County,18,814,330,484
Alabama,Tuscaloosa County,0,208911,100589,108322
Alabama,Tuscaloosa County,1,12541,6425,6116
Alabama,Tuscaloosa County,2,12229,6106,6123
Alabama,Tuscaloosa County,3,11798,6033,5765
Alabama,Tuscaloosa County,4,17404,8460,8944
Alabama,Tuscaloosa County,5,24032,11838,12194
Alabama,Tuscaloosa County,6,17392,8585,8807
Alabama,Tuscaloosa County,7,13406,6644,6762
Alabama,Tuscaloosa County,8,13264,6465,6799
Alabama,Tuscaloosa County,9,11791,5612,6179
Alabama,Tuscaloosa County,10,12104,5768,6336
Alabama,Tuscaloosa County,11,11296,5412,5884
Alabama,Tuscaloosa County,12,11966,5725,6241
Alabama,Tuscaloosa County,13,11945,5549,6396
Alabama,Tuscaloosa County,14,9930,4616,5314
Alabama,Tuscaloosa County,15,6975,3205,3770
Alabama,Tuscaloosa County,16,4671,1990,2681
Alabama,Tuscaloosa County,17,3014,1169,1845
Alabama,Tuscaloosa County,18,3153,987,2166
Alabama,Walker County,0,63711,31040,32671
Alabama,Walker County,1,3832,1931,1901
Alabama,Walker County,2,3945,1975,1970
Alabama,Walker County,3,3913,2044,1869
Alabama,Walker County,4,3751,1962,1789
Alabama,Walker County,5,3614,1816,1798
Alabama,Walker County,6,4126,2089,2037
Alabama,Walker County,7,3418,1692,1726
Alabama,Walker County,8,3606,1782,1824
Alabama,Walker County,9,3719,1775,1944
Alabama,Walker County,10,4239,2186,2053
Alabama,Walker County,11,4238,2110,2128
Alabama,Walker County,12,4549,2201,2348
Alabama,Walker County,13,4450,2074,2376
Alabama,Walker County,14,3942,1857,2085
Alabama,Walker County,15,3348,1496,1852
Alabama,Walker County,16,2364,1023,1341
Alabama,Walker County,17,1590,658,932
Alabama,Walker County,18,1067,369,698
Alabama,Washington County,0,16378,8055,8323
Alabama,Washington County,1,873,429,444
Alabama,Washington County,2,928,474,454
Alabama,Washington County,3,1086,564,522
Alabama,Washington County,4,1106,596,510
Alabama,Washington County,5,956,496,460
Alabama,Washington County,6,1003,541,462
Alabama,Washington County,7,818,407,411
Alabama,Washington County,8,933,440,493
Alabama,Washington County,9,892,423,469
Alabama,Washington County,10,1119,545,574
Alabama,Washington County,11,1129,555,574
Alabama,Washington County,12,1229,604,625
Alabama,Washington County,13,1176,567,609
Alabama,Washington County,14,1004,466,538
Alabama,Washington County,15,844,406,438
Alabama,Washington County,16,574,248,326
Alabama,Washington County,17,383,174,209
Alabama,Washington County,18,325,120,205
Alabama,Wilcox County,0,10627,5056,5571
Alabama,Wilcox County,1,679,340,339
Alabama,Wilcox County,2,635,313,322
Alabama,Wilcox County,3,707,343,364
Alabama,Wilcox County,4,803,419,384
Alabama,Wilcox County,5,684,347,337
Alabama,Wilcox County,6,633,325,308
Alabama,Wilcox County,7,526,254,272
Alabama,Wilcox County,8,597,274,323
Alabama,Wilcox County,9,557,246,311
Alabama,Wilcox County,10,632,274,358
Alabama,Wilcox County,11,647,300,347
Alabama,Wilcox County,12,692,326,366
Alabama,Wilcox County,13,769,372,397
Alabama,Wilcox County,14,657,332,325
Alabama,Wilcox County,15,565,269,296
Alabama,Wilcox County,16,322,154,168
Alabama,Wilcox County,17,273,101,172
Alabama,Wilcox County,18,249,67,182
Alabama,Winston County,0,23660,11655,12005
Alabama,Winston County,1,1289,648,641
Alabama,Winston County,2,1234,649,585
Alabama,Winston County,3,1408,704,704
Alabama,Winston County,4,1394,730,664
Alabama,Winston County,5,1273,644,629
Alabama,Winston County,6,1276,641,635
Alabama,Winston County,7,1197,573,624
Alabama,Winston County,8,1292,629,663
Alabama,Winston County,9,1330,700,630
Alabama,Winston County,10,1623,832,791
Alabama,Winston County,11,1713,868,845
Alabama,Winston County,12,1832,911,921
Alabama,Winston County,13,1698,837,861
Alabama,Winston County,14,1522,740,782
Alabama,Winston County,15,1415,665,750
Alabama,Winston County,16,1002,451,551
Alabama,Winston County,17,609,253,356
Alabama,Winston County,18,553,180,373
Alaska,Aleutians East Borough,0,3515,2374,1141
Alaska,Aleutians East Borough,1,83,43,40
Alaska,Aleutians East Borough,2,85,42,43
Alaska,Aleutians East Borough,3,70,39,31
Alaska,Aleutians East Borough,4,88,57,31
Alaska,Aleutians East Borough,5,289,230,59
Alaska,Aleutians East Borough,6,309,232,77
Alaska,Aleutians East Borough,7,255,198,57
Alaska,Aleutians East Borough,8,296,211,85
Alaska,Aleutians East Borough,9,448,315,133
Alaska,Aleutians East Borough,10,377,270,107
Alaska,Aleutians East Borough,11,399,254,145
Alaska,Aleutians East Borough,12,288,179,109
Alaska,Aleutians East Borough,13,204,116,88
Alaska,Aleutians East Borough,14,107,63,44
Alaska,Aleutians East Borough,15,119,63,56
Alaska,Aleutians East Borough,16,47,31,16
Alaska,Aleutians East Borough,17,23,13,10
Alaska,Aleutians East Borough,18,28,18,10
Alaska,Aleutians West Census Area,0,5723,3750,1973
Alaska,Aleutians West Census Area,1,180,100,80
Alaska,Aleutians West Census Area,2,184,91,93
Alaska,Aleutians West Census Area,3,167,78,89
Alaska,Aleutians West Census Area,4,209,106,103
Alaska,Aleutians West Census Area,5,419,270,149
Alaska,Aleutians West Census Area,6,575,409,166
Alaska,Aleutians West Census Area,7,482,319,163
Alaska,Aleutians West Census Area,8,486,335,151
Alaska,Aleutians West Census Area,9,550,398,152
Alaska,Aleutians West Census Area,10,562,390,172
Alaska,Aleutians West Census Area,11,586,402,184
Alaska,Aleutians West Census Area,12,514,341,173
Alaska,Aleutians West Census Area,13,415,266,149
Alaska,Aleutians West Census Area,14,230,144,86
Alaska,Aleutians West Census Area,15,97,61,36
Alaska,Aleutians West Census Area,16,32,22,10
Alaska,Aleutians West Census Area,17,14,7,7
Alaska,Aleutians West Census Area,18,21,11,10
Alaska,Anchorage Municipality,0,291538,148384,143154
Alaska,Anchorage Municipality,1,20944,10545,10399
Alaska,Anchorage Municipality,2,19897,10330,9567
Alaska,Anchorage Municipality,3,19192,9874,9318
Alaska,Anchorage Municipality,4,17997,9466,8531
Alaska,Anchorage Municipality,5,21962,12361,9601
Alaska,Anchorage Municipality,6,26281,13717,12564
Alaska,Anchorage Municipality,7,24242,12483,11759
Alaska,Anchorage Municipality,8,21222,10694,10528
Alaska,Anchorage Municipality,9,17038,8587,8451
Alaska,Anchorage Municipality,10,17686,8936,8750
Alaska,Anchorage Municipality,11,17357,8633,8724
Alaska,Anchorage Municipality,12,18641,9325,9316
Alaska,Anchorage Municipality,13,16746,8201,8545
Alaska,Anchorage Municipality,14,12491,6225,6266
Alaska,Anchorage Municipality,15,8669,4253,4416
Alaska,Anchorage Municipality,16,5116,2377,2739
Alaska,Anchorage Municipality,17,3050,1277,1773
Alaska,Anchorage Municipality,18,3007,1100,1907
Alaska,Bethel Census Area,0,18216,9376,8840
Alaska,Bethel Census Area,1,2043,1064,979
Alaska,Bethel Census Area,2,1877,961,916
Alaska,Bethel Census Area,3,1640,797,843
Alaska,Bethel Census Area,4,1574,830,744
Alaska,Bethel Census Area,5,1319,642,677
Alaska,Bethel Census Area,6,1507,764,743
Alaska,Bethel Census Area,7,1318,686,632
Alaska,Bethel Census Area,8,1033,538,495
Alaska,Bethel Census Area,9,826,420,406
Alaska,Bethel Census Area,10,845,437,408
Alaska,Bethel Census Area,11,975,554,421
Alaska,Bethel Census Area,12,1036,568,468
Alaska,Bethel Census Area,13,821,443,378
Alaska,Bethel Census Area,14,596,310,286
Alaska,Bethel Census Area,15,352,177,175
Alaska,Bethel Census Area,16,238,105,133
Alaska,Bethel Census Area,17,135,59,76
Alaska,Bethel Census Area,18,81,21,60
Alaska,Bristol Bay Borough,0,877,468,409
Alaska,Bristol Bay Borough,1,56,22,34
Alaska,Bristol Bay Borough,2,55,33,22
Alaska,Bristol Bay Borough,3,33,19,14
Alaska,Bristol Bay Borough,4,43,22,21
Alaska,Bristol Bay Borough,5,56,31,25
Alaska,Bristol Bay Borough,6,67,34,33
Alaska,Bristol Bay Borough,7,71,33,38
Alaska,Bristol Bay Borough,8,48,29,19
Alaska,Bristol Bay Borough,9,48,26,22
Alaska,Bristol Bay Borough,10,55,30,25
Alaska,Bristol Bay Borough,11,53,30,23
Alaska,Bristol Bay Borough,12,98,53,45
Alaska,Bristol Bay Borough,13,67,37,30
Alaska,Bristol Bay Borough,14,54,27,27
Alaska,Bristol Bay Borough,15,29,23,6
Alaska,Bristol Bay Borough,16,19,9,10
Alaska,Bristol Bay Borough,17,20,10,10
Alaska,Bristol Bay Borough,18,5,0,5
Alaska,Denali Borough,0,2059,1146,913
Alaska,Denali Borough,1,114,67,47
Alaska,Denali Borough,2,105,58,47
Alaska,Denali Borough,3,109,65,44
Alaska,Denali Borough,4,81,41,40
Alaska,Denali Borough,5,105,65,40
Alaska,Denali Borough,6,170,101,69
Alaska,Denali Borough,7,153,83,70
Alaska,Denali Borough,8,150,69,81
Alaska,Denali Borough,9,141,69,72
Alaska,Denali Borough,10,189,106,83
Alaska,Denali Borough,11,174,84,90
Alaska,Denali Borough,12,182,99,83
Alaska,Denali Borough,13,141,84,57
Alaska,Denali Borough,14,136,87,49
Alaska,Denali Borough,15,47,30,17
Alaska,Denali Borough,16,34,20,14
Alaska,Denali Borough,17,20,13,7
Alaska,Denali Borough,18,8,5,3
Alaska,Dillingham Census Area,0,5000,2518,2482
Alaska,Dillingham Census Area,1,498,211,287
Alaska,Dillingham Census Area,2,482,236,246
Alaska,Dillingham Census Area,3,379,199,180
Alaska,Dillingham Census Area,4,363,185,178
Alaska,Dillingham Census Area,5,359,177,182
Alaska,Dillingham Census Area,6,431,215,216
Alaska,Dillingham Census Area,7,347,178,169
Alaska,Dillingham Census Area,8,289,158,131
Alaska,Dillingham Census Area,9,231,107,124
Alaska,Dillingham Census Area,10,230,121,109
Alaska,Dillingham Census Area,11,294,152,142
Alaska,Dillingham Census Area,12,335,176,159
Alaska,Dillingham Census Area,13,292,157,135
Alaska,Dillingham Census Area,14,199,107,92
Alaska,Dillingham Census Area,15,115,59,56
Alaska,Dillingham Census Area,16,80,41,39
Alaska,Dillingham Census Area,17,41,24,17
Alaska,Dillingham Census Area,18,35,15,20
Alaska,Fairbanks North Star Borough,0,98971,53310,45661
Alaska,Fairbanks North Star Borough,1,7506,3887,3619
Alaska,Fairbanks North Star Borough,2,6888,3492,3396
Alaska,Fairbanks North Star Borough,3,6125,3163,2962
Alaska,Fairbanks North Star Borough,4,5947,3210,2737
Alaska,Fairbanks North Star Borough,5,10451,6729,3722
Alaska,Fairbanks North Star Borough,6,10079,5748,4331
Alaska,Fairbanks North Star Borough,7,8408,4571,3837
Alaska,Fairbanks North Star Borough,8,6993,3800,3193
Alaska,Fairbanks North Star Borough,9,5392,2821,2571
Alaska,Fairbanks North Star Borough,10,5043,2609,2434
Alaska,Fairbanks North Star Borough,11,5092,2622,2470
Alaska,Fairbanks North Star Borough,12,5571,2775,2796
Alaska,Fairbanks North Star Borough,13,5272,2610,2662
Alaska,Fairbanks North Star Borough,14,4264,2300,1964
Alaska,Fairbanks North Star Borough,15,2850,1526,1324
Alaska,Fairbanks North Star Borough,16,1584,788,796
Alaska,Fairbanks North Star Borough,17,810,384,426
Alaska,Fairbanks North Star Borough,18,696,275,421
Alaska,Haines Borough,0,2474,1222,1252
Alaska,Haines Borough,1,89,46,43
Alaska,Haines Borough,2,111,51,60
Alaska,Haines Borough,3,129,60,69
Alaska,Haines Borough,4,141,70,71
Alaska,Haines Borough,5,110,64,46
Alaska,Haines Borough,6,97,45,52
Alaska,Haines Borough,7,146,70,76
Alaska,Haines Borough,8,150,69,81
Alaska,Haines Borough,9,147,81,66
Alaska,Haines Borough,10,145,69,76
Alaska,Haines Borough,11,179,80,99
Alaska,Haines Borough,12,229,122,107
Alaska,Haines Borough,13,255,124,131
Alaska,Haines Borough,14,223,118,105
Alaska,Haines Borough,15,168,88,80
Alaska,Haines Borough,16,68,29,39
Alaska,Haines Borough,17,38,20,18
Alaska,Haines Borough,18,49,16,33
Alaska,Hoonah-Angoon Census Area,0,2151,1134,1017
Alaska,Hoonah-Angoon Census Area,1,102,45,57
Alaska,Hoonah-Angoon Census Area,2,115,67,48
Alaska,Hoonah-Angoon Census Area,3,119,54,65
Alaska,Hoonah-Angoon Census Area,4,95,40,55
Alaska,Hoonah-Angoon Census Area,5,87,46,41
Alaska,Hoonah-Angoon Census Area,6,100,61,39
Alaska,Hoonah-Angoon Census Area,7,112,60,52
Alaska,Hoonah-Angoon Census Area,8,119,56,63
Alaska,Hoonah-Angoon Census Area,9,106,45,61
Alaska,Hoonah-Angoon Census Area,10,152,99,53
Alaska,Hoonah-Angoon Census Area,11,168,78,90
Alaska,Hoonah-Angoon Census Area,12,202,112,90
Alaska,Hoonah-Angoon Census Area,13,191,96,95
Alaska,Hoonah-Angoon Census Area,14,202,94,108
Alaska,Hoonah-Angoon Census Area,15,121,85,36
Alaska,Hoonah-Angoon Census Area,16,90,52,38
Alaska,Hoonah-Angoon Census Area,17,46,29,17
Alaska,Hoonah-Angoon Census Area,18,24,15,9
Alaska,Juneau City and Borough,0,32113,16313,15800
Alaska,Juneau City and Borough,1,1843,933,910
Alaska,Juneau City and Borough,2,1888,1011,877
Alaska,Juneau City and Borough,3,1893,954,939
Alaska,Juneau City and Borough,4,1964,985,979
Alaska,Juneau City and Borough,5,2000,1080,920
Alaska,Juneau City and Borough,6,2374,1182,1192
Alaska,Juneau City and Borough,7,2478,1259,1219
Alaska,Juneau City and Borough,8,2375,1192,1183
Alaska,Juneau City and Borough,9,2051,1059,992
Alaska,Juneau City and Borough,10,2144,1099,1045
Alaska,Juneau City and Borough,11,2153,1101,1052
Alaska,Juneau City and Borough,12,2427,1248,1179
Alaska,Juneau City and Borough,13,2225,1141,1084
Alaska,Juneau City and Borough,14,1776,877,899
Alaska,Juneau City and Borough,15,1205,637,568
Alaska,Juneau City and Borough,16,638,296,342
Alaska,Juneau City and Borough,17,351,163,188
Alaska,Juneau City and Borough,18,328,96,232
Alaska,Kenai Peninsula Borough,0,58533,30488,28045
Alaska,Kenai Peninsula Borough,1,3552,1814,1738
Alaska,Kenai Peninsula Borough,2,3733,1921,1812
Alaska,Kenai Peninsula Borough,3,3712,1941,1771
Alaska,Kenai Peninsula Borough,4,3450,1782,1668
Alaska,Kenai Peninsula Borough,5,3156,1740,1416
Alaska,Kenai Peninsula Borough,6,3775,2016,1759
Alaska,Kenai Peninsula Borough,7,3615,1896,1719
Alaska,Kenai Peninsula Borough,8,3670,1897,1773
Alaska,Kenai Peninsula Borough,9,3251,1732,1519
Alaska,Kenai Peninsula Borough,10,3469,1838,1631
Alaska,Kenai Peninsula Borough,11,3654,1859,1795
Alaska,Kenai Peninsula Borough,12,4532,2348,2184
Alaska,Kenai Peninsula Borough,13,4776,2421,2355
Alaska,Kenai Peninsula Borough,14,4137,2180,1957
Alaska,Kenai Peninsula Borough,15,2744,1464,1280
Alaska,Kenai Peninsula Borough,16,1722,918,804
Alaska,Kenai Peninsula Borough,17,895,448,447
Alaska,Kenai Peninsula Borough,18,690,273,417
Alaska,Ketchikan Gateway Borough,0,13918,7102,6816
Alaska,Ketchikan Gateway Borough,1,819,417,402
Alaska,Ketchikan Gateway Borough,2,876,415,461
Alaska,Ketchikan Gateway Borough,3,845,418,427
Alaska,Ketchikan Gateway Borough,4,864,471,393
Alaska,Ketchikan Gateway Borough,5,791,433,358
Alaska,Ketchikan Gateway Borough,6,996,521,475
Alaska,Ketchikan Gateway Borough,7,944,471,473
Alaska,Ketchikan Gateway Borough,8,984,530,454
Alaska,Ketchikan Gateway Borough,9,787,400,387
Alaska,Ketchikan Gateway Borough,10,855,424,431
Alaska,Ketchikan Gateway Borough,11,873,436,437
Alaska,Ketchikan Gateway Borough,12,1085,570,515
Alaska,Ketchikan Gateway Borough,13,1037,505,532
Alaska,Ketchikan Gateway Borough,14,814,435,379
Alaska,Ketchikan Gateway Borough,15,588,290,298
Alaska,Ketchikan Gateway Borough,16,366,191,175
Alaska,Ketchikan Gateway Borough,17,186,89,97
Alaska,Ketchikan Gateway Borough,18,208,86,122
Alaska,Kodiak Island Borough,0,13345,7096,6249
Alaska,Kodiak Island Borough,1,1042,554,488
Alaska,Kodiak Island Borough,2,961,510,451
Alaska,Kodiak Island Borough,3,900,444,456
Alaska,Kodiak Island Borough,4,840,458,382
Alaska,Kodiak Island Borough,5,911,521,390
Alaska,Kodiak Island Borough,6,1100,603,497
Alaska,Kodiak Island Borough,7,1066,561,505
Alaska,Kodiak Island Borough,8,987,530,457
Alaska,Kodiak Island Borough,9,833,455,378
Alaska,Kodiak Island Borough,10,702,359,343
Alaska,Kodiak Island Borough,11,815,450,365
Alaska,Kodiak Island Borough,12,921,512,409
Alaska,Kodiak Island Borough,13,888,473,415
Alaska,Kodiak Island Borough,14,514,270,244
Alaska,Kodiak Island Borough,15,404,201,203
Alaska,Kodiak Island Borough,16,241,107,134
Alaska,Kodiak Island Borough,17,129,62,67
Alaska,Kodiak Island Borough,18,91,26,65
Alaska,Kusilvak Census Area,0,8303,4374,3929
Alaska,Kusilvak Census Area,1,1088,564,524
Alaska,Kusilvak Census Area,2,1026,548,478
Alaska,Kusilvak Census Area,3,815,442,373
Alaska,Kusilvak Census Area,4,729,372,357
Alaska,Kusilvak Census Area,5,641,341,300
Alaska,Kusilvak Census Area,6,733,403,330
Alaska,Kusilvak Census Area,7,585,320,265
Alaska,Kusilvak Census Area,8,420,229,191
Alaska,Kusilvak Census Area,9,325,161,164
Alaska,Kusilvak Census Area,10,339,176,163
Alaska,Kusilvak Census Area,11,390,208,182
Alaska,Kusilvak Census Area,12,410,221,189
Alaska,Kusilvak Census Area,13,306,169,137
Alaska,Kusilvak Census Area,14,208,103,105
Alaska,Kusilvak Census Area,15,135,66,69
Alaska,Kusilvak Census Area,16,62,24,38
Alaska,Kusilvak Census Area,17,44,13,31
Alaska,Kusilvak Census Area,18,47,14,33
Alaska,Lake and Peninsula Borough,0,1587,813,774
Alaska,Lake and Peninsula Borough,1,161,83,78
Alaska,Lake and Peninsula Borough,2,113,49,64
Alaska,Lake and Peninsula Borough,3,115,53,62
Alaska,Lake and Peninsula Borough,4,100,49,51
Alaska,Lake and Peninsula Borough,5,89,50,39
Alaska,Lake and Peninsula Borough,6,137,66,71
Alaska,Lake and Peninsula Borough,7,97,54,43
Alaska,Lake and Peninsula Borough,8,110,56,54
Alaska,Lake and Peninsula Borough,9,97,59,38
Alaska,Lake and Peninsula Borough,10,92,40,52
Alaska,Lake and Peninsula Borough,11,99,57,42
Alaska,Lake and Peninsula Borough,12,124,64,60
Alaska,Lake and Peninsula Borough,13,91,47,44
Alaska,Lake and Peninsula Borough,14,66,34,32
Alaska,Lake and Peninsula Borough,15,46,26,20
Alaska,Lake and Peninsula Borough,16,22,13,9
Alaska,Lake and Peninsula Borough,17,15,8,7
Alaska,Lake and Peninsula Borough,18,13,5,8
Alaska,Matanuska-Susitna Borough,0,107610,55867,51743
Alaska,Matanuska-Susitna Borough,1,7681,4003,3678
Alaska,Matanuska-Susitna Borough,2,8033,4083,3950
Alaska,Matanuska-Susitna Borough,3,8418,4371,4047
Alaska,Matanuska-Susitna Borough,4,7213,3820,3393
Alaska,Matanuska-Susitna Borough,5,6198,3376,2822
Alaska,Matanuska-Susitna Borough,6,7632,4091,3541
Alaska,Matanuska-Susitna Borough,7,7790,3975,3815
Alaska,Matanuska-Susitna Borough,8,7712,3956,3756
Alaska,Matanuska-Susitna Borough,9,6721,3537,3184
Alaska,Matanuska-Susitna Borough,10,6563,3426,3137
Alaska,Matanuska-Susitna Borough,11,6561,3414,3147
Alaska,Matanuska-Susitna Borough,12,7442,3848,3594
Alaska,Matanuska-Susitna Borough,13,6832,3553,3279
Alaska,Matanuska-Susitna Borough,14,5377,2677,2700
Alaska,Matanuska-Susitna Borough,15,3389,1715,1674
Alaska,Matanuska-Susitna Borough,16,2144,1161,983
Alaska,Matanuska-Susitna Borough,17,1042,489,553
Alaska,Matanuska-Susitna Borough,18,862,372,490
Alaska,Nome Census Area,0,10008,5267,4741
Alaska,Nome Census Area,1,1009,497,512
Alaska,Nome Census Area,2,1054,554,500
Alaska,Nome Census Area,3,910,469,441
Alaska,Nome Census Area,4,787,413,374
Alaska,Nome Census Area,5,699,378,321
Alaska,Nome Census Area,6,847,431,416
Alaska,Nome Census Area,7,722,381,341
Alaska,Nome Census Area,8,640,349,291
Alaska,Nome Census Area,9,527,270,257
Alaska,Nome Census Area,10,485,247,238
Alaska,Nome Census Area,11,510,287,223
Alaska,Nome Census Area,12,570,305,265
Alaska,Nome Census Area,13,474,268,206
Alaska,Nome Census Area,14,326,189,137
Alaska,Nome Census Area,15,219,122,97
Alaska,Nome Census Area,16,115,60,55
Alaska,Nome Census Area,17,71,29,42
Alaska,Nome Census Area,18,43,18,25
Alaska,North Slope Borough,0,9872,6145,3727
Alaska,North Slope Borough,1,788,416,372
Alaska,North Slope Borough,2,780,404,376
Alaska,North Slope Borough,3,693,347,346
Alaska,North Slope Borough,4,556,280,276
Alaska,North Slope Borough,5,557,340,217
Alaska,North Slope Borough,6,825,485,340
Alaska,North Slope Borough,7,820,544,276
Alaska,North Slope Borough,8,689,473,216
Alaska,North Slope Borough,9,570,374,196
Alaska,North Slope Borough,10,677,488,189
Alaska,North Slope Borough,11,881,665,216
Alaska,North Slope Borough,12,822,585,237
Alaska,North Slope Borough,13,541,370,171
Alaska,North Slope Borough,14,310,200,110
Alaska,North Slope Borough,15,171,102,69
Alaska,North Slope Borough,16,86,40,46
Alaska,North Slope Borough,17,58,16,42
Alaska,North Slope Borough,18,48,16,32
Alaska,Northwest Arctic Borough,0,7671,4141,3530
Alaska,Northwest Arctic Borough,1,780,396,384
Alaska,Northwest Arctic Borough,2,857,468,389
Alaska,Northwest Arctic Borough,3,697,382,315
Alaska,Northwest Arctic Borough,4,601,287,314
Alaska,Northwest Arctic Borough,5,542,269,273
Alaska,Northwest Arctic Borough,6,721,415,306
Alaska,Northwest Arctic Borough,7,530,290,240
Alaska,Northwest Arctic Borough,8,449,239,210
Alaska,Northwest Arctic Borough,9,344,203,141
Alaska,Northwest Arctic Borough,10,377,210,167
Alaska,Northwest Arctic Borough,11,454,278,176
Alaska,Northwest Arctic Borough,12,425,250,175
Alaska,Northwest Arctic Borough,13,333,184,149
Alaska,Northwest Arctic Borough,14,181,99,82
Alaska,Northwest Arctic Borough,15,152,72,80
Alaska,Northwest Arctic Borough,16,90,53,37
Alaska,Northwest Arctic Borough,17,72,28,44
Alaska,Northwest Arctic Borough,18,66,18,48
Alaska,Petersburg Borough,0,3221,1700,1521
Alaska,Petersburg Borough,1,193,102,91
Alaska,Petersburg Borough,2,209,99,110
Alaska,Petersburg Borough,3,159,82,77
Alaska,Petersburg Borough,4,176,90,86
Alaska,Petersburg Borough,5,179,111,68
Alaska,Petersburg Borough,6,185,89,96
Alaska,Petersburg Borough,7,201,98,103
Alaska,Petersburg Borough,8,191,105,86
Alaska,Petersburg Borough,9,182,98,84
Alaska,Petersburg Borough,10,207,112,95
Alaska,Petersburg Borough,11,210,123,87
Alaska,Petersburg Borough,12,253,120,133
Alaska,Petersburg Borough,13,261,139,122
Alaska,Petersburg Borough,14,264,151,113
Alaska,Petersburg Borough,15,153,79,74
Alaska,Petersburg Borough,16,102,58,44
Alaska,Petersburg Borough,17,47,26,21
Alaska,Petersburg Borough,18,49,18,31
Alaska,Prince of Wales-Hyder Census Area,0,6422,3517,2905
Alaska,Prince of Wales-Hyder Census Area,1,389,217,172
Alaska,Prince of Wales-Hyder Census Area,2,418,224,194
Alaska,Prince of Wales-Hyder Census Area,3,420,232,188
Alaska,Prince of Wales-Hyder Census Area,4,395,215,180
Alaska,Prince of Wales-Hyder Census Area,5,302,157,145
Alaska,Prince of Wales-Hyder Census Area,6,362,193,169
Alaska,Prince of Wales-Hyder Census Area,7,413,201,212
Alaska,Prince of Wales-Hyder Census Area,8,373,208,165
Alaska,Prince of Wales-Hyder Census Area,9,346,195,151
Alaska,Prince of Wales-Hyder Census Area,10,362,191,171
Alaska,Prince of Wales-Hyder Census Area,11,502,288,214
Alaska,Prince of Wales-Hyder Census Area,12,521,280,241
Alaska,Prince of Wales-Hyder Census Area,13,523,297,226
Alaska,Prince of Wales-Hyder Census Area,14,479,260,219
Alaska,Prince of Wales-Hyder Census Area,15,315,188,127
Alaska,Prince of Wales-Hyder Census Area,16,165,100,65
Alaska,Prince of Wales-Hyder Census Area,17,82,46,36
Alaska,Prince of Wales-Hyder Census Area,18,55,25,30
Alaska,Sitka City and Borough,0,8647,4400,4247
Alaska,Sitka City and Borough,1,437,229,208
Alaska,Sitka City and Borough,2,515,249,266
Alaska,Sitka City and Borough,3,590,319,271
Alaska,Sitka City and Borough,4,507,264,243
Alaska,Sitka City and Borough,5,510,282,228
Alaska,Sitka City and Borough,6,618,331,287
Alaska,Sitka City and Borough,7,636,291,345
Alaska,Sitka City and Borough,8,589,298,291
Alaska,Sitka City and Borough,9,584,312,272
Alaska,Sitka City and Borough,10,531,285,246
Alaska,Sitka City and Borough,11,508,260,248
Alaska,Sitka City and Borough,12,624,329,295
Alaska,Sitka City and Borough,13,637,314,323
Alaska,Sitka City and Borough,14,501,239,262
Alaska,Sitka City and Borough,15,339,172,167
Alaska,Sitka City and Borough,16,209,102,107
Alaska,Sitka City and Borough,17,163,71,92
Alaska,Sitka City and Borough,18,149,53,96
Alaska,Skagway Municipality,0,1148,597,551
Alaska,Skagway Municipality,1,61,31,30
Alaska,Skagway Municipality,2,56,30,26
Alaska,Skagway Municipality,3,43,25,18
Alaska,Skagway Municipality,4,31,18,13
Alaska,Skagway Municipality,5,39,20,19
Alaska,Skagway Municipality,6,100,52,48
Alaska,Skagway Municipality,7,115,59,56
Alaska,Skagway Municipality,8,130,64,66
Alaska,Skagway Municipality,9,94,45,49
Alaska,Skagway Municipality,10,81,39,42
Alaska,Skagway Municipality,11,79,43,36
Alaska,Skagway Municipality,12,68,36,32
Alaska,Skagway Municipality,13,84,49,35
Alaska,Skagway Municipality,14,71,38,33
Alaska,Skagway Municipality,15,37,21,16
Alaska,Skagway Municipality,16,32,13,19
Alaska,Skagway Municipality,17,18,9,9
Alaska,Skagway Municipality,18,9,5,4
Alaska,Southeast Fairbanks Census Area,0,6918,3815,3103
Alaska,Southeast Fairbanks Census Area,1,515,248,267
Alaska,Southeast Fairbanks Census Area,2,498,257,241
Alaska,Southeast Fairbanks Census Area,3,447,222,225
Alaska,Southeast Fairbanks Census Area,4,418,231,187
Alaska,Southeast Fairbanks Census Area,5,325,176,149
Alaska,Southeast Fairbanks Census Area,6,527,301,226
Alaska,Southeast Fairbanks Census Area,7,485,288,197
Alaska,Southeast Fairbanks Census Area,8,443,246,197
Alaska,Southeast Fairbanks Census Area,9,416,235,181
Alaska,Southeast Fairbanks Census Area,10,435,259,176
Alaska,Southeast Fairbanks Census Area,11,433,247,186
Alaska,Southeast Fairbanks Census Area,12,491,287,204
Alaska,Southeast Fairbanks Census Area,13,480,261,219
Alaska,Southeast Fairbanks Census Area,14,405,229,176
Alaska,Southeast Fairbanks Census Area,15,272,153,119
Alaska,Southeast Fairbanks Census Area,16,182,104,78
Alaska,Southeast Fairbanks Census Area,17,93,50,43
Alaska,Southeast Fairbanks Census Area,18,53,21,32
Alaska,Valdez-Cordova Census Area,0,9164,4803,4361
Alaska,Valdez-Cordova Census Area,1,622,284,338
Alaska,Valdez-Cordova Census Area,2,576,299,277
Alaska,Valdez-Cordova Census Area,3,576,296,280
Alaska,Valdez-Cordova Census Area,4,567,281,286
Alaska,Valdez-Cordova Census Area,5,462,243,219
Alaska,Valdez-Cordova Census Area,6,574,299,275
Alaska,Valdez-Cordova Census Area,7,656,357,299
Alaska,Valdez-Cordova Census Area,8,619,334,285
Alaska,Valdez-Cordova Census Area,9,502,250,252
Alaska,Valdez-Cordova Census Area,10,536,302,234
Alaska,Valdez-Cordova Census Area,11,637,349,288
Alaska,Valdez-Cordova Census Area,12,806,422,384
Alaska,Valdez-Cordova Census Area,13,775,416,359
Alaska,Valdez-Cordova Census Area,14,549,307,242
Alaska,Valdez-Cordova Census Area,15,365,204,161
Alaska,Valdez-Cordova Census Area,16,183,98,85
Alaska,Valdez-Cordova Census Area,17,93,43,50
Alaska,Valdez-Cordova Census Area,18,66,19,47
Alaska,Wrangell City and Borough,0,2503,1296,1207
Alaska,Wrangell City and Borough,1,116,61,55
Alaska,Wrangell City and Borough,2,154,67,87
Alaska,Wrangell City and Borough,3,147,71,76
Alaska,Wrangell City and Borough,4,132,74,58
Alaska,Wrangell City and Borough,5,133,69,64
Alaska,Wrangell City and Borough,6,129,67,62
Alaska,Wrangell City and Borough,7,127,62,65
Alaska,Wrangell City and Borough,8,121,69,52
Alaska,Wrangell City and Borough,9,99,47,52
Alaska,Wrangell City and Borough,10,149,72,77
Alaska,Wrangell City and Borough,11,150,83,67
Alaska,Wrangell City and Borough,12,236,122,114
Alaska,Wrangell City and Borough,13,262,140,122
Alaska,Wrangell City and Borough,14,211,122,89
Alaska,Wrangell City and Borough,15,146,73,73
Alaska,Wrangell City and Borough,16,78,35,43
Alaska,Wrangell City and Borough,17,72,50,22
Alaska,Wrangell City and Borough,18,41,12,29
Alaska,Yakutat City and Borough,0,604,335,269
Alaska,Yakutat City and Borough,1,33,13,20
Alaska,Yakutat City and Borough,2,32,13,19
Alaska,Yakutat City and Borough,3,23,12,11
Alaska,Yakutat City and Borough,4,29,16,13
Alaska,Yakutat City and Borough,5,32,13,19
Alaska,Yakutat City and Borough,6,45,26,19
Alaska,Yakutat City and Borough,7,35,22,13
Alaska,Yakutat City and Borough,8,35,21,14
Alaska,Yakutat City and Borough,9,35,25,10
Alaska,Yakutat City and Borough,10,41,24,17
Alaska,Yakutat City and Borough,11,61,33,28
Alaska,Yakutat City and Borough,12,39,22,17
Alaska,Yakutat City and Borough,13,46,26,20
Alaska,Yakutat City and Borough,14,42,29,13
Alaska,Yakutat City and Borough,15,33,18,15
Alaska,Yakutat City and Borough,16,17,12,5
Alaska,Yakutat City and Borough,17,13,7,6
Alaska,Yakutat City and Borough,18,13,3,10
Alaska,Yukon-Koyukuk Census Area,0,5327,2822,2505
Alaska,Yukon-Koyukuk Census Area,1,371,190,181
Alaska,Yukon-Koyukuk Census Area,2,478,236,242
Alaska,Yukon-Koyukuk Census Area,3,393,212,181
Alaska,Yukon-Koyukuk Census Area,4,366,174,192
Alaska,Yukon-Koyukuk Census Area,5,277,141,136
Alaska,Yukon-Koyukuk Census Area,6,376,207,169
Alaska,Yukon-Koyukuk Census Area,7,344,188,156
Alaska,Yukon-Koyukuk Census Area,8,349,188,161
Alaska,Yukon-Koyukuk Census Area,9,287,156,131
Alaska,Yukon-Koyukuk Census Area,10,229,106,123
Alaska,Yukon-Koyukuk Census Area,11,312,161,151
Alaska,Yukon-Koyukuk Census Area,12,354,195,159
Alaska,Yukon-Koyukuk Census Area,13,381,206,175
Alaska,Yukon-Koyukuk Census Area,14,345,192,153
Alaska,Yukon-Koyukuk Census Area,15,197,120,77
Alaska,Yukon-Koyukuk Census Area,16,131,74,57
Alaska,Yukon-Koyukuk Census Area,17,69,38,31
Alaska,Yukon-Koyukuk Census Area,18,68,38,30
Arizona,Apache County,0,71818,35310,36508
Arizona,Apache County,1,4799,2375,2424
Arizona,Apache County,2,5457,2723,2734
Arizona,Apache County,3,5890,2898,2992
Arizona,Apache County,4,5489,2662,2827
Arizona,Apache County,5,4695,2345,2350
Arizona,Apache County,6,4998,2660,2338
Arizona,Apache County,7,4392,2309,2083
Arizona,Apache County,8,3964,2080,1884
Arizona,Apache County,9,3762,1925,1837
Arizona,Apache County,10,3833,1869,1964
Arizona,Apache County,11,4296,2089,2207
Arizona,Apache County,12,4825,2333,2492
Arizona,Apache County,13,4432,2024,2408
Arizona,Apache County,14,3645,1758,1887
Arizona,Apache County,15,2827,1307,1520
Arizona,Apache County,16,2060,929,1131
Arizona,Apache County,17,1299,581,718
Arizona,Apache County,18,1155,443,712
Arizona,Cochise County,0,126770,64380,62390
Arizona,Cochise County,1,7409,3729,3680
Arizona,Cochise County,2,7485,3802,3683
Arizona,Cochise County,3,7819,3939,3880
Arizona,Cochise County,4,8261,4422,3839
Arizona,Cochise County,5,7627,4405,3222
Arizona,Cochise County,6,8270,4552,3718
Arizona,Cochise County,7,7534,4103,3431
Arizona,Cochise County,8,7562,4055,3507
Arizona,Cochise County,9,6334,3298,3036
Arizona,Cochise County,10,6339,3219,3120
Arizona,Cochise County,11,7047,3450,3597
Arizona,Cochise County,12,8175,3805,4370
Arizona,Cochise County,13,8582,4039,4543
Arizona,Cochise County,14,8605,4123,4482
Arizona,Cochise County,15,7547,3682,3865
Arizona,Cochise County,16,5639,2711,2928
Arizona,Cochise County,17,3566,1738,1828
Arizona,Cochise County,18,2969,1308,1661
Arizona,Coconino County,0,142854,70580,72274
Arizona,Coconino County,1,7882,4111,3771
Arizona,Coconino County,2,8177,4187,3990
Arizona,Coconino County,3,8470,4349,4121
Arizona,Coconino County,4,13964,6480,7484
Arizona,Coconino County,5,19620,9225,10395
Arizona,Coconino County,6,11401,5992,5409
Arizona,Coconino County,7,8885,4601,4284
Arizona,Coconino County,8,8393,4263,4130
Arizona,Coconino County,9,7380,3827,3553
Arizona,Coconino County,10,7167,3630,3537
Arizona,Coconino County,11,7268,3617,3651
Arizona,Coconino County,12,8269,3957,4312
Arizona,Coconino County,13,8123,3826,4297
Arizona,Coconino County,14,6714,3352,3362
Arizona,Coconino County,15,4680,2292,2388
Arizona,Coconino County,16,3090,1422,1668
Arizona,Coconino County,17,1737,796,941
Arizona,Coconino County,18,1634,653,981
Arizona,Gila County,0,53889,26644,27245
Arizona,Gila County,1,3034,1559,1475
Arizona,Gila County,2,3083,1611,1472
Arizona,Gila County,3,2957,1509,1448
Arizona,Gila County,4,2754,1393,1361
Arizona,Gila County,5,2440,1248,1192
Arizona,Gila County,6,2757,1381,1376
Arizona,Gila County,7,2563,1288,1275
Arizona,Gila County,8,2535,1353,1182
Arizona,Gila County,9,2130,1000,1130
Arizona,Gila County,10,2542,1269,1273
Arizona,Gila County,11,3071,1454,1617
Arizona,Gila County,12,3908,1884,2024
Arizona,Gila County,13,4609,2195,2414
Arizona,Gila County,14,4677,2283,2394
Arizona,Gila County,15,4284,2117,2167
Arizona,Gila County,16,3081,1517,1564
Arizona,Gila County,17,1874,926,948
Arizona,Gila County,18,1590,657,933
Arizona,Graham County,0,38072,20283,17789
Arizona,Graham County,1,2730,1385,1345
Arizona,Graham County,2,2840,1495,1345
Arizona,Graham County,3,3015,1522,1493
Arizona,Graham County,4,2948,1523,1425
Arizona,Graham County,5,2735,1595,1140
Arizona,Graham County,6,2977,1722,1255
Arizona,Graham County,7,2618,1554,1064
Arizona,Graham County,8,2564,1521,1043
Arizona,Graham County,9,2341,1314,1027
Arizona,Graham County,10,2117,1189,928
Arizona,Graham County,11,1925,1048,877
Arizona,Graham County,12,1976,980,996
Arizona,Graham County,13,1976,1002,974
Arizona,Graham County,14,1652,788,864
Arizona,Graham County,15,1366,644,722
Arizona,Graham County,16,970,440,530
Arizona,Graham County,17,697,312,385
Arizona,Graham County,18,625,249,376
Arizona,Greenlee County,0,9483,4871,4612
Arizona,Greenlee County,1,756,366,390
Arizona,Greenlee County,2,712,359,353
Arizona,Greenlee County,3,721,361,360
Arizona,Greenlee County,4,644,355,289
Arizona,Greenlee County,5,594,316,278
Arizona,Greenlee County,6,718,356,362
Arizona,Greenlee County,7,687,368,319
Arizona,Greenlee County,8,702,381,321
Arizona,Greenlee County,9,572,317,255
Arizona,Greenlee County,10,537,267,270
Arizona,Greenlee County,11,529,278,251
Arizona,Greenlee County,12,528,279,249
Arizona,Greenlee County,13,535,291,244
Arizona,Greenlee County,14,409,208,201
Arizona,Greenlee County,15,294,154,140
Arizona,Greenlee County,16,206,97,109
Arizona,Greenlee County,17,148,60,88
Arizona,Greenlee County,18,191,58,133
Arizona,La Paz County,0,21098,10820,10278
Arizona,La Paz County,1,1002,510,492
Arizona,La Paz County,2,932,493,439
Arizona,La Paz County,3,1057,577,480
Arizona,La Paz County,4,900,486,414
Arizona,La Paz County,5,855,463,392
Arizona,La Paz County,6,1059,527,532
Arizona,La Paz County,7,903,434,469
Arizona,La Paz County,8,898,498,400
Arizona,La Paz County,9,796,411,385
Arizona,La Paz County,10,813,393,420
Arizona,La Paz County,11,959,445,514
Arizona,La Paz County,12,1284,609,675
Arizona,La Paz County,13,1353,651,702
Arizona,La Paz County,14,1682,802,880
Arizona,La Paz County,15,2170,1156,1014
Arizona,La Paz County,16,2054,1075,979
Arizona,La Paz County,17,1375,735,640
Arizona,La Paz County,18,1006,555,451
Arizona,Maricopa County,0,4410824,2181718,2229106
Arizona,Maricopa County,1,279620,143107,136513
Arizona,Maricopa County,2,289272,147794,141478
Arizona,Maricopa County,3,304795,155016,149779
Arizona,Maricopa County,4,295805,151600,144205
Arizona,Maricopa County,5,291532,149674,141858
Arizona,Maricopa County,6,335816,170834,164982
Arizona,Maricopa County,7,307998,157183,150815
Arizona,Maricopa County,8,298360,150147,148213
Arizona,Maricopa County,9,275928,136973,138955
Arizona,Maricopa County,10,284479,140898,143581
Arizona,Maricopa County,11,267970,131980,135990
Arizona,Maricopa County,12,268633,130855,137778
Arizona,Maricopa County,13,241331,114056,127275
Arizona,Maricopa County,14,210766,97199,113567
Arizona,Maricopa County,15,177344,81661,95683
Arizona,Maricopa County,16,123762,56327,67435
Arizona,Maricopa County,17,78789,35517,43272
Arizona,Maricopa County,18,78624,30897,47727
Arizona,Mohave County,0,209550,105979,103571
Arizona,Mohave County,1,9161,4714,4447
Arizona,Mohave County,2,9562,4779,4783
Arizona,Mohave County,3,10764,5494,5270
Arizona,Mohave County,4,9893,5096,4797
Arizona,Mohave County,5,9356,5091,4265
Arizona,Mohave County,6,11163,6090,5073
Arizona,Mohave County,7,10175,5387,4788
Arizona,Mohave County,8,9788,5141,4647
Arizona,Mohave County,9,9092,4754,4338
Arizona,Mohave County,10,10609,5366,5243
Arizona,Mohave County,11,12210,5933,6277
Arizona,Mohave County,12,16084,7716,8368
Arizona,Mohave County,13,18167,8720,9447
Arizona,Mohave County,14,18476,9000,9476
Arizona,Mohave County,15,17513,8909,8604
Arizona,Mohave County,16,13225,6784,6441
Arizona,Mohave County,17,8242,4192,4050
Arizona,Mohave County,18,6070,2813,3257
Arizona,Navajo County,0,110445,55281,55164
Arizona,Navajo County,1,7673,3851,3822
Arizona,Navajo County,2,8253,4257,3996
Arizona,Navajo County,3,8737,4435,4302
Arizona,Navajo County,4,7623,3893,3730
Arizona,Navajo County,5,6344,3379,2965
Arizona,Navajo County,6,7125,3788,3337
Arizona,Navajo County,7,6247,3252,2995
Arizona,Navajo County,8,6167,3148,3019
Arizona,Navajo County,9,5685,2937,2748
Arizona,Navajo County,10,5824,2927,2897
Arizona,Navajo County,11,6202,3001,3201
Arizona,Navajo County,12,7239,3443,3796
Arizona,Navajo County,13,7316,3511,3805
Arizona,Navajo County,14,6709,3176,3533
Arizona,Navajo County,15,5398,2658,2740
Arizona,Navajo County,16,3787,1811,1976
Arizona,Navajo County,17,2309,1069,1240
Arizona,Navajo County,18,1807,745,1062
Arizona,Pima County,0,1039073,511456,527617
Arizona,Pima County,1,58491,29898,28593
Arizona,Pima County,2,59449,30185,29264
Arizona,Pima County,3,61965,31804,30161
Arizona,Pima County,4,68872,34523,34349
Arizona,Pima County,5,90267,46165,44102
Arizona,Pima County,6,72913,38272,34641
Arizona,Pima County,7,60111,31316,28795
Arizona,Pima County,8,61967,31304,30663
Arizona,Pima County,9,56528,28082,28446
Arizona,Pima County,10,57185,28099,29086
Arizona,Pima County,11,56656,27632,29024
Arizona,Pima County,12,64018,30629,33389
Arizona,Pima County,13,65396,30360,35036
Arizona,Pima County,14,62486,28987,33499
Arizona,Pima County,15,54013,25155,28858
Arizona,Pima County,16,38553,17610,20943
Arizona,Pima County,17,24765,11303,13462
Arizona,Pima County,18,25438,10132,15306
Arizona,Pinal County,0,447138,232917,214221
Arizona,Pinal County,1,25250,12870,12380
Arizona,Pinal County,2,28421,14291,14130
Arizona,Pinal County,3,30354,15631,14723
Arizona,Pinal County,4,26891,14114,12777
Arizona,Pinal County,5,25002,14467,10535
Arizona,Pinal County,6,29377,17048,12329
Arizona,Pinal County,7,29347,16556,12791
Arizona,Pinal County,8,30507,16724,13783
Arizona,Pinal County,9,27795,15217,12578
Arizona,Pinal County,10,26164,14366,11798
Arizona,Pinal County,11,23816,12369,11447
Arizona,Pinal County,12,25694,12689,13005
Arizona,Pinal County,13,27391,12593,14798
Arizona,Pinal County,14,28189,12997,15192
Arizona,Pinal County,15,26681,13029,13652
Arizona,Pinal County,16,18555,9260,9295
Arizona,Pinal County,17,10151,5174,4977
Arizona,Pinal County,18,7553,3522,4031
Arizona,Santa Cruz County,0,46511,22473,24038
Arizona,Santa Cruz County,1,3211,1665,1546
Arizona,Santa Cruz County,2,3407,1720,1687
Arizona,Santa Cruz County,3,3652,1877,1775
Arizona,Santa Cruz County,4,3569,1777,1792
Arizona,Santa Cruz County,5,2995,1535,1460
Arizona,Santa Cruz County,6,2761,1418,1343
Arizona,Santa Cruz County,7,2447,1202,1245
Arizona,Santa Cruz County,8,2526,1153,1373
Arizona,Santa Cruz County,9,2534,1199,1335
Arizona,Santa Cruz County,10,2594,1218,1376
Arizona,Santa Cruz County,11,2682,1235,1447
Arizona,Santa Cruz County,12,2845,1350,1495
Arizona,Santa Cruz County,13,2867,1289,1578
Arizona,Santa Cruz County,14,2610,1181,1429
Arizona,Santa Cruz County,15,2305,1117,1188
Arizona,Santa Cruz County,16,1603,738,865
Arizona,Santa Cruz County,17,962,429,533
Arizona,Santa Cruz County,18,941,370,571
Arizona,Yavapai County,0,231993,113321,118672
Arizona,Yavapai County,1,9689,5118,4571
Arizona,Yavapai County,2,9968,5000,4968
Arizona,Yavapai County,3,11316,5748,5568
Arizona,Yavapai County,4,11367,6084,5283
Arizona,Yavapai County,5,10435,5604,4831
Arizona,Yavapai County,6,10934,5729,5205
Arizona,Yavapai County,7,10165,5161,5004
Arizona,Yavapai County,8,10402,5323,5079
Arizona,Yavapai County,9,9990,4907,5083
Arizona,Yavapai County,10,11298,5508,5790
Arizona,Yavapai County,11,13205,6241,6964
Arizona,Yavapai County,12,17964,8207,9757
Arizona,Yavapai County,13,21982,9860,12122
Arizona,Yavapai County,14,23388,10863,12525
Arizona,Yavapai County,15,20154,9809,10345
Arizona,Yavapai County,16,13995,6882,7113
Arizona,Yavapai County,17,8316,4094,4222
Arizona,Yavapai County,18,7425,3183,4242
Arizona,Yuma County,0,212128,109306,102822
Arizona,Yuma County,1,15229,7702,7527
Arizona,Yuma County,2,14708,7500,7208
Arizona,Yuma County,3,14909,7733,7176
Arizona,Yuma County,4,14814,7751,7063
Arizona,Yuma County,5,17679,10640,7039
Arizona,Yuma County,6,15711,8754,6957
Arizona,Yuma County,7,13793,7527,6266
Arizona,Yuma County,8,12552,6668,5884
Arizona,Yuma County,9,10677,5553,5124
Arizona,Yuma County,10,10664,5128,5536
Arizona,Yuma County,11,10789,5266,5523
Arizona,Yuma County,12,10643,5180,5463
Arizona,Yuma County,13,10132,4851,5281
Arizona,Yuma County,14,9721,4536,5185
Arizona,Yuma County,15,9857,4645,5212
Arizona,Yuma County,16,8914,4212,4702
Arizona,Yuma County,17,6089,3064,3025
Arizona,Yuma County,18,5247,2596,2651
Arkansas,Arkansas County,0,17769,8593,9176
Arkansas,Arkansas County,1,1179,602,577
Arkansas,Arkansas County,2,1163,586,577
Arkansas,Arkansas County,3,1079,550,529
Arkansas,Arkansas County,4,1016,516,500
Arkansas,Arkansas County,5,975,475,500
Arkansas,Arkansas County,6,1113,536,577
Arkansas,Arkansas County,7,923,444,479
Arkansas,Arkansas County,8,1009,477,532
Arkansas,Arkansas County,9,1075,538,537
Arkansas,Arkansas County,10,1067,541,526
Arkansas,Arkansas County,11,1140,533,607
Arkansas,Arkansas County,12,1278,609,669
Arkansas,Arkansas County,13,1268,620,648
Arkansas,Arkansas County,14,1120,548,572
Arkansas,Arkansas County,15,884,444,440
Arkansas,Arkansas County,16,598,254,344
Arkansas,Arkansas County,17,443,171,272
Arkansas,Arkansas County,18,439,149,290
Arkansas,Ashley County,0,20046,9771,10275
Arkansas,Ashley County,1,1226,630,596
Arkansas,Ashley County,2,1295,687,608
Arkansas,Ashley County,3,1251,606,645
Arkansas,Ashley County,4,1242,653,589
Arkansas,Ashley County,5,1078,555,523
Arkansas,Ashley County,6,1241,597,644
Arkansas,Ashley County,7,1007,491,516
Arkansas,Ashley County,8,1096,516,580
Arkansas,Ashley County,9,1137,532,605
Arkansas,Ashley County,10,1326,618,708
Arkansas,Ashley County,11,1298,637,661
Arkansas,Ashley County,12,1467,718,749
Arkansas,Ashley County,13,1301,644,657
Arkansas,Ashley County,14,1262,607,655
Arkansas,Ashley County,15,1105,524,581
Arkansas,Ashley County,16,808,375,433
Arkansas,Ashley County,17,531,238,293
Arkansas,Ashley County,18,375,143,232
Arkansas,Baxter County,0,41619,20096,21523
Arkansas,Baxter County,1,1921,995,926
Arkansas,Baxter County,2,1933,994,939
Arkansas,Baxter County,3,2229,1135,1094
Arkansas,Baxter County,4,1978,1035,943
Arkansas,Baxter County,5,1748,874,874
Arkansas,Baxter County,6,2009,1028,981
Arkansas,Baxter County,7,1905,942,963
Arkansas,Baxter County,8,2006,947,1059
Arkansas,Baxter County,9,1825,914,911
Arkansas,Baxter County,10,2221,1073,1148
Arkansas,Baxter County,11,2440,1154,1286
Arkansas,Baxter County,12,3185,1467,1718
Arkansas,Baxter County,13,3359,1531,1828
Arkansas,Baxter County,14,3441,1597,1844
Arkansas,Baxter County,15,3318,1561,1757
Arkansas,Baxter County,16,2760,1287,1473
Arkansas,Baxter County,17,1742,869,873
Arkansas,Baxter County,18,1599,693,906
Arkansas,Benton County,0,272608,135582,137026
Arkansas,Benton County,1,19055,9851,9204
Arkansas,Benton County,2,19875,10103,9772
Arkansas,Benton County,3,20673,10633,10040
Arkansas,Benton County,4,18363,9357,9006
Arkansas,Benton County,5,15702,7851,7851
Arkansas,Benton County,6,19642,9937,9705
Arkansas,Benton County,7,20493,10409,10084
Arkansas,Benton County,8,21042,10718,10324
Arkansas,Benton County,9,17895,9156,8739
Arkansas,Benton County,10,17964,8890,9074
Arkansas,Benton County,11,16020,8090,7930
Arkansas,Benton County,12,15605,7653,7952
Arkansas,Benton County,13,13722,6533,7189
Arkansas,Benton County,14,11626,5388,6238
Arkansas,Benton County,15,9745,4522,5223
Arkansas,Benton County,16,6651,2999,3652
Arkansas,Benton County,17,4361,1897,2464
Arkansas,Benton County,18,4174,1595,2579
Arkansas,Boone County,0,37480,18443,19037
Arkansas,Boone County,1,2387,1232,1155
Arkansas,Boone County,2,2317,1211,1106
Arkansas,Boone County,3,2484,1265,1219
Arkansas,Boone County,4,2138,1146,992
Arkansas,Boone County,5,1989,1003,986
Arkansas,Boone County,6,2374,1202,1172
Arkansas,Boone County,7,2022,1009,1013
Arkansas,Boone County,8,2191,1113,1078
Arkansas,Boone County,9,2071,1024,1047
Arkansas,Boone County,10,2307,1130,1177
Arkansas,Boone County,11,2368,1153,1215
Arkansas,Boone County,12,2684,1315,1369
Arkansas,Boone County,13,2405,1143,1262
Arkansas,Boone County,14,2279,1061,1218
Arkansas,Boone County,15,2069,982,1087
Arkansas,Boone County,16,1493,659,834
Arkansas,Boone County,17,970,424,546
Arkansas,Boone County,18,932,371,561
Arkansas,Bradley County,0,10897,5306,5591
Arkansas,Bradley County,1,662,348,314
Arkansas,Bradley County,2,756,393,363
Arkansas,Bradley County,3,762,405,357
Arkansas,Bradley County,4,654,311,343
Arkansas,Bradley County,5,543,252,291
Arkansas,Bradley County,6,677,335,342
Arkansas,Bradley County,7,641,336,305
Arkansas,Bradley County,8,657,346,311
Arkansas,Bradley County,9,648,305,343
Arkansas,Bradley County,10,664,335,329
Arkansas,Bradley County,11,696,332,364
Arkansas,Bradley County,12,733,332,401
Arkansas,Bradley County,13,737,357,380
Arkansas,Bradley County,14,620,297,323
Arkansas,Bradley County,15,512,247,265
Arkansas,Bradley County,16,399,161,238
Arkansas,Bradley County,17,257,124,133
Arkansas,Bradley County,18,279,90,189
Arkansas,Calhoun County,0,5277,2662,2615
Arkansas,Calhoun County,1,237,127,110
Arkansas,Calhoun County,2,284,134,150
Arkansas,Calhoun County,3,296,150,146
Arkansas,Calhoun County,4,296,165,131
Arkansas,Calhoun County,5,291,167,124
Arkansas,Calhoun County,6,333,175,158
Arkansas,Calhoun County,7,291,153,138
Arkansas,Calhoun County,8,273,151,122
Arkansas,Calhoun County,9,288,136,152
Arkansas,Calhoun County,10,341,178,163
Arkansas,Calhoun County,11,373,189,184
Arkansas,Calhoun County,12,440,231,209
Arkansas,Calhoun County,13,397,201,196
Arkansas,Calhoun County,14,376,183,193
Arkansas,Calhoun County,15,289,134,155
Arkansas,Calhoun County,16,194,85,109
Arkansas,Calhoun County,17,156,59,97
Arkansas,Calhoun County,18,122,44,78
Arkansas,Carroll County,0,28223,14047,14176
Arkansas,Carroll County,1,1654,864,790
Arkansas,Carroll County,2,1613,803,810
Arkansas,Carroll County,3,1759,879,880
Arkansas,Carroll County,4,1673,866,807
Arkansas,Carroll County,5,1487,806,681
Arkansas,Carroll County,6,1534,790,744
Arkansas,Carroll County,7,1452,730,722
Arkansas,Carroll County,8,1488,754,734
Arkansas,Carroll County,9,1487,715,772
Arkansas,Carroll County,10,1623,818,805
Arkansas,Carroll County,11,1741,865,876
Arkansas,Carroll County,12,1985,999,986
Arkansas,Carroll County,13,2183,1019,1164
Arkansas,Carroll County,14,2190,1091,1099
Arkansas,Carroll County,15,1807,910,897
Arkansas,Carroll County,16,1206,590,616
Arkansas,Carroll County,17,705,307,398
Arkansas,Carroll County,18,636,241,395
Arkansas,Chicot County,0,10438,5272,5166
Arkansas,Chicot County,1,599,321,278
Arkansas,Chicot County,2,663,346,317
Arkansas,Chicot County,3,698,372,326
Arkansas,Chicot County,4,599,317,282
Arkansas,Chicot County,5,637,386,251
Arkansas,Chicot County,6,608,362,246
Arkansas,Chicot County,7,550,300,250
Arkansas,Chicot County,8,577,314,263
Arkansas,Chicot County,9,525,275,250
Arkansas,Chicot County,10,641,329,312
Arkansas,Chicot County,11,612,301,311
Arkansas,Chicot County,12,804,386,418
Arkansas,Chicot County,13,803,385,418
Arkansas,Chicot County,14,656,299,357
Arkansas,Chicot County,15,471,201,270
Arkansas,Chicot County,16,408,185,223
Arkansas,Chicot County,17,269,100,169
Arkansas,Chicot County,18,318,93,225
Arkansas,Clark County,0,22061,10452,11609
Arkansas,Clark County,1,1161,578,583
Arkansas,Clark County,2,1131,577,554
Arkansas,Clark County,3,1225,603,622
Arkansas,Clark County,4,2215,1034,1181
Arkansas,Clark County,5,3203,1515,1688
Arkansas,Clark County,6,1334,643,691
Arkansas,Clark County,7,1104,544,560
Arkansas,Clark County,8,1045,517,528
Arkansas,Clark County,9,1076,511,565
Arkansas,Clark County,10,1165,562,603
Arkansas,Clark County,11,1162,549,613
Arkansas,Clark County,12,1294,585,709
Arkansas,Clark County,13,1259,597,662
Arkansas,Clark County,14,1106,524,582
Arkansas,Clark County,15,943,447,496
Arkansas,Clark County,16,705,307,398
Arkansas,Clark County,17,475,201,274
Arkansas,Clark County,18,458,158,300
Arkansas,Clay County,0,14847,7255,7592
Arkansas,Clay County,1,924,443,481
Arkansas,Clay County,2,848,436,412
Arkansas,Clay County,3,911,466,445
Arkansas,Clay County,4,850,432,418
Arkansas,Clay County,5,814,407,407
Arkansas,Clay County,6,936,492,444
Arkansas,Clay County,7,754,371,383
Arkansas,Clay County,8,850,431,419
Arkansas,Clay County,9,802,408,394
Arkansas,Clay County,10,908,449,459
Arkansas,Clay County,11,1005,521,484
Arkansas,Clay County,12,1079,528,551
Arkansas,Clay County,13,987,481,506
Arkansas,Clay County,14,877,386,491
Arkansas,Clay County,15,859,413,446
Arkansas,Clay County,16,629,272,357
Arkansas,Clay County,17,453,190,263
Arkansas,Clay County,18,361,129,232
Arkansas,Cleburne County,0,24965,12277,12688
Arkansas,Cleburne County,1,1095,563,532
Arkansas,Cleburne County,2,1328,681,647
Arkansas,Cleburne County,3,1435,728,707
Arkansas,Cleburne County,4,1322,702,620
Arkansas,Cleburne County,5,1108,589,519
Arkansas,Cleburne County,6,1224,608,616
Arkansas,Cleburne County,7,1198,602,596
Arkansas,Cleburne County,8,1343,665,678
Arkansas,Cleburne County,9,1312,626,686
Arkansas,Cleburne County,10,1368,716,652
Arkansas,Cleburne County,11,1648,806,842
Arkansas,Cleburne County,12,1965,1006,959
Arkansas,Cleburne County,13,1932,888,1044
Arkansas,Cleburne County,14,1784,830,954
Arkansas,Cleburne County,15,1784,855,929
Arkansas,Cleburne County,16,1383,674,709
Arkansas,Cleburne County,17,883,397,486
Arkansas,Cleburne County,18,853,341,512
Arkansas,Cleveland County,0,8018,3978,4040
Arkansas,Cleveland County,1,412,224,188
Arkansas,Cleveland County,2,439,226,213
Arkansas,Cleveland County,3,577,288,289
Arkansas,Cleveland County,4,506,259,247
Arkansas,Cleveland County,5,407,207,200
Arkansas,Cleveland County,6,436,213,223
Arkansas,Cleveland County,7,424,223,201
Arkansas,Cleveland County,8,459,226,233
Arkansas,Cleveland County,9,461,215,246
Arkansas,Cleveland County,10,523,250,273
Arkansas,Cleveland County,11,519,284,235
Arkansas,Cleveland County,12,626,312,314
Arkansas,Cleveland County,13,546,269,277
Arkansas,Cleveland County,14,530,249,281
Arkansas,Cleveland County,15,453,224,229
Arkansas,Cleveland County,16,305,152,153
Arkansas,Cleveland County,17,222,89,133
Arkansas,Cleveland County,18,173,68,105
Arkansas,Columbia County,0,23537,11352,12185
Arkansas,Columbia County,1,1360,727,633
Arkansas,Columbia County,2,1348,690,658
Arkansas,Columbia County,3,1362,690,672
Arkansas,Columbia County,4,2268,1154,1114
Arkansas,Columbia County,5,2621,1339,1282
Arkansas,Columbia County,6,1439,684,755
Arkansas,Columbia County,7,1206,589,617
Arkansas,Columbia County,8,1263,611,652
Arkansas,Columbia County,9,1108,501,607
Arkansas,Columbia County,10,1252,566,686
Arkansas,Columbia County,11,1319,637,682
Arkansas,Columbia County,12,1476,705,771
Arkansas,Columbia County,13,1414,692,722
Arkansas,Columbia County,14,1219,582,637
Arkansas,Columbia County,15,1005,449,556
Arkansas,Columbia County,16,735,319,416
Arkansas,Columbia County,17,572,214,358
Arkansas,Columbia County,18,570,203,367
Arkansas,Conway County,0,20891,10260,10631
Arkansas,Conway County,1,1222,630,592
Arkansas,Conway County,2,1345,658,687
Arkansas,Conway County,3,1279,639,640
Arkansas,Conway County,4,1275,677,598
Arkansas,Conway County,5,1034,515,519
Arkansas,Conway County,6,1322,679,643
Arkansas,Conway County,7,1181,571,610
Arkansas,Conway County,8,1222,601,621
Arkansas,Conway County,9,1185,596,589
Arkansas,Conway County,10,1248,607,641
Arkansas,Conway County,11,1427,705,722
Arkansas,Conway County,12,1556,776,780
Arkansas,Conway County,13,1500,720,780
Arkansas,Conway County,14,1204,592,612
Arkansas,Conway County,15,1061,493,568
Arkansas,Conway County,16,764,362,402
Arkansas,Conway County,17,539,241,298
Arkansas,Conway County,18,527,198,329
Arkansas,Craighead County,0,108558,52730,55828
Arkansas,Craighead County,1,7597,3966,3631
Arkansas,Craighead County,2,7553,3857,3696
Arkansas,Craighead County,3,7498,3856,3642
Arkansas,Craighead County,4,7943,4101,3842
Arkansas,Craighead County,5,7941,4001,3940
Arkansas,Craighead County,6,8893,4317,4576
Arkansas,Craighead County,7,7846,3813,4033
Arkansas,Craighead County,8,7299,3581,3718
Arkansas,Craighead County,9,6590,3247,3343
Arkansas,Craighead County,10,6387,3132,3255
Arkansas,Craighead County,11,6080,2914,3166
Arkansas,Craighead County,12,6193,2970,3223
Arkansas,Craighead County,13,5708,2602,3106
Arkansas,Craighead County,14,4875,2217,2658
Arkansas,Craighead County,15,3776,1678,2098
Arkansas,Craighead County,16,2743,1122,1621
Arkansas,Craighead County,17,1791,705,1086
Arkansas,Craighead County,18,1845,651,1194
Arkansas,Crawford County,0,63406,31258,32148
Arkansas,Crawford County,1,3970,1999,1971
Arkansas,Crawford County,2,4228,2116,2112
Arkansas,Crawford County,3,4578,2373,2205
Arkansas,Crawford County,4,4182,2159,2023
Arkansas,Crawford County,5,3544,1816,1728
Arkansas,Crawford County,6,4094,2030,2064
Arkansas,Crawford County,7,3912,1969,1943
Arkansas,Crawford County,8,3821,1894,1927
Arkansas,Crawford County,9,3905,1928,1977
Arkansas,Crawford County,10,4087,1988,2099
Arkansas,Crawford County,11,4124,2061,2063
Arkansas,Crawford County,12,4353,2193,2160
Arkansas,Crawford County,13,4061,1958,2103
Arkansas,Crawford County,14,3364,1611,1753
Arkansas,Crawford County,15,2773,1280,1493
Arkansas,Crawford County,16,2059,952,1107
Arkansas,Crawford County,17,1267,542,725
Arkansas,Crawford County,18,1084,389,695
Arkansas,Crittenden County,0,48342,23011,25331
Arkansas,Crittenden County,1,3686,1896,1790
Arkansas,Crittenden County,2,3531,1816,1715
Arkansas,Crittenden County,3,3633,1830,1803
Arkansas,Crittenden County,4,3478,1790,1688
Arkansas,Crittenden County,5,3062,1490,1572
Arkansas,Crittenden County,6,3392,1616,1776
Arkansas,Crittenden County,7,3022,1399,1623
Arkansas,Crittenden County,8,2944,1359,1585
Arkansas,Crittenden County,9,2771,1289,1482
Arkansas,Crittenden County,10,2893,1335,1558
Arkansas,Crittenden County,11,3014,1339,1675
Arkansas,Crittenden County,12,3234,1595,1639
Arkansas,Crittenden County,13,2844,1291,1553
Arkansas,Crittenden County,14,2296,1092,1204
Arkansas,Crittenden County,15,1763,774,989
Arkansas,Crittenden County,16,1278,575,703
Arkansas,Crittenden County,17,753,288,465
Arkansas,Crittenden County,18,748,237,511
Arkansas,Cross County,0,16676,8044,8632
Arkansas,Cross County,1,1047,514,533
Arkansas,Cross County,2,1058,537,521
Arkansas,Cross County,3,1145,576,569
Arkansas,Cross County,4,1045,551,494
Arkansas,Cross County,5,945,498,447
Arkansas,Cross County,6,1008,475,533
Arkansas,Cross County,7,901,426,475
Arkansas,Cross County,8,1003,469,534
Arkansas,Cross County,9,1029,496,533
Arkansas,Cross County,10,1040,518,522
Arkansas,Cross County,11,1045,508,537
Arkansas,Cross County,12,1201,571,630
Arkansas,Cross County,13,1079,522,557
Arkansas,Cross County,14,932,456,476
Arkansas,Cross County,15,867,377,490
Arkansas,Cross County,16,604,268,336
Arkansas,Cross County,17,360,150,210
Arkansas,Cross County,18,367,132,235
Arkansas,Dallas County,0,7182,3549,3633
Arkansas,Dallas County,1,376,191,185
Arkansas,Dallas County,2,409,230,179
Arkansas,Dallas County,3,468,255,213
Arkansas,Dallas County,4,422,216,206
Arkansas,Dallas County,5,363,187,176
Arkansas,Dallas County,6,410,203,207
Arkansas,Dallas County,7,361,189,172
Arkansas,Dallas County,8,412,212,200
Arkansas,Dallas County,9,335,163,172
Arkansas,Dallas County,10,418,220,198
Arkansas,Dallas County,11,425,189,236
Arkansas,Dallas County,12,544,275,269
Arkansas,Dallas County,13,574,303,271
Arkansas,Dallas County,14,497,242,255
Arkansas,Dallas County,15,432,191,241
Arkansas,Dallas County,16,302,131,171
Arkansas,Dallas County,17,188,77,111
Arkansas,Dallas County,18,246,75,171
Arkansas,Desha County,0,11512,5437,6075
Arkansas,Desha County,1,772,436,336
Arkansas,Desha County,2,831,395,436
Arkansas,Desha County,3,842,424,418
Arkansas,Desha County,4,755,370,385
Arkansas,Desha County,5,614,272,342
Arkansas,Desha County,6,644,294,350
Arkansas,Desha County,7,642,303,339
Arkansas,Desha County,8,654,287,367
Arkansas,Desha County,9,601,295,306
Arkansas,Desha County,10,607,295,312
Arkansas,Desha County,11,689,306,383
Arkansas,Desha County,12,819,388,431
Arkansas,Desha County,13,854,417,437
Arkansas,Desha County,14,716,328,388
Arkansas,Desha County,15,545,259,286
Arkansas,Desha County,16,414,174,240
Arkansas,Desha County,17,267,122,145
Arkansas,Desha County,18,246,72,174
Arkansas,Drew County,0,18328,8955,9373
Arkansas,Drew County,1,1096,610,486
Arkansas,Drew County,2,1045,557,488
Arkansas,Drew County,3,1117,562,555
Arkansas,Drew County,4,1409,735,674
Arkansas,Drew County,5,1788,922,866
Arkansas,Drew County,6,1272,637,635
Arkansas,Drew County,7,974,482,492
Arkansas,Drew County,8,1041,506,535
Arkansas,Drew County,9,979,469,510
Arkansas,Drew County,10,1003,455,548
Arkansas,Drew County,11,1078,501,577
Arkansas,Drew County,12,1202,559,643
Arkansas,Drew County,13,1117,586,531
Arkansas,Drew County,14,964,435,529
Arkansas,Drew County,15,756,351,405
Arkansas,Drew County,16,615,254,361
Arkansas,Drew County,17,466,196,270
Arkansas,Drew County,18,406,138,268
Arkansas,Faulkner County,0,124806,60992,63814
Arkansas,Faulkner County,1,7621,3977,3644
Arkansas,Faulkner County,2,7911,4117,3794
Arkansas,Faulkner County,3,8366,4228,4138
Arkansas,Faulkner County,4,9078,4545,4533
Arkansas,Faulkner County,5,14476,6949,7527
Arkansas,Faulkner County,6,9541,4728,4813
Arkansas,Faulkner County,7,8473,4226,4247
Arkansas,Faulkner County,8,8127,4074,4053
Arkansas,Faulkner County,9,7384,3606,3778
Arkansas,Faulkner County,10,7516,3737,3779
Arkansas,Faulkner County,11,7074,3378,3696
Arkansas,Faulkner County,12,7264,3557,3707
Arkansas,Faulkner County,13,6393,3010,3383
Arkansas,Faulkner County,14,5277,2444,2833
Arkansas,Faulkner County,15,4207,1946,2261
Arkansas,Faulkner County,16,2769,1195,1574
Arkansas,Faulkner County,17,1728,725,1003
Arkansas,Faulkner County,18,1601,550,1051
Arkansas,Franklin County,0,17810,8908,8902
Arkansas,Franklin County,1,993,519,474
Arkansas,Franklin County,2,1103,594,509
Arkansas,Franklin County,3,1223,624,599
Arkansas,Franklin County,4,1183,640,543
Arkansas,Franklin County,5,1011,587,424
Arkansas,Franklin County,6,1071,561,510
Arkansas,Franklin County,7,949,461,488
Arkansas,Franklin County,8,1084,552,532
Arkansas,Franklin County,9,1037,527,510
Arkansas,Franklin County,10,1090,534,556
Arkansas,Franklin County,11,1136,560,576
Arkansas,Franklin County,12,1299,628,671
Arkansas,Franklin County,13,1188,565,623
Arkansas,Franklin County,14,1047,514,533
Arkansas,Franklin County,15,850,387,463
Arkansas,Franklin County,16,648,291,357
Arkansas,Franklin County,17,460,216,244
Arkansas,Franklin County,18,438,148,290
Arkansas,Fulton County,0,12269,6021,6248
Arkansas,Fulton County,1,601,305,296
Arkansas,Fulton County,2,656,357,299
Arkansas,Fulton County,3,787,398,389
Arkansas,Fulton County,4,722,386,336
Arkansas,Fulton County,5,585,300,285
Arkansas,Fulton County,6,559,267,292
Arkansas,Fulton County,7,546,277,269
Arkansas,Fulton County,8,610,284,326
Arkansas,Fulton County,9,583,291,292
Arkansas,Fulton County,10,735,362,373
Arkansas,Fulton County,11,782,384,398
Arkansas,Fulton County,12,920,427,493
Arkansas,Fulton County,13,962,451,511
Arkansas,Fulton County,14,964,466,498
Arkansas,Fulton County,15,816,385,431
Arkansas,Fulton County,16,654,317,337
Arkansas,Fulton County,17,410,209,201
Arkansas,Fulton County,18,377,155,222
Arkansas,Garland County,0,99154,47660,51494
Arkansas,Garland County,1,5336,2718,2618
Arkansas,Garland County,2,5470,2857,2613
Arkansas,Garland County,3,5619,2829,2790
Arkansas,Garland County,4,5592,2927,2665
Arkansas,Garland County,5,5056,2541,2515
Arkansas,Garland County,6,5955,2975,2980
Arkansas,Garland County,7,5359,2588,2771
Arkansas,Garland County,8,5585,2740,2845
Arkansas,Garland County,9,5291,2545,2746
Arkansas,Garland County,10,5834,2744,3090
Arkansas,Garland County,11,6093,2918,3175
Arkansas,Garland County,12,7044,3343,3701
Arkansas,Garland County,13,7288,3354,3934
Arkansas,Garland County,14,7174,3264,3910
Arkansas,Garland County,15,6140,2813,3327
Arkansas,Garland County,16,4577,2121,2456
Arkansas,Garland County,17,2916,1329,1587
Arkansas,Garland County,18,2825,1054,1771
Arkansas,Grant County,0,18188,8985,9203
Arkansas,Grant County,1,980,468,512
Arkansas,Grant County,2,1119,571,548
Arkansas,Grant County,3,1218,644,574
Arkansas,Grant County,4,1161,579,582
Arkansas,Grant County,5,967,481,486
Arkansas,Grant County,6,1134,581,553
Arkansas,Grant County,7,1062,549,513
Arkansas,Grant County,8,1161,583,578
Arkansas,Grant County,9,1145,553,592
Arkansas,Grant County,10,1213,620,593
Arkansas,Grant County,11,1236,590,646
Arkansas,Grant County,12,1354,687,667
Arkansas,Grant County,13,1163,569,594
Arkansas,Grant County,14,1001,500,501
Arkansas,Grant County,15,896,437,459
Arkansas,Grant County,16,642,276,366
Arkansas,Grant County,17,368,163,205
Arkansas,Grant County,18,368,134,234
Arkansas,Greene County,0,45325,22289,23036
Arkansas,Greene County,1,2968,1542,1426
Arkansas,Greene County,2,3080,1539,1541
Arkansas,Greene County,3,3158,1626,1532
Arkansas,Greene County,4,2932,1487,1445
Arkansas,Greene County,5,2694,1398,1296
Arkansas,Greene County,6,3170,1556,1614
Arkansas,Greene County,7,2856,1410,1446
Arkansas,Greene County,8,2915,1469,1446
Arkansas,Greene County,9,2872,1446,1426
Arkansas,Greene County,10,3081,1534,1547
Arkansas,Greene County,11,2930,1446,1484
Arkansas,Greene County,12,2891,1411,1480
Arkansas,Greene County,13,2536,1227,1309
Arkansas,Greene County,14,2318,1089,1229
Arkansas,Greene County,15,1905,886,1019
Arkansas,Greene County,16,1380,595,785
Arkansas,Greene County,17,876,359,517
Arkansas,Greene County,18,763,269,494
Arkansas,Hempstead County,0,21741,10482,11259
Arkansas,Hempstead County,1,1565,817,748
Arkansas,Hempstead County,2,1631,823,808
Arkansas,Hempstead County,3,1567,772,795
Arkansas,Hempstead County,4,1361,725,636
Arkansas,Hempstead County,5,1229,622,607
Arkansas,Hempstead County,6,1293,586,707
Arkansas,Hempstead County,7,1122,538,584
Arkansas,Hempstead County,8,1229,571,658
Arkansas,Hempstead County,9,1249,562,687
Arkansas,Hempstead County,10,1195,595,600
Arkansas,Hempstead County,11,1372,657,715
Arkansas,Hempstead County,12,1554,762,792
Arkansas,Hempstead County,13,1469,719,750
Arkansas,Hempstead County,14,1158,537,621
Arkansas,Hempstead County,15,973,438,535
Arkansas,Hempstead County,16,787,378,409
Arkansas,Hempstead County,17,500,214,286
Arkansas,Hempstead County,18,487,166,321
Arkansas,Hot Spring County,0,33701,17643,16058
Arkansas,Hot Spring County,1,1716,915,801
Arkansas,Hot Spring County,2,1844,968,876
Arkansas,Hot Spring County,3,2063,1060,1003
Arkansas,Hot Spring County,4,2018,1191,827
Arkansas,Hot Spring County,5,1962,1119,843
Arkansas,Hot Spring County,6,2355,1340,1015
Arkansas,Hot Spring County,7,2027,1132,895
Arkansas,Hot Spring County,8,2069,1101,968
Arkansas,Hot Spring County,9,2110,1151,959
Arkansas,Hot Spring County,10,2210,1188,1022
Arkansas,Hot Spring County,11,2243,1236,1007
Arkansas,Hot Spring County,12,2397,1216,1181
Arkansas,Hot Spring County,13,2318,1123,1195
Arkansas,Hot Spring County,14,2075,953,1122
Arkansas,Hot Spring County,15,1697,822,875
Arkansas,Hot Spring County,16,1185,546,639
Arkansas,Hot Spring County,17,727,306,421
Arkansas,Hot Spring County,18,685,276,409
Arkansas,Howard County,0,13341,6417,6924
Arkansas,Howard County,1,939,500,439
Arkansas,Howard County,2,971,508,463
Arkansas,Howard County,3,994,508,486
Arkansas,Howard County,4,866,445,421
Arkansas,Howard County,5,734,365,369
Arkansas,Howard County,6,795,366,429
Arkansas,Howard County,7,761,341,420
Arkansas,Howard County,8,807,391,416
Arkansas,Howard County,9,708,330,378
Arkansas,Howard County,10,781,340,441
Arkansas,Howard County,11,873,438,435
Arkansas,Howard County,12,901,431,470
Arkansas,Howard County,13,817,405,412
Arkansas,Howard County,14,702,338,364
Arkansas,Howard County,15,627,283,344
Arkansas,Howard County,16,442,181,261
Arkansas,Howard County,17,326,140,186
Arkansas,Howard County,18,297,107,190
Arkansas,Independence County,0,37678,18371,19307
Arkansas,Independence County,1,2422,1204,1218
Arkansas,Independence County,2,2540,1269,1271
Arkansas,Independence County,3,2638,1343,1295
Arkansas,Independence County,4,2519,1275,1244
Arkansas,Independence County,5,2294,1120,1174
Arkansas,Independence County,6,2246,1144,1102
Arkansas,Independence County,7,2232,1118,1114
Arkansas,Independence County,8,2296,1155,1141
Arkansas,Independence County,9,2273,1119,1154
Arkansas,Independence County,10,2331,1161,1170
Arkansas,Independence County,11,2350,1130,1220
Arkansas,Independence County,12,2475,1192,1283
Arkansas,Independence County,13,2459,1240,1219
Arkansas,Independence County,14,2010,951,1059
Arkansas,Independence County,15,1686,779,907
Arkansas,Independence County,16,1219,549,670
Arkansas,Independence County,17,869,340,529
Arkansas,Independence County,18,819,282,537
Arkansas,Izard County,0,13593,7050,6543
Arkansas,Izard County,1,585,284,301
Arkansas,Izard County,2,662,328,334
Arkansas,Izard County,3,779,424,355
Arkansas,Izard County,4,663,349,314
Arkansas,Izard County,5,683,360,323
Arkansas,Izard County,6,724,444,280
Arkansas,Izard County,7,698,388,310
Arkansas,Izard County,8,741,411,330
Arkansas,Izard County,9,704,367,337
Arkansas,Izard County,10,870,494,376
Arkansas,Izard County,11,924,529,395
Arkansas,Izard County,12,1041,500,541
Arkansas,Izard County,13,1013,493,520
Arkansas,Izard County,14,982,497,485
Arkansas,Izard County,15,881,430,451
Arkansas,Izard County,16,706,355,351
Arkansas,Izard County,17,492,223,269
Arkansas,Izard County,18,445,174,271
Arkansas,Jackson County,0,16811,8348,8463
Arkansas,Jackson County,1,981,481,500
Arkansas,Jackson County,2,882,436,446
Arkansas,Jackson County,3,957,506,451
Arkansas,Jackson County,4,867,443,424
Arkansas,Jackson County,5,1003,533,470
Arkansas,Jackson County,6,1302,689,613
Arkansas,Jackson County,7,1143,611,532
Arkansas,Jackson County,8,1123,579,544
Arkansas,Jackson County,9,1067,566,501
Arkansas,Jackson County,10,1059,520,539
Arkansas,Jackson County,11,1104,558,546
Arkansas,Jackson County,12,1164,568,596
Arkansas,Jackson County,13,1108,519,589
Arkansas,Jackson County,14,967,463,504
Arkansas,Jackson County,15,818,345,473
Arkansas,Jackson County,16,581,273,308
Arkansas,Jackson County,17,348,140,208
Arkansas,Jackson County,18,337,118,219
Arkansas,Jefferson County,0,68114,33662,34452
Arkansas,Jefferson County,1,4158,2144,2014
Arkansas,Jefferson County,2,4022,2077,1945
Arkansas,Jefferson County,3,4248,2180,2068
Arkansas,Jefferson County,4,4778,2454,2324
Arkansas,Jefferson County,5,4775,2444,2331
Arkansas,Jefferson County,6,4715,2522,2193
Arkansas,Jefferson County,7,4132,2151,1981
Arkansas,Jefferson County,8,4092,2100,1992
Arkansas,Jefferson County,9,3735,1918,1817
Arkansas,Jefferson County,10,4001,2015,1986
Arkansas,Jefferson County,11,4274,2072,2202
Arkansas,Jefferson County,12,4716,2251,2465
Arkansas,Jefferson County,13,4691,2214,2477
Arkansas,Jefferson County,14,3941,1806,2135
Arkansas,Jefferson County,15,3091,1469,1622
Arkansas,Jefferson County,16,2025,896,1129
Arkansas,Jefferson County,17,1373,543,830
Arkansas,Jefferson County,18,1347,406,941
Arkansas,Johnson County,0,26742,13264,13478
Arkansas,Johnson County,1,1813,892,921
Arkansas,Johnson County,2,1832,945,887
Arkansas,Johnson County,3,1849,912,937
Arkansas,Johnson County,4,1941,979,962
Arkansas,Johnson County,5,1696,859,837
Arkansas,Johnson County,6,1670,837,833
Arkansas,Johnson County,7,1641,834,807
Arkansas,Johnson County,8,1676,850,826
Arkansas,Johnson County,9,1492,739,753
Arkansas,Johnson County,10,1556,781,775
Arkansas,Johnson County,11,1713,877,836
Arkansas,Johnson County,12,1814,887,927
Arkansas,Johnson County,13,1649,837,812
Arkansas,Johnson County,14,1368,667,701
Arkansas,Johnson County,15,1180,564,616
Arkansas,Johnson County,16,829,385,444
Arkansas,Johnson County,17,508,230,278
Arkansas,Johnson County,18,515,189,326
Arkansas,Lafayette County,0,6682,3283,3399
Arkansas,Lafayette County,1,341,191,150
Arkansas,Lafayette County,2,307,166,141
Arkansas,Lafayette County,3,354,184,170
Arkansas,Lafayette County,4,358,193,165
Arkansas,Lafayette County,5,368,182,186
Arkansas,Lafayette County,6,412,225,187
Arkansas,Lafayette County,7,285,146,139
Arkansas,Lafayette County,8,331,159,172
Arkansas,Lafayette County,9,371,178,193
Arkansas,Lafayette County,10,371,163,208
Arkansas,Lafayette County,11,490,234,256
Arkansas,Lafayette County,12,533,253,280
Arkansas,Lafayette County,13,555,266,289
Arkansas,Lafayette County,14,426,224,202
Arkansas,Lafayette County,15,432,184,248
Arkansas,Lafayette County,16,337,157,180
Arkansas,Lafayette County,17,211,93,118
Arkansas,Lafayette County,18,200,85,115
Arkansas,Lawrence County,0,16434,8112,8322
Arkansas,Lawrence County,1,960,499,461
Arkansas,Lawrence County,2,970,506,464
Arkansas,Lawrence County,3,1050,557,493
Arkansas,Lawrence County,4,1114,574,540
Arkansas,Lawrence County,5,1058,536,522
Arkansas,Lawrence County,6,1060,560,500
Arkansas,Lawrence County,7,857,432,425
Arkansas,Lawrence County,8,930,476,454
Arkansas,Lawrence County,9,906,430,476
Arkansas,Lawrence County,10,973,482,491
Arkansas,Lawrence County,11,1094,549,545
Arkansas,Lawrence County,12,1130,548,582
Arkansas,Lawrence County,13,1090,528,562
Arkansas,Lawrence County,14,879,422,457
Arkansas,Lawrence County,15,869,405,464
Arkansas,Lawrence County,16,617,265,352
Arkansas,Lawrence County,17,458,201,257
Arkansas,Lawrence County,18,419,142,277
Arkansas,Lee County,0,8985,5049,3936
Arkansas,Lee County,1,447,219,228
Arkansas,Lee County,2,441,215,226
Arkansas,Lee County,3,447,227,220
Arkansas,Lee County,4,474,238,236
Arkansas,Lee County,5,544,340,204
Arkansas,Lee County,6,728,510,218
Arkansas,Lee County,7,650,469,181
Arkansas,Lee County,8,564,393,171
Arkansas,Lee County,9,563,381,182
Arkansas,Lee County,10,630,394,236
Arkansas,Lee County,11,573,303,270
Arkansas,Lee County,12,597,325,272
Arkansas,Lee County,13,563,259,304
Arkansas,Lee County,14,515,232,283
Arkansas,Lee County,15,464,208,256
Arkansas,Lee County,16,325,150,175
Arkansas,Lee County,17,209,83,126
Arkansas,Lee County,18,251,103,148
Arkansas,Lincoln County,0,13383,8273,5110
Arkansas,Lincoln County,1,537,265,272
Arkansas,Lincoln County,2,609,291,318
Arkansas,Lincoln County,3,678,320,358
Arkansas,Lincoln County,4,738,443,295
Arkansas,Lincoln County,5,1035,802,233
Arkansas,Lincoln County,6,1183,886,297
Arkansas,Lincoln County,7,1119,843,276
Arkansas,Lincoln County,8,1045,739,306
Arkansas,Lincoln County,9,914,648,266
Arkansas,Lincoln County,10,940,645,295
Arkansas,Lincoln County,11,957,582,375
Arkansas,Lincoln County,12,863,521,342
Arkansas,Lincoln County,13,716,375,341
Arkansas,Lincoln County,14,613,299,314
Arkansas,Lincoln County,15,526,265,261
Arkansas,Lincoln County,16,371,161,210
Arkansas,Lincoln County,17,290,115,175
Arkansas,Lincoln County,18,249,73,176
Arkansas,Little River County,0,12326,5936,6390
Arkansas,Little River County,1,734,368,366
Arkansas,Little River County,2,741,394,347
Arkansas,Little River County,3,792,412,380
Arkansas,Little River County,4,730,404,326
Arkansas,Little River County,5,652,320,332
Arkansas,Little River County,6,725,369,356
Arkansas,Little River County,7,672,333,339
Arkansas,Little River County,8,677,330,347
Arkansas,Little River County,9,739,332,407
Arkansas,Little River County,10,764,362,402
Arkansas,Little River County,11,812,375,437
Arkansas,Little River County,12,849,391,458
Arkansas,Little River County,13,850,400,450
Arkansas,Little River County,14,810,361,449
Arkansas,Little River County,15,718,338,380
Arkansas,Little River County,16,507,231,276
Arkansas,Little River County,17,302,125,177
Arkansas,Little River County,18,252,91,161
Arkansas,Logan County,0,21737,10852,10885
Arkansas,Logan County,1,1310,684,626
Arkansas,Logan County,2,1177,576,601
Arkansas,Logan County,3,1326,685,641
Arkansas,Logan County,4,1397,814,583
Arkansas,Logan County,5,1178,631,547
Arkansas,Logan County,6,1303,664,639
Arkansas,Logan County,7,1162,590,572
Arkansas,Logan County,8,1186,565,621
Arkansas,Logan County,9,1240,608,632
Arkansas,Logan County,10,1437,711,726
Arkansas,Logan County,11,1596,829,767
Arkansas,Logan County,12,1643,803,840
Arkansas,Logan County,13,1467,692,775
Arkansas,Logan County,14,1352,665,687
Arkansas,Logan County,15,1105,531,574
Arkansas,Logan County,16,855,389,466
Arkansas,Logan County,17,541,249,292
Arkansas,Logan County,18,462,166,296
Arkansas,Lonoke County,0,73657,36302,37355
Arkansas,Lonoke County,1,4988,2549,2439
Arkansas,Lonoke County,2,5227,2727,2500
Arkansas,Lonoke County,3,5502,2822,2680
Arkansas,Lonoke County,4,4980,2559,2421
Arkansas,Lonoke County,5,4276,2169,2107
Arkansas,Lonoke County,6,5124,2569,2555
Arkansas,Lonoke County,7,5242,2607,2635
Arkansas,Lonoke County,8,5232,2627,2605
Arkansas,Lonoke County,9,4891,2370,2521
Arkansas,Lonoke County,10,4854,2387,2467
Arkansas,Lonoke County,11,4647,2290,2357
Arkansas,Lonoke County,12,4730,2344,2386
Arkansas,Lonoke County,13,4156,1943,2213
Arkansas,Lonoke County,14,3260,1508,1752
Arkansas,Lonoke County,15,2620,1242,1378
Arkansas,Lonoke County,16,1844,838,1006
Arkansas,Lonoke County,17,1130,431,699
Arkansas,Lonoke County,18,954,320,634
Arkansas,Madison County,0,16481,8229,8252
Arkansas,Madison County,1,1112,553,559
Arkansas,Madison County,2,1000,526,474
Arkansas,Madison County,3,1098,561,537
Arkansas,Madison County,4,1050,543,507
Arkansas,Madison County,5,863,421,442
Arkansas,Madison County,6,977,502,475
Arkansas,Madison County,7,943,473,470
Arkansas,Madison County,8,911,466,445
Arkansas,Madison County,9,923,474,449
Arkansas,Madison County,10,1016,496,520
Arkansas,Madison County,11,1080,561,519
Arkansas,Madison County,12,1216,626,590
Arkansas,Madison County,13,1149,581,568
Arkansas,Madison County,14,1061,506,555
Arkansas,Madison County,15,790,388,402
Arkansas,Madison County,16,609,286,323
Arkansas,Madison County,17,376,164,212
Arkansas,Madison County,18,307,102,205
Arkansas,Marion County,0,16722,8209,8513
Arkansas,Marion County,1,837,395,442
Arkansas,Marion County,2,850,430,420
Arkansas,Marion County,3,928,440,488
Arkansas,Marion County,4,745,398,347
Arkansas,Marion County,5,671,359,312
Arkansas,Marion County,6,758,389,369
Arkansas,Marion County,7,750,373,377
Arkansas,Marion County,8,744,358,386
Arkansas,Marion County,9,732,366,366
Arkansas,Marion County,10,880,419,461
Arkansas,Marion County,11,1071,541,530
Arkansas,Marion County,12,1393,669,724
Arkansas,Marion County,13,1595,754,841
Arkansas,Marion County,14,1573,775,798
Arkansas,Marion County,15,1345,676,669
Arkansas,Marion County,16,912,454,458
Arkansas,Marion County,17,520,264,256
Arkansas,Marion County,18,418,149,269
Arkansas,Miller County,0,43592,21411,22181
Arkansas,Miller County,1,2878,1455,1423
Arkansas,Miller County,2,2896,1492,1404
Arkansas,Miller County,3,2794,1473,1321
Arkansas,Miller County,4,2684,1406,1278
Arkansas,Miller County,5,2569,1377,1192
Arkansas,Miller County,6,3063,1558,1505
Arkansas,Miller County,7,2691,1346,1345
Arkansas,Miller County,8,2848,1380,1468
Arkansas,Miller County,9,2636,1287,1349
Arkansas,Miller County,10,2730,1352,1378
Arkansas,Miller County,11,2776,1401,1375
Arkansas,Miller County,12,2948,1397,1551
Arkansas,Miller County,13,2715,1280,1435
Arkansas,Miller County,14,2335,1086,1249
Arkansas,Miller County,15,1918,867,1051
Arkansas,Miller County,16,1391,605,786
Arkansas,Miller County,17,905,390,515
Arkansas,Miller County,18,815,259,556
Arkansas,Mississippi County,0,41239,20077,21162
Arkansas,Mississippi County,1,2969,1514,1455
Arkansas,Mississippi County,2,2829,1450,1379
Arkansas,Mississippi County,3,3092,1610,1482
Arkansas,Mississippi County,4,2889,1461,1428
Arkansas,Mississippi County,5,2655,1338,1317
Arkansas,Mississippi County,6,2880,1494,1386
Arkansas,Mississippi County,7,2538,1233,1305
Arkansas,Mississippi County,8,2507,1244,1263
Arkansas,Mississippi County,9,2392,1098,1294
Arkansas,Mississippi County,10,2337,1109,1228
Arkansas,Mississippi County,11,2649,1278,1371
Arkansas,Mississippi County,12,2798,1329,1469
Arkansas,Mississippi County,13,2604,1263,1341
Arkansas,Mississippi County,14,2062,990,1072
Arkansas,Mississippi County,15,1557,693,864
Arkansas,Mississippi County,16,1051,467,584
Arkansas,Mississippi County,17,767,300,467
Arkansas,Mississippi County,18,663,206,457
Arkansas,Monroe County,0,6900,3209,3691
Arkansas,Monroe County,1,451,209,242
Arkansas,Monroe County,2,399,206,193
Arkansas,Monroe County,3,401,203,198
Arkansas,Monroe County,4,346,161,185
Arkansas,Monroe County,5,339,149,190
Arkansas,Monroe County,6,417,178,239
Arkansas,Monroe County,7,317,164,153
Arkansas,Monroe County,8,343,179,164
Arkansas,Monroe County,9,323,142,181
Arkansas,Monroe County,10,380,192,188
Arkansas,Monroe County,11,471,219,252
Arkansas,Monroe County,12,559,265,294
Arkansas,Monroe County,13,553,253,300
Arkansas,Monroe County,14,511,235,276
Arkansas,Monroe County,15,372,163,209
Arkansas,Monroe County,16,291,125,166
Arkansas,Monroe County,17,226,100,126
Arkansas,Monroe County,18,201,66,135
Arkansas,Montgomery County,0,8924,4414,4510
Arkansas,Montgomery County,1,420,223,197
Arkansas,Montgomery County,2,414,221,193
Arkansas,Montgomery County,3,485,237,248
Arkansas,Montgomery County,4,503,265,238
Arkansas,Montgomery County,5,420,219,201
Arkansas,Montgomery County,6,430,229,201
Arkansas,Montgomery County,7,348,172,176
Arkansas,Montgomery County,8,383,192,191
Arkansas,Montgomery County,9,418,217,201
Arkansas,Montgomery County,10,520,251,269
Arkansas,Montgomery County,11,706,309,397
Arkansas,Montgomery County,12,749,381,368
Arkansas,Montgomery County,13,717,349,368
Arkansas,Montgomery County,14,686,342,344
Arkansas,Montgomery County,15,640,317,323
Arkansas,Montgomery County,16,490,235,255
Arkansas,Montgomery County,17,314,138,176
Arkansas,Montgomery County,18,281,117,164
Arkansas,Nevada County,0,8326,4126,4200
Arkansas,Nevada County,1,484,257,227
Arkansas,Nevada County,2,538,296,242
Arkansas,Nevada County,3,545,304,241
Arkansas,Nevada County,4,499,259,240
Arkansas,Nevada County,5,375,196,179
Arkansas,Nevada County,6,520,272,248
Arkansas,Nevada County,7,440,210,230
Arkansas,Nevada County,8,439,212,227
Arkansas,Nevada County,9,447,231,216
Arkansas,Nevada County,10,527,256,271
Arkansas,Nevada County,11,557,269,288
Arkansas,Nevada County,12,621,298,323
Arkansas,Nevada County,13,616,291,325
Arkansas,Nevada County,14,522,262,260
Arkansas,Nevada County,15,432,184,248
Arkansas,Nevada County,16,324,147,177
Arkansas,Nevada County,17,211,100,111
Arkansas,Nevada County,18,229,82,147
Arkansas,Newton County,0,7805,3954,3851
Arkansas,Newton County,1,381,206,175
Arkansas,Newton County,2,367,190,177
Arkansas,Newton County,3,460,245,215
Arkansas,Newton County,4,448,241,207
Arkansas,Newton County,5,350,185,165
Arkansas,Newton County,6,400,199,201
Arkansas,Newton County,7,368,202,166
Arkansas,Newton County,8,411,204,207
Arkansas,Newton County,9,392,193,199
Arkansas,Newton County,10,404,196,208
Arkansas,Newton County,11,516,271,245
Arkansas,Newton County,12,585,285,300
Arkansas,Newton County,13,654,335,319
Arkansas,Newton County,14,657,345,312
Arkansas,Newton County,15,582,286,296
Arkansas,Newton County,16,401,198,203
Arkansas,Newton County,17,238,103,135
Arkansas,Newton County,18,191,70,121
Arkansas,Ouachita County,0,23606,11196,12410
Arkansas,Ouachita County,1,1328,682,646
Arkansas,Ouachita County,2,1471,716,755
Arkansas,Ouachita County,3,1621,832,789
Arkansas,Ouachita County,4,1362,718,644
Arkansas,Ouachita County,5,1222,608,614
Arkansas,Ouachita County,6,1343,657,686
Arkansas,Ouachita County,7,1307,630,677
Arkansas,Ouachita County,8,1309,631,678
Arkansas,Ouachita County,9,1222,554,668
Arkansas,Ouachita County,10,1413,670,743
Arkansas,Ouachita County,11,1472,695,777
Arkansas,Ouachita County,12,1820,861,959
Arkansas,Ouachita County,13,1906,866,1040
Arkansas,Ouachita County,14,1622,752,870
Arkansas,Ouachita County,15,1146,520,626
Arkansas,Ouachita County,16,827,388,439
Arkansas,Ouachita County,17,561,212,349
Arkansas,Ouachita County,18,654,204,450
Arkansas,Perry County,0,10352,5113,5239
Arkansas,Perry County,1,620,312,308
Arkansas,Perry County,2,609,322,287
Arkansas,Perry County,3,672,329,343
Arkansas,Perry County,4,627,303,324
Arkansas,Perry County,5,564,288,276
Arkansas,Perry County,6,522,270,252
Arkansas,Perry County,7,570,288,282
Arkansas,Perry County,8,571,288,283
Arkansas,Perry County,9,594,292,302
Arkansas,Perry County,10,706,357,349
Arkansas,Perry County,11,726,368,358
Arkansas,Perry County,12,756,378,378
Arkansas,Perry County,13,724,355,369
Arkansas,Perry County,14,665,300,365
Arkansas,Perry County,15,560,271,289
Arkansas,Perry County,16,366,183,183
Arkansas,Perry County,17,261,124,137
Arkansas,Perry County,18,239,85,154
Arkansas,Phillips County,0,18029,8476,9553
Arkansas,Phillips County,1,1386,737,649
Arkansas,Phillips County,2,1220,660,560
Arkansas,Phillips County,3,1265,629,636
Arkansas,Phillips County,4,1218,622,596
Arkansas,Phillips County,5,1106,516,590
Arkansas,Phillips County,6,1076,503,573
Arkansas,Phillips County,7,874,398,476
Arkansas,Phillips County,8,949,411,538
Arkansas,Phillips County,9,879,403,476
Arkansas,Phillips County,10,950,454,496
Arkansas,Phillips County,11,1048,473,575
Arkansas,Phillips County,12,1329,613,716
Arkansas,Phillips County,13,1303,564,739
Arkansas,Phillips County,14,1156,521,635
Arkansas,Phillips County,15,856,402,454
Arkansas,Phillips County,16,614,268,346
Arkansas,Phillips County,17,410,180,230
Arkansas,Phillips County,18,390,122,268
Arkansas,Pike County,0,10673,5336,5337
Arkansas,Pike County,1,553,292,261
Arkansas,Pike County,2,648,328,320
Arkansas,Pike County,3,675,366,309
Arkansas,Pike County,4,652,327,325
Arkansas,Pike County,5,596,298,298
Arkansas,Pike County,6,576,309,267
Arkansas,Pike County,7,579,317,262
Arkansas,Pike County,8,563,282,281
Arkansas,Pike County,9,653,319,334
Arkansas,Pike County,10,760,398,362
Arkansas,Pike County,11,734,365,369
Arkansas,Pike County,12,752,378,374
Arkansas,Pike County,13,756,365,391
Arkansas,Pike County,14,706,318,388
Arkansas,Pike County,15,525,258,267
Arkansas,Pike County,16,424,195,229
Arkansas,Pike County,17,315,136,179
Arkansas,Pike County,18,206,85,121
Arkansas,Poinsett County,0,23974,11646,12328
Arkansas,Poinsett County,1,1622,826,796
Arkansas,Poinsett County,2,1572,825,747
Arkansas,Poinsett County,3,1612,809,803
Arkansas,Poinsett County,4,1477,735,742
Arkansas,Poinsett County,5,1386,699,687
Arkansas,Poinsett County,6,1683,857,826
Arkansas,Poinsett County,7,1372,679,693
Arkansas,Poinsett County,8,1345,654,691
Arkansas,Poinsett County,9,1345,664,681
Arkansas,Poinsett County,10,1561,765,796
Arkansas,Poinsett County,11,1577,803,774
Arkansas,Poinsett County,12,1655,780,875
Arkansas,Poinsett County,13,1471,749,722
Arkansas,Poinsett County,14,1328,574,754
Arkansas,Poinsett County,15,1153,514,639
Arkansas,Poinsett County,16,880,374,506
Arkansas,Poinsett County,17,522,205,317
Arkansas,Poinsett County,18,413,134,279
Arkansas,Polk County,0,20049,9767,10282
Arkansas,Polk County,1,1196,616,580
Arkansas,Polk County,2,1220,589,631
Arkansas,Polk County,3,1330,651,679
Arkansas,Polk County,4,1269,658,611
Arkansas,Polk County,5,999,522,477
Arkansas,Polk County,6,1096,516,580
Arkansas,Polk County,7,948,475,473
Arkansas,Polk County,8,1040,509,531
Arkansas,Polk County,9,1067,530,537
Arkansas,Polk County,10,1197,579,618
Arkansas,Polk County,11,1199,608,591
Arkansas,Polk County,12,1453,719,734
Arkansas,Polk County,13,1424,680,744
Arkansas,Polk County,14,1418,677,741
Arkansas,Polk County,15,1219,567,652
Arkansas,Polk County,16,937,447,490
Arkansas,Polk County,17,557,244,313
Arkansas,Polk County,18,480,180,300
Arkansas,Pope County,0,64000,31721,32279
Arkansas,Pope County,1,4056,2085,1971
Arkansas,Pope County,2,3944,2039,1905
Arkansas,Pope County,3,4179,2118,2061
Arkansas,Pope County,4,5067,2563,2504
Arkansas,Pope County,5,5499,2811,2688
Arkansas,Pope County,6,4644,2336,2308
Arkansas,Pope County,7,3985,2036,1949
Arkansas,Pope County,8,3707,1824,1883
Arkansas,Pope County,9,3427,1783,1644
Arkansas,Pope County,10,3730,1838,1892
Arkansas,Pope County,11,3895,1899,1996
Arkansas,Pope County,12,4123,2119,2004
Arkansas,Pope County,13,3663,1749,1914
Arkansas,Pope County,14,3081,1463,1618
Arkansas,Pope County,15,2689,1234,1455
Arkansas,Pope County,16,1891,855,1036
Arkansas,Pope County,17,1244,557,687
Arkansas,Pope County,18,1176,412,764
Arkansas,Prairie County,0,8074,4063,4011
Arkansas,Prairie County,1,430,251,179
Arkansas,Prairie County,2,444,244,200
Arkansas,Prairie County,3,454,261,193
Arkansas,Prairie County,4,433,227,206
Arkansas,Prairie County,5,433,239,194
Arkansas,Prairie County,6,406,202,204
Arkansas,Prairie County,7,445,218,227
Arkansas,Prairie County,8,391,198,193
Arkansas,Prairie County,9,391,169,222
Arkansas,Prairie County,10,513,254,259
Arkansas,Prairie County,11,600,279,321
Arkansas,Prairie County,12,592,302,290
Arkansas,Prairie County,13,622,291,331
Arkansas,Prairie County,14,512,268,244
Arkansas,Prairie County,15,479,241,238
Arkansas,Prairie County,16,394,187,207
Arkansas,Prairie County,17,283,131,152
Arkansas,Prairie County,18,252,101,151
Arkansas,Pulaski County,0,392680,187731,204949
Arkansas,Pulaski County,1,25974,13260,12714
Arkansas,Pulaski County,2,25536,13058,12478
Arkansas,Pulaski County,3,25029,12812,12217
Arkansas,Pulaski County,4,23054,11740,11314
Arkansas,Pulaski County,5,25388,12870,12518
Arkansas,Pulaski County,6,30212,14700,15512
Arkansas,Pulaski County,7,27786,13252,14534
Arkansas,Pulaski County,8,26718,12807,13911
Arkansas,Pulaski County,9,23508,11113,12395
Arkansas,Pulaski County,10,24132,11362,12770
Arkansas,Pulaski County,11,23240,10980,12260
Arkansas,Pulaski County,12,26048,12242,13806
Arkansas,Pulaski County,13,24980,11522,13458
Arkansas,Pulaski County,14,21261,9621,11640
Arkansas,Pulaski County,15,15562,7025,8537
Arkansas,Pulaski County,16,10226,4403,5823
Arkansas,Pulaski County,17,6629,2607,4022
Arkansas,Pulaski County,18,7397,2357,5040
Arkansas,Randolph County,0,17948,8874,9074
Arkansas,Randolph County,1,1139,586,553
Arkansas,Randolph County,2,1196,620,576
Arkansas,Randolph County,3,1178,624,554
Arkansas,Randolph County,4,1117,582,535
Arkansas,Randolph County,5,927,490,437
Arkansas,Randolph County,6,1189,610,579
Arkansas,Randolph County,7,1063,535,528
Arkansas,Randolph County,8,1044,537,507
Arkansas,Randolph County,9,1031,524,507
Arkansas,Randolph County,10,1003,477,526
Arkansas,Randolph County,11,1148,581,567
Arkansas,Randolph County,12,1198,587,611
Arkansas,Randolph County,13,1136,565,571
Arkansas,Randolph County,14,1067,491,576
Arkansas,Randolph County,15,885,417,468
Arkansas,Randolph County,16,661,284,377
Arkansas,Randolph County,17,438,182,256
Arkansas,Randolph County,18,528,182,346
Arkansas,St. Francis County,0,25439,14023,11416
Arkansas,St. Francis County,1,1583,779,804
Arkansas,St. Francis County,2,1438,704,734
Arkansas,St. Francis County,3,1474,790,684
Arkansas,St. Francis County,4,1412,704,708
Arkansas,St. Francis County,5,1505,839,666
Arkansas,St. Francis County,6,1910,1185,725
Arkansas,St. Francis County,7,1873,1257,616
Arkansas,St. Francis County,8,1957,1326,631
Arkansas,St. Francis County,9,1716,1076,640
Arkansas,St. Francis County,10,1588,931,657
Arkansas,St. Francis County,11,1579,895,684
Arkansas,St. Francis County,12,1633,831,802
Arkansas,St. Francis County,13,1649,829,820
Arkansas,St. Francis County,14,1410,681,729
Arkansas,St. Francis County,15,1095,533,562
Arkansas,St. Francis County,16,715,303,412
Arkansas,St. Francis County,17,434,192,242
Arkansas,St. Francis County,18,468,168,300
Arkansas,Saline County,0,121421,59489,61932
Arkansas,Saline County,1,7084,3555,3529
Arkansas,Saline County,2,7699,4003,3696
Arkansas,Saline County,3,8397,4222,4175
Arkansas,Saline County,4,7546,3946,3600
Arkansas,Saline County,5,6271,3072,3199
Arkansas,Saline County,6,7689,3720,3969
Arkansas,Saline County,7,7796,3775,4021
Arkansas,Saline County,8,8550,4222,4328
Arkansas,Saline County,9,7889,3928,3961
Arkansas,Saline County,10,7910,3961,3949
Arkansas,Saline County,11,7810,3853,3957
Arkansas,Saline County,12,7806,3820,3986
Arkansas,Saline County,13,7410,3576,3834
Arkansas,Saline County,14,6705,3054,3651
Arkansas,Saline County,15,5923,2832,3091
Arkansas,Saline County,16,4294,2002,2292
Arkansas,Saline County,17,2577,1152,1425
Arkansas,Saline County,18,2065,796,1269
Arkansas,Scott County,0,10319,5236,5083
Arkansas,Scott County,1,581,291,290
Arkansas,Scott County,2,661,362,299
Arkansas,Scott County,3,723,390,333
Arkansas,Scott County,4,636,352,284
Arkansas,Scott County,5,518,265,253
Arkansas,Scott County,6,635,305,330
Arkansas,Scott County,7,542,290,252
Arkansas,Scott County,8,544,281,263
Arkansas,Scott County,9,537,277,260
Arkansas,Scott County,10,612,296,316
Arkansas,Scott County,11,725,381,344
Arkansas,Scott County,12,798,391,407
Arkansas,Scott County,13,655,341,314
Arkansas,Scott County,14,645,311,334
Arkansas,Scott County,15,560,272,288
Arkansas,Scott County,16,468,232,236
Arkansas,Scott County,17,258,113,145
Arkansas,Scott County,18,221,86,135
Arkansas,Searcy County,0,7958,3988,3970
Arkansas,Searcy County,1,418,192,226
Arkansas,Searcy County,2,448,243,205
Arkansas,Searcy County,3,464,250,214
Arkansas,Searcy County,4,461,250,211
Arkansas,Searcy County,5,357,187,170
Arkansas,Searcy County,6,375,180,195
Arkansas,Searcy County,7,401,189,212
Arkansas,Searcy County,8,385,202,183
Arkansas,Searcy County,9,414,217,197
Arkansas,Searcy County,10,467,242,225
Arkansas,Searcy County,11,534,242,292
Arkansas,Searcy County,12,613,324,289
Arkansas,Searcy County,13,633,305,328
Arkansas,Searcy County,14,587,307,280
Arkansas,Searcy County,15,538,266,272
Arkansas,Searcy County,16,366,164,202
Arkansas,Searcy County,17,255,121,134
Arkansas,Searcy County,18,242,107,135
Arkansas,Sebastian County,0,127753,62418,65335
Arkansas,Sebastian County,1,8387,4301,4086
Arkansas,Sebastian County,2,8249,4185,4064
Arkansas,Sebastian County,3,8662,4362,4300
Arkansas,Sebastian County,4,8309,4221,4088
Arkansas,Sebastian County,5,8307,4124,4183
Arkansas,Sebastian County,6,9085,4536,4549
Arkansas,Sebastian County,7,8231,4106,4125
Arkansas,Sebastian County,8,7933,3994,3939
Arkansas,Sebastian County,9,7515,3660,3855
Arkansas,Sebastian County,10,7940,3894,4046
Arkansas,Sebastian County,11,8285,4161,4124
Arkansas,Sebastian County,12,8445,4163,4282
Arkansas,Sebastian County,13,7901,3787,4114
Arkansas,Sebastian County,14,6672,3098,3574
Arkansas,Sebastian County,15,5248,2364,2884
Arkansas,Sebastian County,16,3732,1669,2063
Arkansas,Sebastian County,17,2377,972,1405
Arkansas,Sebastian County,18,2475,821,1654
Arkansas,Sevier County,0,17139,8622,8517
Arkansas,Sevier County,1,1353,717,636
Arkansas,Sevier County,2,1373,653,720
Arkansas,Sevier County,3,1376,693,683
Arkansas,Sevier County,4,1223,664,559
Arkansas,Sevier County,5,1101,562,539
Arkansas,Sevier County,6,1165,600,565
Arkansas,Sevier County,7,991,533,458
Arkansas,Sevier County,8,999,524,475
Arkansas,Sevier County,9,947,448,499
Arkansas,Sevier County,10,1150,570,580
Arkansas,Sevier County,11,1022,521,501
Arkansas,Sevier County,12,1007,520,487
Arkansas,Sevier County,13,939,474,465
Arkansas,Sevier County,14,794,409,385
Arkansas,Sevier County,15,629,284,345
Arkansas,Sevier County,16,457,211,246
Arkansas,Sevier County,17,330,126,204
Arkansas,Sevier County,18,283,113,170
Arkansas,Sharp County,0,17366,8570,8796
Arkansas,Sharp County,1,938,509,429
Arkansas,Sharp County,2,917,465,452
Arkansas,Sharp County,3,1038,541,497
Arkansas,Sharp County,4,1026,557,469
Arkansas,Sharp County,5,829,458,371
Arkansas,Sharp County,6,879,435,444
Arkansas,Sharp County,7,743,364,379
Arkansas,Sharp County,8,860,418,442
Arkansas,Sharp County,9,886,446,440
Arkansas,Sharp County,10,1042,498,544
Arkansas,Sharp County,11,1073,529,544
Arkansas,Sharp County,12,1254,599,655
Arkansas,Sharp County,13,1351,618,733
Arkansas,Sharp County,14,1289,613,676
Arkansas,Sharp County,15,1215,593,622
Arkansas,Sharp County,16,885,417,468
Arkansas,Sharp County,17,623,306,317
Arkansas,Sharp County,18,518,204,314
Arkansas,Stone County,0,12457,6135,6322
Arkansas,Stone County,1,596,299,297
Arkansas,Stone County,2,640,337,303
Arkansas,Stone County,3,730,362,368
Arkansas,Stone County,4,655,336,319
Arkansas,Stone County,5,545,285,260
Arkansas,Stone County,6,626,302,324
Arkansas,Stone County,7,545,274,271
Arkansas,Stone County,8,605,300,305
Arkansas,Stone County,9,669,356,313
Arkansas,Stone County,10,592,301,291
Arkansas,Stone County,11,773,363,410
Arkansas,Stone County,12,1013,496,517
Arkansas,Stone County,13,1052,525,527
Arkansas,Stone County,14,957,470,487
Arkansas,Stone County,15,918,432,486
Arkansas,Stone County,16,718,349,369
Arkansas,Stone County,17,426,182,244
Arkansas,Stone County,18,397,166,231
Arkansas,Union County,0,39126,19038,20088
Arkansas,Union County,1,2568,1273,1295
Arkansas,Union County,2,2603,1329,1274
Arkansas,Union County,3,2693,1398,1295
Arkansas,Union County,4,2409,1293,1116
Arkansas,Union County,5,2174,1067,1107
Arkansas,Union County,6,2376,1219,1157
Arkansas,Union County,7,2234,1062,1172
Arkansas,Union County,8,2435,1170,1265
Arkansas,Union County,9,2181,1063,1118
Arkansas,Union County,10,2446,1170,1276
Arkansas,Union County,11,2415,1197,1218
Arkansas,Union County,12,2833,1366,1467
Arkansas,Union County,13,2742,1328,1414
Arkansas,Union County,14,2296,1068,1228
Arkansas,Union County,15,1773,849,924
Arkansas,Union County,16,1263,555,708
Arkansas,Union County,17,851,346,505
Arkansas,Union County,18,834,285,549
Arkansas,Van Buren County,0,16603,8255,8348
Arkansas,Van Buren County,1,802,425,377
Arkansas,Van Buren County,2,875,437,438
Arkansas,Van Buren County,3,1029,531,498
Arkansas,Van Buren County,4,950,483,467
Arkansas,Van Buren County,5,715,387,328
Arkansas,Van Buren County,6,731,384,347
Arkansas,Van Buren County,7,778,381,397
Arkansas,Van Buren County,8,868,422,446
Arkansas,Van Buren County,9,835,389,446
Arkansas,Van Buren County,10,1007,566,441
Arkansas,Van Buren County,11,1067,537,530
Arkansas,Van Buren County,12,1259,618,641
Arkansas,Van Buren County,13,1362,656,706
Arkansas,Van Buren County,14,1214,587,627
Arkansas,Van Buren County,15,1140,554,586
Arkansas,Van Buren County,16,856,399,457
Arkansas,Van Buren County,17,561,262,299
Arkansas,Van Buren County,18,554,237,317
Arkansas,Washington County,0,236961,118335,118626
Arkansas,Washington County,1,16141,8284,7857
Arkansas,Washington County,2,16172,8172,8000
Arkansas,Washington County,3,16224,8331,7893
Arkansas,Washington County,4,18783,9323,9460
Arkansas,Washington County,5,24995,13153,11842
Arkansas,Washington County,6,19138,9796,9342
Arkansas,Washington County,7,16690,8467,8223
Arkansas,Washington County,8,16864,8618,8246
Arkansas,Washington County,9,14439,7329,7110
Arkansas,Washington County,10,13356,6718,6638
Arkansas,Washington County,11,12523,6299,6224
Arkansas,Washington County,12,12646,6245,6401
Arkansas,Washington County,13,11181,5243,5938
Arkansas,Washington County,14,9334,4428,4906
Arkansas,Washington County,15,7210,3300,3910
Arkansas,Washington County,16,4986,2197,2789
Arkansas,Washington County,17,3132,1314,1818
Arkansas,Washington County,18,3147,1118,2029
Arkansas,White County,0,78727,38321,40406
Arkansas,White County,1,4656,2434,2222
Arkansas,White County,2,5029,2590,2439
Arkansas,White County,3,5278,2712,2566
Arkansas,White County,4,5987,2892,3095
Arkansas,White County,5,6213,3073,3140
Arkansas,White County,6,5071,2481,2590
Arkansas,White County,7,4648,2313,2335
Arkansas,White County,8,4724,2277,2447
Arkansas,White County,9,4397,2164,2233
Arkansas,White County,10,5015,2499,2516
Arkansas,White County,11,4945,2383,2562
Arkansas,White County,12,5284,2666,2618
Arkansas,White County,13,4548,2145,2403
Arkansas,White County,14,3985,1901,2084
Arkansas,White County,15,3466,1573,1893
Arkansas,White County,16,2445,1036,1409
Arkansas,White County,17,1596,653,943
Arkansas,White County,18,1440,529,911
Arkansas,Woodruff County,0,6490,3121,3369
Arkansas,Woodruff County,1,381,215,166
Arkansas,Woodruff County,2,400,197,203
Arkansas,Woodruff County,3,382,188,194
Arkansas,Woodruff County,4,379,184,195
Arkansas,Woodruff County,5,355,179,176
Arkansas,Woodruff County,6,345,166,179
Arkansas,Woodruff County,7,316,141,175
Arkansas,Woodruff County,8,323,153,170
Arkansas,Woodruff County,9,356,190,166
Arkansas,Woodruff County,10,413,199,214
Arkansas,Woodruff County,11,403,216,187
Arkansas,Woodruff County,12,495,232,263
Arkansas,Woodruff County,13,440,207,233
Arkansas,Woodruff County,14,496,242,254
Arkansas,Woodruff County,15,380,176,204
Arkansas,Woodruff County,16,269,110,159
Arkansas,Woodruff County,17,157,68,89
Arkansas,Woodruff County,18,200,58,142
Arkansas,Yell County,0,21535,10811,10724
Arkansas,Yell County,1,1386,710,676
Arkansas,Yell County,2,1439,738,701
Arkansas,Yell County,3,1582,819,763
Arkansas,Yell County,4,1390,745,645
Arkansas,Yell County,5,1221,649,572
Arkansas,Yell County,6,1280,657,623
Arkansas,Yell County,7,1182,611,571
Arkansas,Yell County,8,1228,643,585
Arkansas,Yell County,9,1305,668,637
Arkansas,Yell County,10,1381,683,698
Arkansas,Yell County,11,1380,667,713
Arkansas,Yell County,12,1580,824,756
Arkansas,Yell County,13,1352,669,683
Arkansas,Yell County,14,1181,580,601
Arkansas,Yell County,15,927,455,472
Arkansas,Yell County,16,738,331,407
Arkansas,Yell County,17,499,207,292
Arkansas,Yell County,18,484,155,329
California,Alameda County,0,1666753,820045,846708
California,Alameda County,1,96716,49506,47210
California,Alameda County,2,95425,48711,46714
California,Alameda County,3,95370,48947,46423
California,Alameda County,4,93570,47278,46292
California,Alameda County,5,99446,49656,49790
California,Alameda County,6,137553,69291,68262
California,Alameda County,7,141644,71053,70591
California,Alameda County,8,134126,67278,66848
California,Alameda County,9,117048,58217,58831
California,Alameda County,10,115151,57304,57847
California,Alameda County,11,107012,53257,53755
California,Alameda County,12,107380,52314,55066
California,Alameda County,13,95802,46151,49651
California,Alameda County,14,78175,36178,41997
California,Alameda County,15,58232,26577,31655
California,Alameda County,16,37876,16738,21138
California,Alameda County,17,25807,10825,14982
California,Alameda County,18,30420,10764,19656
California,Alpine County,0,1101,588,513
California,Alpine County,1,44,27,17
California,Alpine County,2,36,18,18
California,Alpine County,3,69,35,34
California,Alpine County,4,70,39,31
California,Alpine County,5,60,34,26
California,Alpine County,6,55,35,20
California,Alpine County,7,54,30,24
California,Alpine County,8,36,22,14
California,Alpine County,9,47,19,28
California,Alpine County,10,63,36,27
California,Alpine County,11,70,29,41
California,Alpine County,12,114,67,47
California,Alpine County,13,103,58,45
California,Alpine County,14,115,58,57
California,Alpine County,15,78,36,42
California,Alpine County,16,36,19,17
California,Alpine County,17,28,16,12
California,Alpine County,18,23,10,13
California,Amador County,0,39383,21425,17958
California,Amador County,1,1615,824,791
California,Amador County,2,1587,870,717
California,Amador County,3,1688,825,863
California,Amador County,4,1672,886,786
California,Amador County,5,1595,914,681
California,Amador County,6,2165,1289,876
California,Amador County,7,2131,1316,815
California,Amador County,8,2365,1472,893
California,Amador County,9,2266,1510,756
California,Amador County,10,2488,1554,934
California,Amador County,11,2697,1556,1141
California,Amador County,12,3140,1653,1487
California,Amador County,13,3341,1647,1694
California,Amador County,14,3492,1675,1817
California,Amador County,15,2997,1467,1530
California,Amador County,16,1871,903,968
California,Amador County,17,1187,591,596
California,Amador County,18,1086,473,613
California,Butte County,0,231256,114342,116914
California,Butte County,1,12803,6603,6200
California,Butte County,2,12732,6561,6171
California,Butte County,3,12963,6597,6366
California,Butte County,4,15667,7923,7744
California,Butte County,5,25027,12680,12347
California,Butte County,6,16833,8818,8015
California,Butte County,7,13394,6889,6505
California,Butte County,8,13601,6996,6605
California,Butte County,9,11685,5942,5743
California,Butte County,10,11971,5967,6004
California,Butte County,11,12243,5955,6288
California,Butte County,12,14305,6849,7456
California,Butte County,13,15040,7154,7886
California,Butte County,14,14348,6797,7551
California,Butte County,15,10990,5192,5798
California,Butte County,16,7162,3296,3866
California,Butte County,17,4914,2140,2774
California,Butte County,18,5578,1983,3595
California,Calaveras County,0,45602,22697,22905
California,Calaveras County,1,1955,1016,939
California,Calaveras County,2,2023,1060,963
California,Calaveras County,3,2220,1089,1131
California,Calaveras County,4,2313,1263,1050
California,Calaveras County,5,2021,1058,963
California,Calaveras County,6,2125,1105,1020
California,Calaveras County,7,2252,1146,1106
California,Calaveras County,8,2282,1178,1104
California,Calaveras County,9,1997,1013,984
California,Calaveras County,10,2497,1197,1300
California,Calaveras County,11,2969,1465,1504
California,Calaveras County,12,3887,1847,2040
California,Calaveras County,13,4508,2151,2357
California,Calaveras County,14,4122,1993,2129
California,Calaveras County,15,3497,1762,1735
California,Calaveras County,16,2333,1172,1161
California,Calaveras County,17,1468,710,758
California,Calaveras County,18,1133,472,661
California,Colusa County,0,21627,11046,10581
California,Colusa County,1,1543,779,764
California,Colusa County,2,1618,832,786
California,Colusa County,3,1732,910,822
California,Colusa County,4,1598,855,743
California,Colusa County,5,1409,728,681
California,Colusa County,6,1463,761,702
California,Colusa County,7,1418,733,685
California,Colusa County,8,1390,712,678
California,Colusa County,9,1222,608,614
California,Colusa County,10,1255,633,622
California,Colusa County,11,1285,665,620
California,Colusa County,12,1286,665,621
California,Colusa County,13,1245,645,600
California,Colusa County,14,1026,509,517
California,Colusa County,15,780,393,387
California,Colusa County,16,607,297,310
California,Colusa County,17,354,172,182
California,Colusa County,18,396,149,247
California,Contra Costa County,0,1150215,562483,587732
California,Contra Costa County,1,64973,33130,31843
California,Contra Costa County,2,70774,36107,34667
California,Contra Costa County,3,77366,39512,37854
California,Contra Costa County,4,73055,37404,35651
California,Contra Costa County,5,66640,33961,32679
California,Contra Costa County,6,73055,37178,35877
California,Contra Costa County,7,73953,36808,37145
California,Contra Costa County,8,78936,38822,40114
California,Contra Costa County,9,76498,37235,39263
California,Contra Costa County,10,80738,39602,41136
California,Contra Costa County,11,80749,39416,41333
California,Contra Costa County,12,80276,39126,41150
California,Contra Costa County,13,71759,34324,37435
California,Contra Costa County,14,59161,27241,31920
California,Contra Costa County,15,47276,21524,25752
California,Contra Costa County,16,31351,13938,17413
California,Contra Costa County,17,20413,8726,11687
California,Contra Costa County,18,23242,8429,14813
California,Del Norte County,0,27828,15188,12640
California,Del Norte County,1,1560,812,748
California,Del Norte County,2,1659,853,806
California,Del Norte County,3,1688,856,832
California,Del Norte County,4,1479,773,706
California,Del Norte County,5,1584,965,619
California,Del Norte County,6,1925,1202,723
California,Del Norte County,7,2008,1301,707
California,Del Norte County,8,2056,1269,787
California,Del Norte County,9,1634,998,636
California,Del Norte County,10,1603,935,668
California,Del Norte County,11,1641,895,746
California,Del Norte County,12,1940,993,947
California,Del Norte County,13,2033,939,1094
California,Del Norte County,14,1754,871,883
California,Del Norte County,15,1276,657,619
California,Del Norte County,16,893,412,481
California,Del Norte County,17,546,244,302
California,Del Norte County,18,549,213,336
California,El Dorado County,0,190678,95091,95587
California,El Dorado County,1,8704,4427,4277
California,El Dorado County,2,10164,5243,4921
California,El Dorado County,3,11802,6004,5798
California,El Dorado County,4,11103,5803,5300
California,El Dorado County,5,9554,4934,4620
California,El Dorado County,6,9649,5125,4524
California,El Dorado County,7,9799,5011,4788
California,El Dorado County,8,10898,5379,5519
California,El Dorado County,9,10515,5210,5305
California,El Dorado County,10,12189,6104,6085
California,El Dorado County,11,13360,6586,6774
California,El Dorado County,12,16346,7921,8425
California,El Dorado County,13,16206,7854,8352
California,El Dorado County,14,14190,7089,7101
California,El Dorado County,15,10754,5292,5462
California,El Dorado County,16,6926,3397,3529
California,El Dorado County,17,4191,1988,2203
California,El Dorado County,18,4328,1724,2604
California,Fresno County,0,994400,496016,498384
California,Fresno County,1,77299,39515,37784
California,Fresno County,2,80577,41032,39545
California,Fresno County,3,79551,40870,38681
California,Fresno County,4,71727,36379,35348
California,Fresno County,5,70764,35947,34817
California,Fresno County,6,80417,41056,39361
California,Fresno County,7,72036,37065,34971
California,Fresno County,8,67102,34041,33061
California,Fresno County,9,58541,29657,28884
California,Fresno County,10,55843,27918,27925
California,Fresno County,11,54618,27355,27263
California,Fresno County,12,54997,26910,28087
California,Fresno County,13,48815,23537,25278
California,Fresno County,14,40669,19398,21271
California,Fresno County,15,30698,14304,16394
California,Fresno County,16,20902,9301,11601
California,Fresno County,17,14028,5985,8043
California,Fresno County,18,15816,5746,10070
California,Glenn County,0,28047,14235,13812
California,Glenn County,1,1995,1043,952
California,Glenn County,2,2099,1104,995
California,Glenn County,3,2156,1103,1053
California,Glenn County,4,1922,1003,919
California,Glenn County,5,1806,933,873
California,Glenn County,6,1874,990,884
California,Glenn County,7,1747,906,841
California,Glenn County,8,1729,878,851
California,Glenn County,9,1521,752,769
California,Glenn County,10,1531,778,753
California,Glenn County,11,1617,792,825
California,Glenn County,12,1852,942,910
California,Glenn County,13,1745,876,869
California,Glenn County,14,1424,719,705
California,Glenn County,15,1108,563,545
California,Glenn County,16,836,407,429
California,Glenn County,17,540,241,299
California,Glenn County,18,545,205,340
California,Humboldt County,0,136373,67913,68460
California,Humboldt County,1,7251,3764,3487
California,Humboldt County,2,7209,3686,3523
California,Humboldt County,3,7394,3781,3613
California,Humboldt County,4,8904,4441,4463
California,Humboldt County,5,12667,6251,6416
California,Humboldt County,6,9823,5058,4765
California,Humboldt County,7,8311,4294,4017
California,Humboldt County,8,9464,4877,4587
California,Humboldt County,9,8373,4422,3951
California,Humboldt County,10,7417,3915,3502
California,Humboldt County,11,7069,3545,3524
California,Humboldt County,12,8788,4262,4526
California,Humboldt County,13,9323,4418,4905
California,Humboldt County,14,9062,4300,4762
California,Humboldt County,15,6364,3079,3285
California,Humboldt County,16,3844,1799,2045
California,Humboldt County,17,2377,1047,1330
California,Humboldt County,18,2733,974,1759
California,Imperial County,0,181827,93235,88592
California,Imperial County,1,14889,7575,7314
California,Imperial County,2,14623,7585,7038
California,Imperial County,3,13986,6959,7027
California,Imperial County,4,13563,7032,6531
California,Imperial County,5,13089,7197,5892
California,Imperial County,6,14215,8034,6181
California,Imperial County,7,12697,7236,5461
California,Imperial County,8,12001,6551,5450
California,Imperial County,9,10202,5425,4777
California,Imperial County,10,10128,5100,5028
California,Imperial County,11,9995,4966,5029
California,Imperial County,12,9798,4749,5049
California,Imperial County,13,9061,4254,4807
California,Imperial County,14,7332,3435,3897
California,Imperial County,15,5780,2643,3137
California,Imperial County,16,4222,1859,2363
California,Imperial County,17,2996,1308,1688
California,Imperial County,18,3250,1327,1923
California,Inyo County,0,17987,9044,8943
California,Inyo County,1,1011,501,510
California,Inyo County,2,1083,574,509
California,Inyo County,3,1019,522,497
California,Inyo County,4,928,500,428
California,Inyo County,5,828,428,400
California,Inyo County,6,893,439,454
California,Inyo County,7,1063,549,514
California,Inyo County,8,1110,584,526
California,Inyo County,9,915,476,439
California,Inyo County,10,965,490,475
California,Inyo County,11,994,475,519
California,Inyo County,12,1461,727,734
California,Inyo County,13,1507,731,776
California,Inyo County,14,1316,667,649
California,Inyo County,15,1002,525,477
California,Inyo County,16,731,337,394
California,Inyo County,17,536,262,274
California,Inyo County,18,625,257,368
California,Kern County,0,896764,459690,437074
California,Kern County,1,69785,35578,34207
California,Kern County,2,74172,37604,36568
California,Kern County,3,73637,37336,36301
California,Kern County,4,66394,34327,32067
California,Kern County,5,65720,35265,30455
California,Kern County,6,73491,39711,33780
California,Kern County,7,66219,35776,30443
California,Kern County,8,60946,32421,28525
California,Kern County,9,53421,28149,25272
California,Kern County,10,51266,26272,24994
California,Kern County,11,49175,24873,24302
California,Kern County,12,50348,25079,25269
California,Kern County,13,43843,21937,21906
California,Kern County,14,33832,16408,17424
California,Kern County,15,25532,11964,13568
California,Kern County,16,17762,8248,9514
California,Kern County,17,10840,4837,6003
California,Kern County,18,10381,3905,6476
California,Kings County,0,151366,83196,68170
California,Kings County,1,11371,5814,5557
California,Kings County,2,11885,5946,5939
California,Kings County,3,11490,5861,5629
California,Kings County,4,10164,5280,4884
California,Kings County,5,12660,7506,5154
California,Kings County,6,13439,8008,5431
California,Kings County,7,12303,7268,5035
California,Kings County,8,11130,6585,4545
California,Kings County,9,9685,5890,3795
California,Kings County,10,8975,5416,3559
California,Kings County,11,8391,4787,3604
California,Kings County,12,7841,4250,3591
California,Kings County,13,6516,3458,3058
California,Kings County,14,5086,2508,2578
California,Kings County,15,3893,1846,2047
California,Kings County,16,2741,1209,1532
California,Kings County,17,1928,844,1084
California,Kings County,18,1868,720,1148
California,Lake County,0,64382,32140,32242
California,Lake County,1,3779,1891,1888
California,Lake County,2,3771,1926,1845
California,Lake County,3,3734,1949,1785
California,Lake County,4,3423,1762,1661
California,Lake County,5,3017,1630,1387
California,Lake County,6,3676,1915,1761
California,Lake County,7,3690,1864,1826
California,Lake County,8,3507,1806,1701
California,Lake County,9,3222,1640,1582
California,Lake County,10,3607,1707,1900
California,Lake County,11,4076,1994,2082
California,Lake County,12,4852,2353,2499
California,Lake County,13,5393,2562,2831
California,Lake County,14,4943,2454,2489
California,Lake County,15,4023,2018,2005
California,Lake County,16,2645,1315,1330
California,Lake County,17,1583,763,820
California,Lake County,18,1441,591,850
California,Lassen County,0,30802,19155,11647
California,Lassen County,1,1533,793,740
California,Lassen County,2,1454,701,753
California,Lassen County,3,1439,758,681
California,Lassen County,4,1515,871,644
California,Lassen County,5,2364,1763,601
California,Lassen County,6,2999,2269,730
California,Lassen County,7,2706,2010,696
California,Lassen County,8,2361,1676,685
California,Lassen County,9,2134,1524,610
California,Lassen County,10,2062,1365,697
California,Lassen County,11,1882,1152,730
California,Lassen County,12,1850,1036,814
California,Lassen County,13,1836,918,918
California,Lassen County,14,1633,875,758
California,Lassen County,15,1257,618,639
California,Lassen County,16,740,353,387
California,Lassen County,17,467,239,228
California,Lassen County,18,570,234,336
California,Los Angeles County,0,10105518,4981895,5123623
California,Los Angeles County,1,603555,309680,293875
California,Los Angeles County,2,604698,309372,295326
California,Los Angeles County,3,610207,312086,298121
California,Los Angeles County,4,628932,319722,309210
California,Los Angeles County,5,700953,352925,348028
California,Los Angeles County,6,856120,435805,420315
California,Los Angeles County,7,783916,401667,382249
California,Los Angeles County,8,717928,363020,354908
California,Los Angeles County,9,663194,329493,333701
California,Los Angeles County,10,686882,340062,346820
California,Los Angeles County,11,661685,327276,334409
California,Los Angeles County,12,644318,314317,330001
California,Los Angeles County,13,567173,270049,297124
California,Los Angeles County,14,447152,206523,240629
California,Los Angeles County,15,337469,151633,185836
California,Los Angeles County,16,235061,101591,133470
California,Los Angeles County,17,164813,67774,97039
California,Los Angeles County,18,191462,68900,122562
California,Madera County,0,157672,76008,81664
California,Madera County,1,11922,6075,5847
California,Madera County,2,12162,6203,5959
California,Madera County,3,12264,6162,6102
California,Madera County,4,11120,5734,5386
California,Madera County,5,10743,5162,5581
California,Madera County,6,11563,5477,6086
California,Madera County,7,10462,4910,5552
California,Madera County,8,10456,4804,5652
California,Madera County,9,9403,4211,5192
California,Madera County,10,9288,4280,5008
California,Madera County,11,8830,4193,4637
California,Madera County,12,8944,4294,4650
California,Madera County,13,8464,4062,4402
California,Madera County,14,7524,3700,3824
California,Madera County,15,5776,2763,3013
California,Madera County,16,3966,1883,2083
California,Madera County,17,2407,1074,1333
California,Madera County,18,2378,1021,1357
California,Marin County,0,259666,126989,132677
California,Marin County,1,11842,5966,5876
California,Marin County,2,13794,7034,6760
California,Marin County,3,16388,8340,8048
California,Marin County,4,15088,7616,7472
California,Marin County,5,11793,6077,5716
California,Marin County,6,10773,5898,4875
California,Marin County,7,11748,6227,5521
California,Marin County,8,14325,7185,7140
California,Marin County,9,16171,8123,8048
California,Marin County,10,20014,9915,10099
California,Marin County,11,20298,10058,10240
California,Marin County,12,20123,9730,10393
California,Marin County,13,19366,9075,10291
California,Marin County,14,18061,8225,9836
California,Marin County,15,15409,7125,8284
California,Marin County,16,10305,4709,5596
California,Marin County,17,6343,2821,3522
California,Marin County,18,7825,2865,4960
California,Mariposa County,0,17471,8904,8567
California,Mariposa County,1,750,403,347
California,Mariposa County,2,786,392,394
California,Mariposa County,3,787,386,401
California,Mariposa County,4,763,409,354
California,Mariposa County,5,824,452,372
California,Mariposa County,6,993,513,480
California,Mariposa County,7,876,467,409
California,Mariposa County,8,891,441,450
California,Mariposa County,9,777,403,374
California,Mariposa County,10,876,462,414
California,Mariposa County,11,1095,542,553
California,Mariposa County,12,1499,746,753
California,Mariposa County,13,1672,834,838
California,Mariposa County,14,1550,769,781
California,Mariposa County,15,1289,701,588
California,Mariposa County,16,922,458,464
California,Mariposa County,17,577,303,274
California,Mariposa County,18,544,223,321
California,Mendocino County,0,87606,43403,44203
California,Mendocino County,1,5160,2576,2584
California,Mendocino County,2,5205,2683,2522
California,Mendocino County,3,5234,2707,2527
California,Mendocino County,4,4994,2594,2400
California,Mendocino County,5,4503,2300,2203
California,Mendocino County,6,4920,2555,2365
California,Mendocino County,7,4963,2543,2420
California,Mendocino County,8,5396,2733,2663
California,Mendocino County,9,5080,2598,2482
California,Mendocino County,10,5127,2546,2581
California,Mendocino County,11,5059,2523,2536
California,Mendocino County,12,5922,2870,3052
California,Mendocino County,13,6677,3196,3481
California,Mendocino County,14,6857,3228,3629
California,Mendocino County,15,5505,2730,2775
California,Mendocino County,16,3097,1482,1615
California,Mendocino County,17,1792,829,963
California,Mendocino County,18,2115,710,1405
California,Merced County,0,274765,138632,136133
California,Merced County,1,21174,10835,10339
California,Merced County,2,22566,11568,10998
California,Merced County,3,23193,11906,11287
California,Merced County,4,23859,12153,11706
California,Merced County,5,20649,10842,9807
California,Merced County,6,21277,11076,10201
California,Merced County,7,19012,10073,8939
California,Merced County,8,17798,9024,8774
California,Merced County,9,15933,7973,7960
California,Merced County,10,15740,7778,7962
California,Merced County,11,15025,7631,7394
California,Merced County,12,14770,7392,7378
California,Merced County,13,12924,6356,6568
California,Merced County,14,10122,4889,5233
California,Merced County,15,7987,3724,4263
California,Merced County,16,5387,2472,2915
California,Merced County,17,3625,1549,2076
California,Merced County,18,3724,1391,2333
California,Modoc County,0,8777,4386,4391
California,Modoc County,1,435,204,231
California,Modoc County,2,497,252,245
California,Modoc County,3,475,244,231
California,Modoc County,4,435,235,200
California,Modoc County,5,397,208,189
California,Modoc County,6,446,232,214
California,Modoc County,7,437,200,237
California,Modoc County,8,461,233,228
California,Modoc County,9,436,201,235
California,Modoc County,10,472,259,213
California,Modoc County,11,503,227,276
California,Modoc County,12,659,323,336
California,Modoc County,13,766,375,391
California,Modoc County,14,754,379,375
California,Modoc County,15,640,338,302
California,Modoc County,16,455,245,210
California,Modoc County,17,258,121,137
California,Modoc County,18,251,110,141
California,Mono County,0,14250,7571,6679
California,Mono County,1,691,360,331
California,Mono County,2,702,330,372
California,Mono County,3,778,393,385
California,Mono County,4,750,388,362
California,Mono County,5,982,548,434
California,Mono County,6,1027,577,450
California,Mono County,7,1059,532,527
California,Mono County,8,976,507,469
California,Mono County,9,871,485,386
California,Mono County,10,947,517,430
California,Mono County,11,941,529,412
California,Mono County,12,1158,593,565
California,Mono County,13,1115,608,507
California,Mono County,14,899,478,421
California,Mono County,15,571,317,254
California,Mono County,16,380,204,176
California,Mono County,17,198,97,101
California,Mono County,18,205,108,97
California,Monterey County,0,435594,221787,213807
California,Monterey County,1,30950,15799,15151
California,Monterey County,2,32700,16798,15902
California,Monterey County,3,32143,16481,15662
California,Monterey County,4,30786,15445,15341
California,Monterey County,5,30484,15836,14648
California,Monterey County,6,31403,16520,14883
California,Monterey County,7,31037,16644,14393
California,Monterey County,8,29768,15836,13932
California,Monterey County,9,27046,14491,12555
California,Monterey County,10,26268,13932,12336
California,Monterey County,11,25048,13066,11982
California,Monterey County,12,25217,12413,12804
California,Monterey County,13,23543,11457,12086
California,Monterey County,14,19759,9569,10190
California,Monterey County,15,14899,7026,7873
California,Monterey County,16,9585,4505,5080
California,Monterey County,17,6532,2823,3709
California,Monterey County,18,8426,3146,5280
California,Napa County,0,139417,69392,70025
California,Napa County,1,7049,3605,3444
California,Napa County,2,7801,4036,3765
California,Napa County,3,8569,4451,4118
California,Napa County,4,8764,4402,4362
California,Napa County,5,8444,4275,4169
California,Napa County,6,8651,4441,4210
California,Napa County,7,8468,4314,4154
California,Napa County,8,8958,4612,4346
California,Napa County,9,8675,4426,4249
California,Napa County,10,9159,4555,4604
California,Napa County,11,9274,4630,4644
California,Napa County,12,9707,4840,4867
California,Napa County,13,9233,4473,4760
California,Napa County,14,8379,4014,4365
California,Napa County,15,6716,3177,3539
California,Napa County,16,4711,2263,2448
California,Napa County,17,3197,1499,1698
California,Napa County,18,3662,1379,2283
California,Nevada County,0,99696,48920,50776
California,Nevada County,1,4282,2186,2096
California,Nevada County,2,4637,2390,2247
California,Nevada County,3,5006,2550,2456
California,Nevada County,4,4869,2543,2326
California,Nevada County,5,4218,2202,2016
California,Nevada County,6,4578,2334,2244
California,Nevada County,7,5038,2541,2497
California,Nevada County,8,5766,2927,2839
California,Nevada County,9,5257,2691,2566
California,Nevada County,10,5491,2787,2704
California,Nevada County,11,5960,2882,3078
California,Nevada County,12,7957,3634,4323
California,Nevada County,13,9257,4306,4951
California,Nevada County,14,9395,4507,4888
California,Nevada County,15,7531,3720,3811
California,Nevada County,16,4609,2228,2381
California,Nevada County,17,2796,1364,1432
California,Nevada County,18,3049,1128,1921
California,Orange County,0,3185968,1572801,1613167
California,Orange County,1,187486,96162,91324
California,Orange County,2,188161,96378,91783
California,Orange County,3,200154,102332,97822
California,Orange County,4,204892,104049,100843
California,Orange County,5,210107,106528,103579
California,Orange County,6,243613,125620,117993
California,Orange County,7,216966,111107,105859
California,Orange County,8,210516,105483,105033
California,Orange County,9,201901,98624,103277
California,Orange County,10,224329,109645,114684
California,Orange County,11,222233,109741,112492
California,Orange County,12,217563,107363,110200
California,Orange County,13,187660,90897,96763
California,Orange County,14,148314,69512,78802
California,Orange County,15,117735,53676,64059
California,Orange County,16,83665,37454,46211
California,Orange County,17,57494,24750,32744
California,Orange County,18,63179,23480,39699
California,Placer County,0,393149,192147,201002
California,Placer County,1,20976,10733,10243
California,Placer County,2,24188,12228,11960
California,Placer County,3,26259,13462,12797
California,Placer County,4,24494,12730,11764
California,Placer County,5,20413,10513,9900
California,Placer County,6,21095,10910,10185
California,Placer County,7,22052,10929,11123
California,Placer County,8,26176,12888,13288
California,Placer County,9,25042,12415,12627
California,Placer County,10,26751,13148,13603
California,Placer County,11,25954,12659,13295
California,Placer County,12,27395,13274,14121
California,Placer County,13,25448,11899,13549
California,Placer County,14,23366,10838,12528
California,Placer County,15,20322,9336,10986
California,Placer County,16,14158,6362,7796
California,Placer County,17,9335,4124,5211
California,Placer County,18,9725,3699,6026
California,Plumas County,0,18804,9360,9444
California,Plumas County,1,861,408,453
California,Plumas County,2,829,448,381
California,Plumas County,3,945,462,483
California,Plumas County,4,926,485,441
California,Plumas County,5,725,378,347
California,Plumas County,6,915,470,445
California,Plumas County,7,966,474,492
California,Plumas County,8,941,469,472
California,Plumas County,9,859,439,420
California,Plumas County,10,872,447,425
California,Plumas County,11,1116,545,571
California,Plumas County,12,1587,742,845
California,Plumas County,13,1917,899,1018
California,Plumas County,14,1867,969,898
California,Plumas County,15,1482,752,730
California,Plumas County,16,984,531,453
California,Plumas County,17,548,265,283
California,Plumas County,18,464,177,287
California,Riverside County,0,2450758,1221375,1229383
California,Riverside County,1,158812,81026,77786
California,Riverside County,2,169386,86662,82724
California,Riverside County,3,180282,92063,88219
California,Riverside County,4,177051,90054,86997
California,Riverside County,5,168029,85700,82329
California,Riverside County,6,177675,91628,86047
California,Riverside County,7,164772,84263,80509
California,Riverside County,8,164156,82382,81774
California,Riverside County,9,151127,74995,76132
California,Riverside County,10,154262,76574,77688
California,Riverside County,11,150972,76118,74854
California,Riverside County,12,148702,74074,74628
California,Riverside County,13,132410,64676,67734
California,Riverside County,14,109135,51537,57598
California,Riverside County,15,91537,42718,48819
California,Riverside County,16,65392,29671,35721
California,Riverside County,17,44102,19802,24300
California,Riverside County,18,42956,17432,25524
California,Sacramento County,0,1540975,752972,788003
California,Sacramento County,1,98953,50249,48704
California,Sacramento County,2,101004,51722,49282
California,Sacramento County,3,103841,53066,50775
California,Sacramento County,4,94932,48626,46306
California,Sacramento County,5,96256,48746,47510
California,Sacramento County,6,124267,62171,62096
California,Sacramento County,7,118321,59268,59053
California,Sacramento County,8,109932,55001,54931
California,Sacramento County,9,95293,46802,48491
California,Sacramento County,10,97069,47435,49634
California,Sacramento County,11,95032,46388,48644
California,Sacramento County,12,99229,47681,51548
California,Sacramento County,13,89245,41673,47572
California,Sacramento County,14,73425,33492,39933
California,Sacramento County,15,55300,24776,30524
California,Sacramento County,16,36364,15491,20873
California,Sacramento County,17,24651,10135,14516
California,Sacramento County,18,27861,10250,17611
California,San Benito County,0,61537,30843,30694
California,San Benito County,1,4072,2027,2045
California,San Benito County,2,4310,2210,2100
California,San Benito County,3,4707,2313,2394
California,San Benito County,4,4418,2288,2130
California,San Benito County,5,4084,2058,2026
California,San Benito County,6,4143,2160,1983
California,San Benito County,7,4281,2236,2045
California,San Benito County,8,4182,2160,2022
California,San Benito County,9,3954,2047,1907
California,San Benito County,10,3885,1933,1952
California,San Benito County,11,4046,2006,2040
California,San Benito County,12,4064,2031,2033
California,San Benito County,13,3454,1726,1728
California,San Benito County,14,2767,1326,1441
California,San Benito County,15,2006,976,1030
California,San Benito County,16,1343,612,731
California,San Benito County,17,845,372,473
California,San Benito County,18,976,362,614
California,San Bernardino County,0,2171603,1080950,1090653
California,San Bernardino County,1,155258,79286,75972
California,San Bernardino County,2,158113,80411,77702
California,San Bernardino County,3,162767,83503,79264
California,San Bernardino County,4,156631,81058,75573
California,San Bernardino County,5,163711,84941,78770
California,San Bernardino County,6,176422,90599,85823
California,San Bernardino County,7,155753,79561,76192
California,San Bernardino County,8,146687,73654,73033
California,San Bernardino County,9,133631,66174,67457
California,San Bernardino County,10,134369,65859,68510
California,San Bernardino County,11,130878,64458,66420
California,San Bernardino County,12,131373,63739,67634
California,San Bernardino County,13,114649,54863,59786
California,San Bernardino County,14,88483,41645,46838
California,San Bernardino County,15,65177,30420,34757
California,San Bernardino County,16,42891,19099,23792
California,San Bernardino County,17,27697,11733,15964
California,San Bernardino County,18,27113,9947,17166
California,San Diego County,0,3343364,1682449,1660915
California,San Diego County,1,208270,106687,101583
California,San Diego County,2,200824,102660,98164
California,San Diego County,3,197110,100490,96620
California,San Diego County,4,207127,107972,99155
California,San Diego County,5,251805,139929,111876
California,San Diego County,6,286427,150570,135857
California,San Diego County,7,264493,137876,126617
California,San Diego County,8,240211,123702,116509
California,San Diego County,9,208530,104956,103574
California,San Diego County,10,209193,104208,104985
California,San Diego County,11,203950,101423,102527
California,San Diego County,12,208106,102542,105564
California,San Diego County,13,187864,90315,97549
California,San Diego County,14,153360,72182,81178
California,San Diego County,15,118628,54728,63900
California,San Diego County,16,79028,35286,43742
California,San Diego County,17,54224,22956,31268
California,San Diego County,18,64214,23967,40247
California,San Francisco County,0,883305,450363,432942
California,San Francisco County,1,39722,20351,19371
California,San Francisco County,2,32285,16613,15672
California,San Francisco County,3,29737,15071,14666
California,San Francisco County,4,30923,14992,15931
California,San Francisco County,5,48005,23467,24538
California,San Francisco County,6,103432,53343,50089
California,San Francisco County,7,104864,54932,49932
California,San Francisco County,8,78518,41778,36740
California,San Francisco County,9,60818,32203,28615
California,San Francisco County,10,60003,32347,27656
California,San Francisco County,11,55093,30032,25061
California,San Francisco County,12,52302,27598,24704
California,San Francisco County,13,49354,25075,24279
California,San Francisco County,14,44340,21542,22798
California,San Francisco County,15,32506,15371,17135
California,San Francisco County,16,22094,9989,12105
California,San Francisco County,17,17480,7484,9996
California,San Francisco County,18,21829,8175,13654
California,San Joaquin County,0,752660,375136,377524
California,San Joaquin County,1,53303,27380,25923
California,San Joaquin County,2,57056,29226,27830
California,San Joaquin County,3,59320,30387,28933
California,San Joaquin County,4,55652,28759,26893
California,San Joaquin County,5,50968,26184,24784
California,San Joaquin County,6,54998,28342,26656
California,San Joaquin County,7,50850,25739,25111
California,San Joaquin County,8,51350,25947,25403
California,San Joaquin County,9,46585,23239,23346
California,San Joaquin County,10,46854,23269,23585
California,San Joaquin County,11,45209,22859,22350
California,San Joaquin County,12,44905,22044,22861
California,San Joaquin County,13,39694,19313,20381
California,San Joaquin County,14,32035,15002,17033
California,San Joaquin County,15,24778,11394,13384
California,San Joaquin County,16,16685,7383,9302
California,San Joaquin County,17,10690,4507,6183
California,San Joaquin County,18,11728,4162,7566
California,San Luis Obispo County,0,284010,144092,139918
California,San Luis Obispo County,1,13125,6737,6388
California,San Luis Obispo County,2,13922,7206,6716
California,San Luis Obispo County,3,14433,7333,7100
California,San Luis Obispo County,4,21498,11055,10443
California,San Luis Obispo County,5,30190,16530,13660
California,San Luis Obispo County,6,16664,9128,7536
California,San Luis Obispo County,7,15927,8444,7483
California,San Luis Obispo County,8,16813,8866,7947
California,San Luis Obispo County,9,14605,7866,6739
California,San Luis Obispo County,10,15137,8004,7133
California,San Luis Obispo County,11,15702,7967,7735
California,San Luis Obispo County,12,18800,9085,9715
California,San Luis Obispo County,13,20154,9333,10821
California,San Luis Obispo County,14,19095,9170,9925
California,San Luis Obispo County,15,14797,7159,7638
California,San Luis Obispo County,16,9669,4574,5095
California,San Luis Obispo County,17,6318,2809,3509
California,San Luis Obispo County,18,7161,2826,4335
California,San Mateo County,0,769545,380308,389237
California,San Mateo County,1,43545,22435,21110
California,San Mateo County,2,43638,22315,21323
California,San Mateo County,3,44727,22752,21975
California,San Mateo County,4,41205,21174,20031
California,San Mateo County,5,41216,21168,20048
California,San Mateo County,6,56080,29534,26546
California,San Mateo County,7,59278,30693,28585
California,San Mateo County,8,57307,28773,28534
California,San Mateo County,9,52742,26595,26147
California,San Mateo County,10,54138,26907,27231
California,San Mateo County,11,52048,25484,26564
California,San Mateo County,12,52514,25602,26912
California,San Mateo County,13,47186,22678,24508
California,San Mateo County,14,39394,18443,20951
California,San Mateo County,15,30376,13682,16694
California,San Mateo County,16,21233,9159,12074
California,San Mateo County,17,14753,6307,8446
California,San Mateo County,18,18165,6607,11558
California,Santa Barbara County,0,446527,223377,223150
California,Santa Barbara County,1,27676,14224,13452
California,Santa Barbara County,2,27964,14257,13707
California,Santa Barbara County,3,27372,13780,13592
California,Santa Barbara County,4,36429,17966,18463
California,Santa Barbara County,5,49772,25528,24244
California,Santa Barbara County,6,32738,17548,15190
California,Santa Barbara County,7,26859,14230,12629
California,Santa Barbara County,8,26877,14105,12772
California,Santa Barbara County,9,23768,12202,11566
California,Santa Barbara County,10,23979,12184,11795
California,Santa Barbara County,11,24006,12012,11994
California,Santa Barbara County,12,26168,12735,13433
California,Santa Barbara County,13,24454,11929,12525
California,Santa Barbara County,14,21083,9957,11126
California,Santa Barbara County,15,16637,7834,8803
California,Santa Barbara County,16,11726,5250,6476
California,Santa Barbara County,17,8429,3575,4854
California,Santa Barbara County,18,10590,4061,6529
California,Santa Clara County,0,1937570,980868,956702
California,Santa Clara County,1,115074,58864,56210
California,Santa Clara County,2,116531,59573,56958
California,Santa Clara County,3,122117,62772,59345
California,Santa Clara County,4,115018,59005,56013
California,Santa Clara County,5,119735,63125,56610
California,Santa Clara County,6,158337,85728,72609
California,Santa Clara County,7,156679,83676,73003
California,Santa Clara County,8,145506,75710,69796
California,Santa Clara County,9,133920,68043,65877
California,Santa Clara County,10,136243,68590,67653
California,Santa Clara County,11,128707,65406,63301
California,Santa Clara County,12,124070,62679,61391
California,Santa Clara County,13,104502,51434,53068
California,Santa Clara County,14,82155,38757,43398
California,Santa Clara County,15,63652,29067,34585
California,Santa Clara County,16,46268,20624,25644
California,Santa Clara County,17,32401,13921,18480
California,Santa Clara County,18,36655,13894,22761
California,Santa Cruz County,0,274255,135725,138530
California,Santa Cruz County,1,13937,7169,6768
California,Santa Cruz County,2,14702,7463,7239
California,Santa Cruz County,3,15128,7717,7411
California,Santa Cruz County,4,22426,11019,11407
California,Santa Cruz County,5,27512,13650,13862
California,Santa Cruz County,6,17879,9412,8467
California,Santa Cruz County,7,15417,7913,7504
California,Santa Cruz County,8,16273,8162,8111
California,Santa Cruz County,9,15690,7812,7878
California,Santa Cruz County,10,16602,8389,8213
California,Santa Cruz County,11,16934,8429,8505
California,Santa Cruz County,12,18152,8852,9300
California,Santa Cruz County,13,18476,8934,9542
California,Santa Cruz County,14,16821,8300,8521
California,Santa Cruz County,15,12056,5775,6281
California,Santa Cruz County,16,6945,3165,3780
California,Santa Cruz County,17,4196,1831,2365
California,Santa Cruz County,18,5109,1733,3376
California,Shasta County,0,180040,88367,91673
California,Shasta County,1,10597,5448,5149
California,Shasta County,2,10609,5435,5174
California,Shasta County,3,10762,5427,5335
California,Shasta County,4,10412,5430,4982
California,Shasta County,5,9876,5114,4762
California,Shasta County,6,11797,5978,5819
California,Shasta County,7,11365,5722,5643
California,Shasta County,8,10922,5433,5489
California,Shasta County,9,9144,4611,4533
California,Shasta County,10,9846,4818,5028
California,Shasta County,11,10772,5111,5661
California,Shasta County,12,13143,6357,6786
California,Shasta County,13,13242,6237,7005
California,Shasta County,14,12087,5739,6348
California,Shasta County,15,9929,4715,5214
California,Shasta County,16,6888,3245,3643
California,Shasta County,17,4365,1928,2437
California,Shasta County,18,4284,1619,2665
California,Sierra County,0,2987,1511,1476
California,Sierra County,1,139,67,72
California,Sierra County,2,133,73,60
California,Sierra County,3,130,60,70
California,Sierra County,4,115,68,47
California,Sierra County,5,110,67,43
California,Sierra County,6,128,78,50
California,Sierra County,7,119,53,66
California,Sierra County,8,143,76,67
California,Sierra County,9,145,71,74
California,Sierra County,10,152,69,83
California,Sierra County,11,169,84,85
California,Sierra County,12,279,149,130
California,Sierra County,13,280,132,148
California,Sierra County,14,347,178,169
California,Sierra County,15,239,115,124
California,Sierra County,16,174,93,81
California,Sierra County,17,100,39,61
California,Sierra County,18,85,39,46
California,Siskiyou County,0,43724,21731,21993
California,Siskiyou County,1,2268,1161,1107
California,Siskiyou County,2,2513,1218,1295
California,Siskiyou County,3,2598,1370,1228
California,Siskiyou County,4,2355,1236,1119
California,Siskiyou County,5,1994,1062,932
California,Siskiyou County,6,2273,1196,1077
California,Siskiyou County,7,2270,1167,1103
California,Siskiyou County,8,2383,1183,1200
California,Siskiyou County,9,2029,1042,987
California,Siskiyou County,10,2342,1194,1148
California,Siskiyou County,11,2388,1131,1257
California,Siskiyou County,12,3235,1513,1722
California,Siskiyou County,13,3916,1849,2067
California,Siskiyou County,14,3809,1873,1936
California,Siskiyou County,15,3077,1530,1547
California,Siskiyou County,16,1966,1026,940
California,Siskiyou County,17,1158,535,623
California,Siskiyou County,18,1150,445,705
California,Solano County,0,446610,221997,224613
California,Solano County,1,26952,13871,13081
California,Solano County,2,27392,13952,13440
California,Solano County,3,27730,14336,13394
California,Solano County,4,26630,13743,12887
California,Solano County,5,28735,15305,13430
California,Solano County,6,33838,17668,16170
California,Solano County,7,31955,16305,15650
California,Solano County,8,30167,15423,14744
California,Solano County,9,26300,13248,13052
California,Solano County,10,27388,13783,13605
California,Solano County,11,28824,14259,14565
California,Solano County,12,31182,15219,15963
California,Solano County,13,29087,13604,15483
California,Solano County,14,24462,11515,12947
California,Solano County,15,18669,8550,10119
California,Solano County,16,11674,5075,6599
California,Solano County,17,7634,3198,4436
California,Solano County,18,7991,2943,5048
California,Sonoma County,0,499942,244124,255818
California,Sonoma County,1,24820,12582,12238
California,Sonoma County,2,27021,13766,13255
California,Sonoma County,3,28764,14684,14080
California,Sonoma County,4,29764,14924,14840
California,Sonoma County,5,28106,14178,13928
California,Sonoma County,6,32557,16935,15622
California,Sonoma County,7,31914,16415,15499
California,Sonoma County,8,32834,16462,16372
California,Sonoma County,9,29577,14931,14646
California,Sonoma County,10,31134,15410,15724
California,Sonoma County,11,32550,15994,16556
California,Sonoma County,12,36135,17227,18908
California,Sonoma County,13,36052,16929,19123
California,Sonoma County,14,33834,15581,18253
California,Sonoma County,15,26685,12422,14263
California,Sonoma County,16,16032,7150,8882
California,Sonoma County,17,10055,4255,5800
California,Sonoma County,18,12108,4279,7829
California,Stanislaus County,0,549815,272316,277499
California,Stanislaus County,1,39758,20338,19420
California,Stanislaus County,2,41581,21069,20512
California,Stanislaus County,3,42621,21632,20989
California,Stanislaus County,4,39385,20324,19061
California,Stanislaus County,5,36896,18851,18045
California,Stanislaus County,6,41085,20769,20316
California,Stanislaus County,7,38591,19648,18943
California,Stanislaus County,8,36614,18462,18152
California,Stanislaus County,9,33193,16664,16529
California,Stanislaus County,10,33115,16425,16690
California,Stanislaus County,11,32368,15917,16451
California,Stanislaus County,12,33128,16173,16955
California,Stanislaus County,13,29161,14062,15099
California,Stanislaus County,14,23831,11075,12756
California,Stanislaus County,15,18614,8543,10071
California,Stanislaus County,16,12471,5521,6950
California,Stanislaus County,17,8608,3546,5062
California,Stanislaus County,18,8795,3297,5498
California,Sutter County,0,96807,48222,48585
California,Sutter County,1,6735,3516,3219
California,Sutter County,2,6752,3492,3260
California,Sutter County,3,7286,3755,3531
California,Sutter County,4,6573,3377,3196
California,Sutter County,5,6059,3160,2899
California,Sutter County,6,7158,3666,3492
California,Sutter County,7,6554,3346,3208
California,Sutter County,8,6087,3016,3071
California,Sutter County,9,5602,2803,2799
California,Sutter County,10,5630,2778,2852
California,Sutter County,11,5816,2880,2936
California,Sutter County,12,6037,2932,3105
California,Sutter County,13,5616,2740,2876
California,Sutter County,14,4396,2111,2285
California,Sutter County,15,3747,1769,1978
California,Sutter County,16,2766,1191,1575
California,Sutter County,17,2021,932,1089
California,Sutter County,18,1972,758,1214
California,Tehama County,0,63916,31743,32173
California,Tehama County,1,4119,2083,2036
California,Tehama County,2,4201,2165,2036
California,Tehama County,3,4488,2298,2190
California,Tehama County,4,3922,2011,1911
California,Tehama County,5,3501,1834,1667
California,Tehama County,6,4027,2071,1956
California,Tehama County,7,3693,1880,1813
California,Tehama County,8,3639,1863,1776
California,Tehama County,9,3418,1740,1678
California,Tehama County,10,3548,1796,1752
California,Tehama County,11,3932,1924,2008
California,Tehama County,12,4790,2255,2535
California,Tehama County,13,4249,2060,2189
California,Tehama County,14,3866,1832,2034
California,Tehama County,15,3222,1548,1674
California,Tehama County,16,2397,1127,1270
California,Tehama County,17,1521,696,825
California,Tehama County,18,1383,560,823
California,Trinity County,0,12535,6442,6093
California,Trinity County,1,544,296,248
California,Trinity County,2,580,300,280
California,Trinity County,3,651,361,290
California,Trinity County,4,561,289,272
California,Trinity County,5,498,261,237
California,Trinity County,6,543,272,271
California,Trinity County,7,586,303,283
California,Trinity County,8,668,340,328
California,Trinity County,9,644,317,327
California,Trinity County,10,663,359,304
California,Trinity County,11,810,416,394
California,Trinity County,12,1076,532,544
California,Trinity County,13,1291,623,668
California,Trinity County,14,1236,644,592
California,Trinity County,15,916,500,416
California,Trinity County,16,604,306,298
California,Trinity County,17,374,189,185
California,Trinity County,18,290,134,156
California,Tulare County,0,465861,233078,232783
California,Tulare County,1,36884,18926,17958
California,Tulare County,2,41224,21151,20073
California,Tulare County,3,41247,21034,20213
California,Tulare County,4,37368,19153,18215
California,Tulare County,5,33169,16761,16408
California,Tulare County,6,34574,17689,16885
California,Tulare County,7,31580,16042,15538
California,Tulare County,8,31327,15960,15367
California,Tulare County,9,27668,13799,13869
California,Tulare County,10,26182,13252,12930
California,Tulare County,11,25063,12486,12577
California,Tulare County,12,24549,12106,12443
California,Tulare County,13,21734,10510,11224
California,Tulare County,14,17643,8429,9214
California,Tulare County,15,13787,6501,7286
California,Tulare County,16,9333,4182,5151
California,Tulare County,17,6176,2629,3547
California,Tulare County,18,6353,2468,3885
California,Tuolumne County,0,54539,28296,26243
California,Tuolumne County,1,2393,1188,1205
California,Tuolumne County,2,2558,1297,1261
California,Tuolumne County,3,2657,1401,1256
California,Tuolumne County,4,2496,1309,1187
California,Tuolumne County,5,2679,1534,1145
California,Tuolumne County,6,3376,1959,1417
California,Tuolumne County,7,3142,1810,1332
California,Tuolumne County,8,3207,1817,1390
California,Tuolumne County,9,2825,1628,1197
California,Tuolumne County,10,2906,1603,1303
California,Tuolumne County,11,3184,1673,1511
California,Tuolumne County,12,4052,1941,2111
California,Tuolumne County,13,4785,2315,2470
California,Tuolumne County,14,4617,2287,2330
California,Tuolumne County,15,3850,1892,1958
California,Tuolumne County,16,2556,1227,1329
California,Tuolumne County,17,1673,786,887
California,Tuolumne County,18,1583,629,954
California,Ventura County,0,850967,421319,429648
California,Ventura County,1,49784,25540,24244
California,Ventura County,2,53892,27241,26651
California,Ventura County,3,56724,28883,27841
California,Ventura County,4,56319,28668,27651
California,Ventura County,5,57063,29151,27912
California,Ventura County,6,59641,30885,28756
California,Ventura County,7,54671,28321,26350
California,Ventura County,8,54473,27652,26821
California,Ventura County,9,51403,25291,26112
California,Ventura County,10,55609,27407,28202
California,Ventura County,11,56766,28106,28660
California,Ventura County,12,59144,28890,30254
California,Ventura County,13,53091,25969,27122
California,Ventura County,14,42601,20055,22546
California,Ventura County,15,33666,15813,17853
California,Ventura County,16,23039,10285,12754
California,Ventura County,17,15483,6569,8914
California,Ventura County,18,17598,6593,11005
California,Yolo County,0,220408,106746,113662
California,Yolo County,1,12414,6267,6147
California,Yolo County,2,12852,6496,6356
California,Yolo County,3,13174,6695,6479
California,Yolo County,4,21335,9983,11352
California,Yolo County,5,30835,14509,16326
California,Yolo County,6,16479,8304,8175
California,Yolo County,7,13600,6960,6640
California,Yolo County,8,13905,6889,7016
California,Yolo County,9,12121,6092,6029
California,Yolo County,10,11799,5755,6044
California,Yolo County,11,11621,5720,5901
California,Yolo County,12,11811,5684,6127
California,Yolo County,13,10927,5144,5783
California,Yolo County,14,9021,4167,4854
California,Yolo County,15,6965,3199,3766
California,Yolo County,16,4711,2171,2540
California,Yolo County,17,3150,1333,1817
California,Yolo County,18,3688,1378,2310
California,Yuba County,0,78041,39503,38538
California,Yuba County,1,6187,3207,2980
California,Yuba County,2,6242,3146,3096
California,Yuba County,3,5894,3037,2857
California,Yuba County,4,5091,2705,2386
California,Yuba County,5,5510,3054,2456
California,Yuba County,6,6254,3206,3048
California,Yuba County,7,6024,3045,2979
California,Yuba County,8,5403,2703,2700
California,Yuba County,9,4388,2228,2160
California,Yuba County,10,4070,1972,2098
California,Yuba County,11,4187,2177,2010
California,Yuba County,12,4584,2252,2332
California,Yuba County,13,4252,2064,2188
California,Yuba County,14,3580,1766,1814
California,Yuba County,15,2628,1221,1407
California,Yuba County,16,1706,846,860
California,Yuba County,17,1086,470,616
California,Yuba County,18,955,404,551
Colorado,Adams County,0,511868,258470,253398
Colorado,Adams County,1,36180,18387,17793
Colorado,Adams County,2,37711,19250,18461
Colorado,Adams County,3,39279,20052,19227
Colorado,Adams County,4,35091,18097,16994
Colorado,Adams County,5,31852,16330,15522
Colorado,Adams County,6,41126,21310,19816
Colorado,Adams County,7,42569,22092,20477
Colorado,Adams County,8,40637,20960,19677
Colorado,Adams County,9,34887,18133,16754
Colorado,Adams County,10,33417,17072,16345
Colorado,Adams County,11,30002,15209,14793
Colorado,Adams County,12,30061,14988,15073
Colorado,Adams County,13,25469,12545,12924
Colorado,Adams County,14,19515,9274,10241
Colorado,Adams County,15,13908,6475,7433
Colorado,Adams County,16,8873,3812,5061
Colorado,Adams County,17,5829,2438,3391
Colorado,Adams County,18,5462,2046,3416
Colorado,Alamosa County,0,16683,8361,8322
Colorado,Alamosa County,1,1088,569,519
Colorado,Alamosa County,2,1208,652,556
Colorado,Alamosa County,3,1074,573,501
Colorado,Alamosa County,4,1716,851,865
Colorado,Alamosa County,5,1827,893,934
Colorado,Alamosa County,6,1262,658,604
Colorado,Alamosa County,7,1065,543,522
Colorado,Alamosa County,8,972,476,496
Colorado,Alamosa County,9,836,426,410
Colorado,Alamosa County,10,745,388,357
Colorado,Alamosa County,11,815,401,414
Colorado,Alamosa County,12,941,449,492
Colorado,Alamosa County,13,863,410,453
Colorado,Alamosa County,14,779,385,394
Colorado,Alamosa County,15,597,270,327
Colorado,Alamosa County,16,385,186,199
Colorado,Alamosa County,17,276,137,139
Colorado,Alamosa County,18,234,94,140
Colorado,Arapahoe County,0,651215,322713,328502
Colorado,Arapahoe County,1,40524,20635,19889
Colorado,Arapahoe County,2,42191,21488,20703
Colorado,Arapahoe County,3,44306,22873,21433
Colorado,Arapahoe County,4,40285,20699,19586
Colorado,Arapahoe County,5,38857,19752,19105
Colorado,Arapahoe County,6,51593,26461,25132
Colorado,Arapahoe County,7,51156,26153,25003
Colorado,Arapahoe County,8,49261,24947,24314
Colorado,Arapahoe County,9,44124,22154,21970
Colorado,Arapahoe County,10,44501,22139,22362
Colorado,Arapahoe County,11,40082,19767,20315
Colorado,Arapahoe County,12,41378,19956,21422
Colorado,Arapahoe County,13,37892,18020,19872
Colorado,Arapahoe County,14,30905,14250,16655
Colorado,Arapahoe County,15,22384,10296,12088
Colorado,Arapahoe County,16,13862,6160,7702
Colorado,Arapahoe County,17,8602,3642,4960
Colorado,Arapahoe County,18,9312,3321,5991
Colorado,Archuleta County,0,13765,6898,6867
Colorado,Archuleta County,1,642,294,348
Colorado,Archuleta County,2,683,365,318
Colorado,Archuleta County,3,742,391,351
Colorado,Archuleta County,4,649,329,320
Colorado,Archuleta County,5,551,308,243
Colorado,Archuleta County,6,605,303,302
Colorado,Archuleta County,7,677,322,355
Colorado,Archuleta County,8,778,409,369
Colorado,Archuleta County,9,712,367,345
Colorado,Archuleta County,10,758,417,341
Colorado,Archuleta County,11,873,383,490
Colorado,Archuleta County,12,1184,570,614
Colorado,Archuleta County,13,1326,644,682
Colorado,Archuleta County,14,1422,707,715
Colorado,Archuleta County,15,1048,555,493
Colorado,Archuleta County,16,575,288,287
Colorado,Archuleta County,17,282,137,145
Colorado,Archuleta County,18,258,109,149
Colorado,Baca County,0,3585,1800,1785
Colorado,Baca County,1,196,110,86
Colorado,Baca County,2,238,133,105
Colorado,Baca County,3,239,117,122
Colorado,Baca County,4,193,95,98
Colorado,Baca County,5,188,104,84
Colorado,Baca County,6,186,111,75
Colorado,Baca County,7,184,88,96
Colorado,Baca County,8,192,92,100
Colorado,Baca County,9,171,99,72
Colorado,Baca County,10,170,86,84
Colorado,Baca County,11,195,100,95
Colorado,Baca County,12,263,124,139
Colorado,Baca County,13,284,149,135
Colorado,Baca County,14,236,102,134
Colorado,Baca County,15,204,97,107
Colorado,Baca County,16,150,75,75
Colorado,Baca County,17,128,57,71
Colorado,Baca County,18,168,61,107
Colorado,Bent County,0,5882,3848,2034
Colorado,Bent County,1,191,90,101
Colorado,Bent County,2,259,124,135
Colorado,Bent County,3,268,127,141
Colorado,Bent County,4,249,131,118
Colorado,Bent County,5,428,328,100
Colorado,Bent County,6,553,458,95
Colorado,Bent County,7,453,353,100
Colorado,Bent County,8,434,344,90
Colorado,Bent County,9,432,333,99
Colorado,Bent County,10,442,342,100
Colorado,Bent County,11,362,251,111
Colorado,Bent County,12,381,219,162
Colorado,Bent County,13,375,215,160
Colorado,Bent County,14,324,181,143
Colorado,Bent County,15,263,135,128
Colorado,Bent County,16,197,101,96
Colorado,Bent County,17,125,62,63
Colorado,Bent County,18,146,54,92
Colorado,Boulder County,0,326078,164069,162009
Colorado,Boulder County,1,14494,7441,7053
Colorado,Boulder County,2,16890,8687,8203
Colorado,Boulder County,3,19016,9655,9361
Colorado,Boulder County,4,26658,13523,13135
Colorado,Boulder County,5,33488,17561,15927
Colorado,Boulder County,6,24846,13629,11217
Colorado,Boulder County,7,20906,11241,9665
Colorado,Boulder County,8,20506,10365,10141
Colorado,Boulder County,9,20161,10055,10106
Colorado,Boulder County,10,21575,10809,10766
Colorado,Boulder County,11,19994,9855,10139
Colorado,Boulder County,12,21142,10382,10760
Colorado,Boulder County,13,19916,9619,10297
Colorado,Boulder County,14,16753,8062,8691
Colorado,Boulder County,15,12086,5816,6270
Colorado,Boulder County,16,7500,3405,4095
Colorado,Boulder County,17,4909,2144,2765
Colorado,Boulder County,18,5238,1820,3418
Colorado,Broomfield County,0,69267,34441,34826
Colorado,Broomfield County,1,3722,1866,1856
Colorado,Broomfield County,2,4340,2235,2105
Colorado,Broomfield County,3,4990,2542,2448
Colorado,Broomfield County,4,4407,2248,2159
Colorado,Broomfield County,5,3765,1911,1854
Colorado,Broomfield County,6,5454,2889,2565
Colorado,Broomfield County,7,5077,2699,2378
Colorado,Broomfield County,8,5049,2547,2502
Colorado,Broomfield County,9,5242,2635,2607
Colorado,Broomfield County,10,5162,2614,2548
Colorado,Broomfield County,11,4394,2189,2205
Colorado,Broomfield County,12,4234,2117,2117
Colorado,Broomfield County,13,3839,1847,1992
Colorado,Broomfield County,14,3208,1432,1776
Colorado,Broomfield County,15,2612,1180,1432
Colorado,Broomfield County,16,1573,697,876
Colorado,Broomfield County,17,1099,433,666
Colorado,Broomfield County,18,1100,360,740
Colorado,Chaffee County,0,20027,10582,9445
Colorado,Chaffee County,1,746,390,356
Colorado,Chaffee County,2,840,432,408
Colorado,Chaffee County,3,873,450,423
Colorado,Chaffee County,4,871,467,404
Colorado,Chaffee County,5,911,565,346
Colorado,Chaffee County,6,1283,794,489
Colorado,Chaffee County,7,1238,734,504
Colorado,Chaffee County,8,1271,721,550
Colorado,Chaffee County,9,1143,661,482
Colorado,Chaffee County,10,1228,669,559
Colorado,Chaffee County,11,1201,635,566
Colorado,Chaffee County,12,1552,745,807
Colorado,Chaffee County,13,1786,843,943
Colorado,Chaffee County,14,1798,894,904
Colorado,Chaffee County,15,1389,661,728
Colorado,Chaffee County,16,850,451,399
Colorado,Chaffee County,17,492,251,241
Colorado,Chaffee County,18,555,219,336
Colorado,Cheyenne County,0,1876,954,922
Colorado,Cheyenne County,1,131,62,69
Colorado,Cheyenne County,2,155,72,83
Colorado,Cheyenne County,3,124,69,55
Colorado,Cheyenne County,4,113,65,48
Colorado,Cheyenne County,5,81,40,41
Colorado,Cheyenne County,6,89,38,51
Colorado,Cheyenne County,7,106,57,49
Colorado,Cheyenne County,8,118,57,61
Colorado,Cheyenne County,9,90,47,43
Colorado,Cheyenne County,10,91,55,36
Colorado,Cheyenne County,11,113,71,42
Colorado,Cheyenne County,12,147,79,68
Colorado,Cheyenne County,13,133,62,71
Colorado,Cheyenne County,14,142,76,66
Colorado,Cheyenne County,15,73,44,29
Colorado,Cheyenne County,16,65,32,33
Colorado,Cheyenne County,17,39,13,26
Colorado,Cheyenne County,18,66,15,51
Colorado,Clear Creek County,0,9605,5067,4538
Colorado,Clear Creek County,1,374,192,182
Colorado,Clear Creek County,2,380,212,168
Colorado,Clear Creek County,3,448,248,200
Colorado,Clear Creek County,4,389,187,202
Colorado,Clear Creek County,5,358,199,159
Colorado,Clear Creek County,6,543,325,218
Colorado,Clear Creek County,7,598,355,243
Colorado,Clear Creek County,8,608,309,299
Colorado,Clear Creek County,9,643,338,305
Colorado,Clear Creek County,10,721,357,364
Colorado,Clear Creek County,11,723,347,376
Colorado,Clear Creek County,12,912,462,450
Colorado,Clear Creek County,13,955,504,451
Colorado,Clear Creek County,14,780,432,348
Colorado,Clear Creek County,15,578,291,287
Colorado,Clear Creek County,16,317,183,134
Colorado,Clear Creek County,17,138,65,73
Colorado,Clear Creek County,18,140,61,79
Colorado,Conejos County,0,8200,4117,4083
Colorado,Conejos County,1,533,250,283
Colorado,Conejos County,2,592,291,301
Colorado,Conejos County,3,636,325,311
Colorado,Conejos County,4,605,310,295
Colorado,Conejos County,5,471,250,221
Colorado,Conejos County,6,448,230,218
Colorado,Conejos County,7,435,230,205
Colorado,Conejos County,8,481,241,240
Colorado,Conejos County,9,401,214,187
Colorado,Conejos County,10,439,215,224
Colorado,Conejos County,11,440,230,210
Colorado,Conejos County,12,565,276,289
Colorado,Conejos County,13,572,290,282
Colorado,Conejos County,14,517,247,270
Colorado,Conejos County,15,424,202,222
Colorado,Conejos County,16,276,144,132
Colorado,Conejos County,17,208,96,112
Colorado,Conejos County,18,157,76,81
Colorado,Costilla County,0,3828,1982,1846
Colorado,Costilla County,1,173,82,91
Colorado,Costilla County,2,194,99,95
Colorado,Costilla County,3,215,126,89
Colorado,Costilla County,4,213,111,102
Colorado,Costilla County,5,181,105,76
Colorado,Costilla County,6,185,99,86
Colorado,Costilla County,7,184,86,98
Colorado,Costilla County,8,183,84,99
Colorado,Costilla County,9,158,78,80
Colorado,Costilla County,10,179,92,87
Colorado,Costilla County,11,248,134,114
Colorado,Costilla County,12,282,141,141
Colorado,Costilla County,13,388,198,190
Colorado,Costilla County,14,320,160,160
Colorado,Costilla County,15,299,171,128
Colorado,Costilla County,16,195,103,92
Colorado,Costilla County,17,130,81,49
Colorado,Costilla County,18,101,32,69
Colorado,Crowley County,0,5858,4286,1572
Colorado,Crowley County,1,147,83,64
Colorado,Crowley County,2,206,100,106
Colorado,Crowley County,3,222,107,115
Colorado,Crowley County,4,194,110,84
Colorado,Crowley County,5,483,420,63
Colorado,Crowley County,6,657,582,75
Colorado,Crowley County,7,563,492,71
Colorado,Crowley County,8,535,449,86
Colorado,Crowley County,9,496,418,78
Colorado,Crowley County,10,511,421,90
Colorado,Crowley County,11,383,301,82
Colorado,Crowley County,12,361,226,135
Colorado,Crowley County,13,297,174,123
Colorado,Crowley County,14,258,144,114
Colorado,Crowley County,15,213,110,103
Colorado,Crowley County,16,144,70,74
Colorado,Crowley County,17,87,43,44
Colorado,Crowley County,18,101,36,65
Colorado,Custer County,0,4954,2555,2399
Colorado,Custer County,1,163,93,70
Colorado,Custer County,2,184,91,93
Colorado,Custer County,3,186,105,81
Colorado,Custer County,4,219,107,112
Colorado,Custer County,5,167,88,79
Colorado,Custer County,6,202,130,72
Colorado,Custer County,7,167,95,72
Colorado,Custer County,8,216,129,87
Colorado,Custer County,9,197,103,94
Colorado,Custer County,10,246,134,112
Colorado,Custer County,11,267,112,155
Colorado,Custer County,12,510,244,266
Colorado,Custer County,13,636,295,341
Colorado,Custer County,14,678,332,346
Colorado,Custer County,15,467,268,199
Colorado,Custer County,16,231,131,100
Colorado,Custer County,17,129,64,65
Colorado,Custer County,18,89,34,55
Colorado,Delta County,0,30953,15501,15452
Colorado,Delta County,1,1507,792,715
Colorado,Delta County,2,1714,846,868
Colorado,Delta County,3,1828,900,928
Colorado,Delta County,4,1743,932,811
Colorado,Delta County,5,1407,749,658
Colorado,Delta County,6,1517,790,727
Colorado,Delta County,7,1517,830,687
Colorado,Delta County,8,1664,847,817
Colorado,Delta County,9,1573,824,749
Colorado,Delta County,10,1628,822,806
Colorado,Delta County,11,1762,893,869
Colorado,Delta County,12,2349,1167,1182
Colorado,Delta County,13,2720,1304,1416
Colorado,Delta County,14,2606,1231,1375
Colorado,Delta County,15,2109,1047,1062
Colorado,Delta County,16,1456,713,743
Colorado,Delta County,17,969,477,492
Colorado,Delta County,18,884,337,547
Colorado,Denver County,0,716492,359590,356902
Colorado,Denver County,1,42921,21887,21034
Colorado,Denver County,2,39148,20010,19138
Colorado,Denver County,3,37588,19012,18576
Colorado,Denver County,4,34579,17374,17205
Colorado,Denver County,5,42962,21033,21929
Colorado,Denver County,6,85242,42883,42359
Colorado,Denver County,7,81849,42505,39344
Colorado,Denver County,8,64579,33611,30968
Colorado,Denver County,9,50158,26204,23954
Colorado,Denver County,10,45199,23917,21282
Colorado,Denver County,11,37596,19743,17853
Colorado,Denver County,12,36298,18150,18148
Colorado,Denver County,13,34157,16382,17775
Colorado,Denver County,14,29714,13840,15874
Colorado,Denver County,15,21410,9797,11613
Colorado,Denver County,16,13440,5795,7645
Colorado,Denver County,17,8975,3689,5286
Colorado,Denver County,18,10677,3758,6919
Colorado,Dolores County,0,2074,1090,984
Colorado,Dolores County,1,73,31,42
Colorado,Dolores County,2,133,71,62
Colorado,Dolores County,3,129,67,62
Colorado,Dolores County,4,112,63,49
Colorado,Dolores County,5,84,49,35
Colorado,Dolores County,6,87,42,45
Colorado,Dolores County,7,81,41,40
Colorado,Dolores County,8,120,65,55
Colorado,Dolores County,9,115,54,61
Colorado,Dolores County,10,126,68,58
Colorado,Dolores County,11,134,64,70
Colorado,Dolores County,12,165,90,75
Colorado,Dolores County,13,195,100,95
Colorado,Dolores County,14,163,90,73
Colorado,Dolores County,15,150,80,70
Colorado,Dolores County,16,96,56,40
Colorado,Dolores County,17,61,35,26
Colorado,Dolores County,18,50,24,26
Colorado,Douglas County,0,342776,171127,171649
Colorado,Douglas County,1,20097,10273,9824
Colorado,Douglas County,2,23555,12173,11382
Colorado,Douglas County,3,27926,14173,13753
Colorado,Douglas County,4,25755,13307,12448
Colorado,Douglas County,5,17931,9147,8784
Colorado,Douglas County,6,17310,8767,8543
Colorado,Douglas County,7,20661,10332,10329
Colorado,Douglas County,8,24809,12372,12437
Colorado,Douglas County,9,25849,12799,13050
Colorado,Douglas County,10,29267,14663,14604
Colorado,Douglas County,11,25638,12770,12868
Colorado,Douglas County,12,23990,11864,12126
Colorado,Douglas County,13,19053,9445,9608
Colorado,Douglas County,14,15109,7220,7889
Colorado,Douglas County,15,11506,5450,6056
Colorado,Douglas County,16,6810,3261,3549
Colorado,Douglas County,17,3748,1651,2097
Colorado,Douglas County,18,3762,1460,2302
Colorado,Eagle County,0,54993,29160,25833
Colorado,Eagle County,1,3058,1571,1487
Colorado,Eagle County,2,3138,1666,1472
Colorado,Eagle County,3,3670,1864,1806
Colorado,Eagle County,4,3239,1686,1553
Colorado,Eagle County,5,2931,1607,1324
Colorado,Eagle County,6,4346,2445,1901
Colorado,Eagle County,7,4407,2465,1942
Colorado,Eagle County,8,4420,2306,2114
Colorado,Eagle County,9,4174,2214,1960
Colorado,Eagle County,10,4337,2342,1995
Colorado,Eagle County,11,3880,2003,1877
Colorado,Eagle County,12,3633,1902,1731
Colorado,Eagle County,13,3404,1799,1605
Colorado,Eagle County,14,2700,1405,1295
Colorado,Eagle County,15,1869,967,902
Colorado,Eagle County,16,973,512,461
Colorado,Eagle County,17,453,246,207
Colorado,Eagle County,18,361,160,201
Colorado,Elbert County,0,26282,13278,13004
Colorado,Elbert County,1,1229,616,613
Colorado,Elbert County,2,1509,806,703
Colorado,Elbert County,3,1804,905,899
Colorado,Elbert County,4,1771,922,849
Colorado,Elbert County,5,1272,663,609
Colorado,Elbert County,6,1099,552,547
Colorado,Elbert County,7,1224,614,610
Colorado,Elbert County,8,1456,730,726
Colorado,Elbert County,9,1501,760,741
Colorado,Elbert County,10,1944,957,987
Colorado,Elbert County,11,2243,1123,1120
Colorado,Elbert County,12,2567,1292,1275
Colorado,Elbert County,13,2352,1178,1174
Colorado,Elbert County,14,1784,883,901
Colorado,Elbert County,15,1240,669,571
Colorado,Elbert County,16,666,353,313
Colorado,Elbert County,17,328,159,169
Colorado,Elbert County,18,293,96,197
Colorado,El Paso County,0,713856,360720,353136
Colorado,El Paso County,1,48160,24685,23475
Colorado,El Paso County,2,47614,24307,23307
Colorado,El Paso County,3,47944,24407,23537
Colorado,El Paso County,4,48585,25699,22886
Colorado,El Paso County,5,57873,32799,25074
Colorado,El Paso County,6,60508,32314,28194
Colorado,El Paso County,7,54224,28137,26087
Colorado,El Paso County,8,49072,25065,24007
Colorado,El Paso County,9,41733,21181,20552
Colorado,El Paso County,10,41994,21035,20959
Colorado,El Paso County,11,41370,20082,21288
Colorado,El Paso County,12,44588,21612,22976
Colorado,El Paso County,13,39128,18579,20549
Colorado,El Paso County,14,32065,15132,16933
Colorado,El Paso County,15,24414,11356,13058
Colorado,El Paso County,16,15118,6718,8400
Colorado,El Paso County,17,9916,4109,5807
Colorado,El Paso County,18,9550,3503,6047
Colorado,Fremont County,0,48021,27722,20299
Colorado,Fremont County,1,2048,1084,964
Colorado,Fremont County,2,2084,1031,1053
Colorado,Fremont County,3,2290,1157,1133
Colorado,Fremont County,4,2227,1180,1047
Colorado,Fremont County,5,2371,1577,794
Colorado,Fremont County,6,3486,2467,1019
Colorado,Fremont County,7,3456,2425,1031
Colorado,Fremont County,8,3385,2330,1055
Colorado,Fremont County,9,2930,1981,949
Colorado,Fremont County,10,3133,2021,1112
Colorado,Fremont County,11,3112,1842,1270
Colorado,Fremont County,12,3564,1790,1774
Colorado,Fremont County,13,3533,1766,1767
Colorado,Fremont County,14,3433,1743,1690
Colorado,Fremont County,15,2692,1312,1380
Colorado,Fremont County,16,1913,935,978
Colorado,Fremont County,17,1228,625,603
Colorado,Fremont County,18,1136,456,680
Colorado,Garfield County,0,59770,30533,29237
Colorado,Garfield County,1,4102,2035,2067
Colorado,Garfield County,2,4232,2177,2055
Colorado,Garfield County,3,4247,2162,2085
Colorado,Garfield County,4,3899,2031,1868
Colorado,Garfield County,5,3382,1801,1581
Colorado,Garfield County,6,4012,2103,1909
Colorado,Garfield County,7,4262,2219,2043
Colorado,Garfield County,8,4393,2302,2091
Colorado,Garfield County,9,3927,2031,1896
Colorado,Garfield County,10,3935,2052,1883
Colorado,Garfield County,11,3691,1872,1819
Colorado,Garfield County,12,4033,2021,2012
Colorado,Garfield County,13,3797,1902,1895
Colorado,Garfield County,14,3183,1648,1535
Colorado,Garfield County,15,1979,988,991
Colorado,Garfield County,16,1226,595,631
Colorado,Garfield County,17,722,320,402
Colorado,Garfield County,18,748,274,474
Colorado,Gilpin County,0,6121,3212,2909
Colorado,Gilpin County,1,229,110,119
Colorado,Gilpin County,2,218,96,122
Colorado,Gilpin County,3,321,159,162
Colorado,Gilpin County,4,276,137,139
Colorado,Gilpin County,5,209,114,95
Colorado,Gilpin County,6,286,147,139
Colorado,Gilpin County,7,360,209,151
Colorado,Gilpin County,8,369,175,194
Colorado,Gilpin County,9,510,274,236
Colorado,Gilpin County,10,495,265,230
Colorado,Gilpin County,11,533,303,230
Colorado,Gilpin County,12,654,351,303
Colorado,Gilpin County,13,626,323,303
Colorado,Gilpin County,14,506,268,238
Colorado,Gilpin County,15,277,148,129
Colorado,Gilpin County,16,143,78,65
Colorado,Gilpin County,17,64,32,32
Colorado,Gilpin County,18,45,23,22
Colorado,Grand County,0,15525,8319,7206
Colorado,Grand County,1,632,330,302
Colorado,Grand County,2,667,346,321
Colorado,Grand County,3,814,412,402
Colorado,Grand County,4,813,443,370
Colorado,Grand County,5,756,418,338
Colorado,Grand County,6,1110,610,500
Colorado,Grand County,7,1079,617,462
Colorado,Grand County,8,1043,583,460
Colorado,Grand County,9,926,492,434
Colorado,Grand County,10,1001,544,457
Colorado,Grand County,11,1047,520,527
Colorado,Grand County,12,1331,673,658
Colorado,Grand County,13,1574,813,761
Colorado,Grand County,14,1153,652,501
Colorado,Grand County,15,810,450,360
Colorado,Grand County,16,403,228,175
Colorado,Grand County,17,177,96,81
Colorado,Grand County,18,189,92,97
Colorado,Gunnison County,0,17246,9300,7946
Colorado,Gunnison County,1,742,381,361
Colorado,Gunnison County,2,802,439,363
Colorado,Gunnison County,3,846,436,410
Colorado,Gunnison County,4,1447,787,660
Colorado,Gunnison County,5,2215,1287,928
Colorado,Gunnison County,6,1334,754,580
Colorado,Gunnison County,7,1199,656,543
Colorado,Gunnison County,8,1196,633,563
Colorado,Gunnison County,9,1051,573,478
Colorado,Gunnison County,10,1110,609,501
Colorado,Gunnison County,11,938,469,469
Colorado,Gunnison County,12,1033,504,529
Colorado,Gunnison County,13,1097,587,510
Colorado,Gunnison County,14,899,499,400
Colorado,Gunnison County,15,637,341,296
Colorado,Gunnison County,16,352,184,168
Colorado,Gunnison County,17,178,95,83
Colorado,Gunnison County,18,170,66,104
Colorado,Hinsdale County,0,811,418,393
Colorado,Hinsdale County,1,32,16,16
Colorado,Hinsdale County,2,36,23,13
Colorado,Hinsdale County,3,34,18,16
Colorado,Hinsdale County,4,47,28,19
Colorado,Hinsdale County,5,39,18,21
Colorado,Hinsdale County,6,32,16,16
Colorado,Hinsdale County,7,42,24,18
Colorado,Hinsdale County,8,29,15,14
Colorado,Hinsdale County,9,45,25,20
Colorado,Hinsdale County,10,32,15,17
Colorado,Hinsdale County,11,54,23,31
Colorado,Hinsdale County,12,60,30,30
Colorado,Hinsdale County,13,83,41,42
Colorado,Hinsdale County,14,72,34,38
Colorado,Hinsdale County,15,88,48,40
Colorado,Hinsdale County,16,43,26,17
Colorado,Hinsdale County,17,21,9,12
Colorado,Hinsdale County,18,22,9,13
Colorado,Huerfano County,0,6889,3513,3376
Colorado,Huerfano County,1,255,124,131
Colorado,Huerfano County,2,307,177,130
Colorado,Huerfano County,3,334,192,142
Colorado,Huerfano County,4,339,184,155
Colorado,Huerfano County,5,238,124,114
Colorado,Huerfano County,6,301,153,148
Colorado,Huerfano County,7,304,167,137
Colorado,Huerfano County,8,308,159,149
Colorado,Huerfano County,9,289,152,137
Colorado,Huerfano County,10,360,186,174
Colorado,Huerfano County,11,390,214,176
Colorado,Huerfano County,12,602,274,328
Colorado,Huerfano County,13,714,288,426
Colorado,Huerfano County,14,687,366,321
Colorado,Huerfano County,15,569,310,259
Colorado,Huerfano County,16,398,210,188
Colorado,Huerfano County,17,241,121,120
Colorado,Huerfano County,18,253,112,141
Colorado,Jackson County,0,1399,724,675
Colorado,Jackson County,1,69,39,30
Colorado,Jackson County,2,62,31,31
Colorado,Jackson County,3,67,39,28
Colorado,Jackson County,4,61,24,37
Colorado,Jackson County,5,55,33,22
Colorado,Jackson County,6,85,47,38
Colorado,Jackson County,7,79,44,35
Colorado,Jackson County,8,76,39,37
Colorado,Jackson County,9,97,47,50
Colorado,Jackson County,10,81,45,36
Colorado,Jackson County,11,99,46,53
Colorado,Jackson County,12,117,57,60
Colorado,Jackson County,13,140,82,58
Colorado,Jackson County,14,111,57,54
Colorado,Jackson County,15,71,38,33
Colorado,Jackson County,16,61,25,36
Colorado,Jackson County,17,35,15,20
Colorado,Jackson County,18,33,16,17
Colorado,Jefferson County,0,580233,289294,290939
Colorado,Jefferson County,1,30223,15405,14818
Colorado,Jefferson County,2,30874,15839,15035
Colorado,Jefferson County,3,33041,16880,16161
Colorado,Jefferson County,4,33337,17513,15824
Colorado,Jefferson County,5,31870,16666,15204
Colorado,Jefferson County,6,42434,22177,20257
Colorado,Jefferson County,7,44059,23012,21047
Colorado,Jefferson County,8,42488,21756,20732
Colorado,Jefferson County,9,36781,18764,18017
Colorado,Jefferson County,10,38071,19200,18871
Colorado,Jefferson County,11,37966,18541,19425
Colorado,Jefferson County,12,43375,20794,22581
Colorado,Jefferson County,13,40237,19596,20641
Colorado,Jefferson County,14,33555,16035,17520
Colorado,Jefferson County,15,24862,11745,13117
Colorado,Jefferson County,16,16092,7116,8976
Colorado,Jefferson County,17,10249,4376,5873
Colorado,Jefferson County,18,10719,3879,6840
Colorado,Kiowa County,0,1383,673,710
Colorado,Kiowa County,1,109,60,49
Colorado,Kiowa County,2,78,39,39
Colorado,Kiowa County,3,72,36,36
Colorado,Kiowa County,4,75,35,40
Colorado,Kiowa County,5,86,47,39
Colorado,Kiowa County,6,71,28,43
Colorado,Kiowa County,7,64,37,27
Colorado,Kiowa County,8,68,37,31
Colorado,Kiowa County,9,70,34,36
Colorado,Kiowa County,10,64,29,35
Colorado,Kiowa County,11,66,29,37
Colorado,Kiowa County,12,131,60,71
Colorado,Kiowa County,13,105,56,49
Colorado,Kiowa County,14,100,55,45
Colorado,Kiowa County,15,65,27,38
Colorado,Kiowa County,16,55,25,30
Colorado,Kiowa County,17,48,17,31
Colorado,Kiowa County,18,56,22,34
Colorado,Kit Carson County,0,7163,3582,3581
Colorado,Kit Carson County,1,461,231,230
Colorado,Kit Carson County,2,521,262,259
Colorado,Kit Carson County,3,541,273,268
Colorado,Kit Carson County,4,452,220,232
Colorado,Kit Carson County,5,361,190,171
Colorado,Kit Carson County,6,420,218,202
Colorado,Kit Carson County,7,411,232,179
Colorado,Kit Carson County,8,449,222,227
Colorado,Kit Carson County,9,363,190,173
Colorado,Kit Carson County,10,362,172,190
Colorado,Kit Carson County,11,374,189,185
Colorado,Kit Carson County,12,541,258,283
Colorado,Kit Carson County,13,522,272,250
Colorado,Kit Carson County,14,378,193,185
Colorado,Kit Carson County,15,338,161,177
Colorado,Kit Carson County,16,263,131,132
Colorado,Kit Carson County,17,190,92,98
Colorado,Kit Carson County,18,216,76,140
Colorado,Lake County,0,7824,4207,3617
Colorado,Lake County,1,416,212,204
Colorado,Lake County,2,420,212,208
Colorado,Lake County,3,484,238,246
Colorado,Lake County,4,432,235,197
Colorado,Lake County,5,543,292,251
Colorado,Lake County,6,691,377,314
Colorado,Lake County,7,628,344,284
Colorado,Lake County,8,587,323,264
Colorado,Lake County,9,514,288,226
Colorado,Lake County,10,510,287,223
Colorado,Lake County,11,470,261,209
Colorado,Lake County,12,522,275,247
Colorado,Lake County,13,490,274,216
Colorado,Lake County,14,503,275,228
Colorado,Lake County,15,252,128,124
Colorado,Lake County,16,170,91,79
Colorado,Lake County,17,102,52,50
Colorado,Lake County,18,90,43,47
Colorado,La Plata County,0,56310,28411,27899
Colorado,La Plata County,1,2854,1494,1360
Colorado,La Plata County,2,2868,1488,1380
Colorado,La Plata County,3,3178,1657,1521
Colorado,La Plata County,4,3522,1846,1676
Colorado,La Plata County,5,3457,1746,1711
Colorado,La Plata County,6,3697,1936,1761
Colorado,La Plata County,7,3924,2014,1910
Colorado,La Plata County,8,4058,2081,1977
Colorado,La Plata County,9,3489,1805,1684
Colorado,La Plata County,10,3486,1793,1693
Colorado,La Plata County,11,3434,1608,1826
Colorado,La Plata County,12,4183,2039,2144
Colorado,La Plata County,13,4492,2150,2342
Colorado,La Plata County,14,3775,1877,1898
Colorado,La Plata County,15,2679,1380,1299
Colorado,La Plata County,16,1439,709,730
Colorado,La Plata County,17,926,454,472
Colorado,La Plata County,18,849,334,515
Colorado,Larimer County,0,350518,174991,175527
Colorado,Larimer County,1,17762,9041,8721
Colorado,Larimer County,2,19076,9767,9309
Colorado,Larimer County,3,20069,10280,9789
Colorado,Larimer County,4,24406,12056,12350
Colorado,Larimer County,5,36825,18973,17852
Colorado,Larimer County,6,28307,15011,13296
Colorado,Larimer County,7,23301,12235,11066
Colorado,Larimer County,8,23095,11780,11315
Colorado,Larimer County,9,20508,10507,10001
Colorado,Larimer County,10,19863,10197,9666
Colorado,Larimer County,11,18529,9039,9490
Colorado,Larimer County,12,21634,10313,11321
Colorado,Larimer County,13,22205,10541,11664
Colorado,Larimer County,14,19444,9287,10157
Colorado,Larimer County,15,14361,6977,7384
Colorado,Larimer County,16,9282,4306,4976
Colorado,Larimer County,17,5685,2476,3209
Colorado,Larimer County,18,6166,2205,3961
Colorado,Las Animas County,0,14503,7572,6931
Colorado,Las Animas County,1,682,350,332
Colorado,Las Animas County,2,725,371,354
Colorado,Las Animas County,3,828,429,399
Colorado,Las Animas County,4,874,453,421
Colorado,Las Animas County,5,828,495,333
Colorado,Las Animas County,6,869,517,352
Colorado,Las Animas County,7,749,414,335
Colorado,Las Animas County,8,833,484,349
Colorado,Las Animas County,9,696,365,331
Colorado,Las Animas County,10,796,408,388
Colorado,Las Animas County,11,824,445,379
Colorado,Las Animas County,12,1091,545,546
Colorado,Las Animas County,13,1179,588,591
Colorado,Las Animas County,14,1142,613,529
Colorado,Las Animas County,15,981,493,488
Colorado,Las Animas County,16,614,302,312
Colorado,Las Animas County,17,390,170,220
Colorado,Las Animas County,18,402,130,272
Colorado,Lincoln County,0,5610,3277,2333
Colorado,Lincoln County,1,303,156,147
Colorado,Lincoln County,2,305,179,126
Colorado,Lincoln County,3,328,162,166
Colorado,Lincoln County,4,274,143,131
Colorado,Lincoln County,5,376,245,131
Colorado,Lincoln County,6,454,312,142
Colorado,Lincoln County,7,438,301,137
Colorado,Lincoln County,8,376,253,123
Colorado,Lincoln County,9,335,211,124
Colorado,Lincoln County,10,339,222,117
Colorado,Lincoln County,11,375,215,160
Colorado,Lincoln County,12,383,220,163
Colorado,Lincoln County,13,339,192,147
Colorado,Lincoln County,14,265,131,134
Colorado,Lincoln County,15,244,117,127
Colorado,Lincoln County,16,192,98,94
Colorado,Lincoln County,17,120,56,64
Colorado,Lincoln County,18,164,64,100
Colorado,Logan County,0,21528,12030,9498
Colorado,Logan County,1,1143,595,548
Colorado,Logan County,2,1117,573,544
Colorado,Logan County,3,1049,550,499
Colorado,Logan County,4,1400,812,588
Colorado,Logan County,5,1558,942,616
Colorado,Logan County,6,1798,1208,590
Colorado,Logan County,7,1495,950,545
Colorado,Logan County,8,1488,938,550
Colorado,Logan County,9,1242,761,481
Colorado,Logan County,10,1293,769,524
Colorado,Logan County,11,1253,719,534
Colorado,Logan County,12,1447,768,679
Colorado,Logan County,13,1421,715,706
Colorado,Logan County,14,1177,593,584
Colorado,Logan County,15,887,429,458
Colorado,Logan County,16,669,315,354
Colorado,Logan County,17,466,199,267
Colorado,Logan County,18,625,194,431
Colorado,Mesa County,0,153207,75720,77487
Colorado,Mesa County,1,8659,4447,4212
Colorado,Mesa County,2,9230,4718,4512
Colorado,Mesa County,3,9656,4943,4713
Colorado,Mesa County,4,10139,5256,4883
Colorado,Mesa County,5,9415,4888,4527
Colorado,Mesa County,6,10091,5067,5024
Colorado,Mesa County,7,10019,5123,4896
Colorado,Mesa County,8,9993,5099,4894
Colorado,Mesa County,9,8579,4288,4291
Colorado,Mesa County,10,8323,4210,4113
Colorado,Mesa County,11,8477,4140,4337
Colorado,Mesa County,12,10571,4981,5590
Colorado,Mesa County,13,10817,5159,5658
Colorado,Mesa County,14,9629,4651,4978
Colorado,Mesa County,15,7414,3490,3924
Colorado,Mesa County,16,5084,2347,2737
Colorado,Mesa County,17,3427,1538,1889
Colorado,Mesa County,18,3684,1375,2309
Colorado,Mineral County,0,776,385,391
Colorado,Mineral County,1,33,14,19
Colorado,Mineral County,2,36,16,20
Colorado,Mineral County,3,18,10,8
Colorado,Mineral County,4,34,18,16
Colorado,Mineral County,5,21,11,10
Colorado,Mineral County,6,34,20,14
Colorado,Mineral County,7,52,28,24
Colorado,Mineral County,8,33,16,17
Colorado,Mineral County,9,37,20,17
Colorado,Mineral County,10,41,17,24
Colorado,Mineral County,11,43,15,28
Colorado,Mineral County,12,77,37,40
Colorado,Mineral County,13,75,37,38
Colorado,Mineral County,14,94,52,42
Colorado,Mineral County,15,67,35,32
Colorado,Mineral County,16,40,18,22
Colorado,Mineral County,17,19,10,9
Colorado,Mineral County,18,22,11,11
Colorado,Moffat County,0,13188,6763,6425
Colorado,Moffat County,1,939,440,499
Colorado,Moffat County,2,933,498,435
Colorado,Moffat County,3,987,544,443
Colorado,Moffat County,4,833,433,400
Colorado,Moffat County,5,707,368,339
Colorado,Moffat County,6,816,416,400
Colorado,Moffat County,7,874,450,424
Colorado,Moffat County,8,868,491,377
Colorado,Moffat County,9,771,389,382
Colorado,Moffat County,10,737,361,376
Colorado,Moffat County,11,810,429,381
Colorado,Moffat County,12,940,472,468
Colorado,Moffat County,13,953,499,454
Colorado,Moffat County,14,729,373,356
Colorado,Moffat County,15,520,269,251
Colorado,Moffat County,16,355,175,180
Colorado,Moffat County,17,185,76,109
Colorado,Moffat County,18,231,80,151
Colorado,Montezuma County,0,26158,12901,13257
Colorado,Montezuma County,1,1463,749,714
Colorado,Montezuma County,2,1675,864,811
Colorado,Montezuma County,3,1607,831,776
Colorado,Montezuma County,4,1540,796,744
Colorado,Montezuma County,5,1206,636,570
Colorado,Montezuma County,6,1466,712,754
Colorado,Montezuma County,7,1541,787,754
Colorado,Montezuma County,8,1449,730,719
Colorado,Montezuma County,9,1349,642,707
Colorado,Montezuma County,10,1450,716,734
Colorado,Montezuma County,11,1521,724,797
Colorado,Montezuma County,12,1938,928,1010
Colorado,Montezuma County,13,2168,999,1169
Colorado,Montezuma County,14,2038,984,1054
Colorado,Montezuma County,15,1514,768,746
Colorado,Montezuma County,16,976,480,496
Colorado,Montezuma County,17,610,300,310
Colorado,Montezuma County,18,647,255,392
Colorado,Montrose County,0,42214,20815,21399
Colorado,Montrose County,1,2368,1216,1152
Colorado,Montrose County,2,2563,1316,1247
Colorado,Montrose County,3,2603,1304,1299
Colorado,Montrose County,4,2441,1271,1170
Colorado,Montrose County,5,2048,1066,982
Colorado,Montrose County,6,2072,1080,992
Colorado,Montrose County,7,2304,1179,1125
Colorado,Montrose County,8,2474,1234,1240
Colorado,Montrose County,9,2197,1046,1151
Colorado,Montrose County,10,2372,1165,1207
Colorado,Montrose County,11,2546,1239,1307
Colorado,Montrose County,12,3056,1481,1575
Colorado,Montrose County,13,3334,1606,1728
Colorado,Montrose County,14,3050,1482,1568
Colorado,Montrose County,15,2569,1252,1317
Colorado,Montrose County,16,1796,864,932
Colorado,Montrose County,17,1175,560,615
Colorado,Montrose County,18,1246,454,792
Colorado,Morgan County,0,28558,14410,14148
Colorado,Morgan County,1,2113,1077,1036
Colorado,Morgan County,2,2150,1054,1096
Colorado,Morgan County,3,1989,1035,954
Colorado,Morgan County,4,1887,985,902
Colorado,Morgan County,5,1814,909,905
Colorado,Morgan County,6,1969,997,972
Colorado,Morgan County,7,2007,1102,905
Colorado,Morgan County,8,1789,936,853
Colorado,Morgan County,9,1564,786,778
Colorado,Morgan County,10,1629,851,778
Colorado,Morgan County,11,1644,841,803
Colorado,Morgan County,12,1815,924,891
Colorado,Morgan County,13,1766,915,851
Colorado,Morgan County,14,1334,652,682
Colorado,Morgan County,15,1036,499,537
Colorado,Morgan County,16,767,346,421
Colorado,Morgan County,17,577,261,316
Colorado,Morgan County,18,708,240,468
Colorado,Otero County,0,18432,9025,9407
Colorado,Otero County,1,1113,554,559
Colorado,Otero County,2,1202,588,614
Colorado,Otero County,3,1303,670,633
Colorado,Otero County,4,1378,730,648
Colorado,Otero County,5,1101,600,501
Colorado,Otero County,6,1064,541,523
Colorado,Otero County,7,1008,488,520
Colorado,Otero County,8,1078,522,556
Colorado,Otero County,9,1017,496,521
Colorado,Otero County,10,964,477,487
Colorado,Otero County,11,1013,482,531
Colorado,Otero County,12,1224,589,635
Colorado,Otero County,13,1201,590,611
Colorado,Otero County,14,1188,575,613
Colorado,Otero County,15,913,433,480
Colorado,Otero County,16,656,283,373
Colorado,Otero County,17,531,231,300
Colorado,Otero County,18,478,176,302
Colorado,Ouray County,0,4833,2446,2387
Colorado,Ouray County,1,142,83,59
Colorado,Ouray County,2,210,109,101
Colorado,Ouray County,3,226,106,120
Colorado,Ouray County,4,232,117,115
Colorado,Ouray County,5,161,86,75
Colorado,Ouray County,6,178,102,76
Colorado,Ouray County,7,214,99,115
Colorado,Ouray County,8,251,122,129
Colorado,Ouray County,9,292,159,133
Colorado,Ouray County,10,299,157,142
Colorado,Ouray County,11,310,136,174
Colorado,Ouray County,12,441,216,225
Colorado,Ouray County,13,563,268,295
Colorado,Ouray County,14,524,278,246
Colorado,Ouray County,15,368,186,182
Colorado,Ouray County,16,242,128,114
Colorado,Ouray County,17,92,53,39
Colorado,Ouray County,18,88,41,47
Colorado,Park County,0,18556,9768,8788
Colorado,Park County,1,667,351,316
Colorado,Park County,2,752,419,333
Colorado,Park County,3,869,430,439
Colorado,Park County,4,801,419,382
Colorado,Park County,5,638,360,278
Colorado,Park County,6,851,458,393
Colorado,Park County,7,886,473,413
Colorado,Park County,8,1161,615,546
Colorado,Park County,9,1072,578,494
Colorado,Park County,10,1271,671,600
Colorado,Park County,11,1508,781,727
Colorado,Park County,12,2113,1122,991
Colorado,Park County,13,2174,1091,1083
Colorado,Park County,14,1740,901,839
Colorado,Park County,15,1111,616,495
Colorado,Park County,16,549,297,252
Colorado,Park County,17,221,121,100
Colorado,Park County,18,172,65,107
Colorado,Phillips County,0,4286,2115,2171
Colorado,Phillips County,1,288,165,123
Colorado,Phillips County,2,272,121,151
Colorado,Phillips County,3,331,191,140
Colorado,Phillips County,4,247,129,118
Colorado,Phillips County,5,216,108,108
Colorado,Phillips County,6,230,120,110
Colorado,Phillips County,7,202,103,99
Colorado,Phillips County,8,271,121,150
Colorado,Phillips County,9,204,102,102
Colorado,Phillips County,10,206,95,111
Colorado,Phillips County,11,248,143,105
Colorado,Phillips County,12,282,135,147
Colorado,Phillips County,13,323,163,160
Colorado,Phillips County,14,244,119,125
Colorado,Phillips County,15,194,102,92
Colorado,Phillips County,16,157,64,93
Colorado,Phillips County,17,165,62,103
Colorado,Phillips County,18,206,72,134
Colorado,Pitkin County,0,17950,9289,8661
Colorado,Pitkin County,1,700,335,365
Colorado,Pitkin County,2,697,364,333
Colorado,Pitkin County,3,793,399,394
Colorado,Pitkin County,4,801,407,394
Colorado,Pitkin County,5,861,434,427
Colorado,Pitkin County,6,1333,738,595
Colorado,Pitkin County,7,1366,720,646
Colorado,Pitkin County,8,1222,643,579
Colorado,Pitkin County,9,1132,543,589
Colorado,Pitkin County,10,1399,742,657
Colorado,Pitkin County,11,1357,704,653
Colorado,Pitkin County,12,1356,641,715
Colorado,Pitkin County,13,1451,770,681
Colorado,Pitkin County,14,1305,698,607
Colorado,Pitkin County,15,1017,527,490
Colorado,Pitkin County,16,614,338,276
Colorado,Pitkin County,17,289,159,130
Colorado,Pitkin County,18,257,127,130
Colorado,Prowers County,0,12164,6113,6051
Colorado,Prowers County,1,869,451,418
Colorado,Prowers County,2,878,467,411
Colorado,Prowers County,3,868,443,425
Colorado,Prowers County,4,969,511,458
Colorado,Prowers County,5,797,434,363
Colorado,Prowers County,6,676,362,314
Colorado,Prowers County,7,669,342,327
Colorado,Prowers County,8,733,360,373
Colorado,Prowers County,9,660,321,339
Colorado,Prowers County,10,632,328,304
Colorado,Prowers County,11,630,312,318
Colorado,Prowers County,12,834,411,423
Colorado,Prowers County,13,806,407,399
Colorado,Prowers County,14,700,334,366
Colorado,Prowers County,15,532,274,258
Colorado,Prowers County,16,375,156,219
Colorado,Prowers County,17,246,92,154
Colorado,Prowers County,18,290,108,182
Colorado,Pueblo County,0,167529,82556,84973
Colorado,Pueblo County,1,9748,5018,4730
Colorado,Pueblo County,2,10250,5269,4981
Colorado,Pueblo County,3,10948,5640,5308
Colorado,Pueblo County,4,11262,5810,5452
Colorado,Pueblo County,5,10265,5324,4941
Colorado,Pueblo County,6,11279,5778,5501
Colorado,Pueblo County,7,10750,5416,5334
Colorado,Pueblo County,8,10401,5201,5200
Colorado,Pueblo County,9,9345,4660,4685
Colorado,Pueblo County,10,9931,4880,5051
Colorado,Pueblo County,11,9818,4836,4982
Colorado,Pueblo County,12,11210,5349,5861
Colorado,Pueblo County,13,11334,5379,5955
Colorado,Pueblo County,14,10155,4847,5308
Colorado,Pueblo County,15,7869,3730,4139
Colorado,Pueblo County,16,5275,2336,2939
Colorado,Pueblo County,17,3661,1603,2058
Colorado,Pueblo County,18,4028,1480,2548
Colorado,Rio Blanco County,0,6336,3237,3099
Colorado,Rio Blanco County,1,373,206,167
Colorado,Rio Blanco County,2,431,224,207
Colorado,Rio Blanco County,3,477,240,237
Colorado,Rio Blanco County,4,449,222,227
Colorado,Rio Blanco County,5,377,193,184
Colorado,Rio Blanco County,6,359,184,175
Colorado,Rio Blanco County,7,441,215,226
Colorado,Rio Blanco County,8,435,231,204
Colorado,Rio Blanco County,9,323,171,152
Colorado,Rio Blanco County,10,353,183,170
Colorado,Rio Blanco County,11,366,193,173
Colorado,Rio Blanco County,12,481,232,249
Colorado,Rio Blanco County,13,486,256,230
Colorado,Rio Blanco County,14,319,171,148
Colorado,Rio Blanco County,15,233,113,120
Colorado,Rio Blanco County,16,187,98,89
Colorado,Rio Blanco County,17,120,55,65
Colorado,Rio Blanco County,18,126,50,76
Colorado,Rio Grande County,0,11250,5624,5626
Colorado,Rio Grande County,1,659,330,329
Colorado,Rio Grande County,2,703,346,357
Colorado,Rio Grande County,3,737,371,366
Colorado,Rio Grande County,4,729,390,339
Colorado,Rio Grande County,5,606,326,280
Colorado,Rio Grande County,6,696,340,356
Colorado,Rio Grande County,7,685,357,328
Colorado,Rio Grande County,8,695,362,333
Colorado,Rio Grande County,9,618,318,300
Colorado,Rio Grande County,10,571,261,310
Colorado,Rio Grande County,11,653,318,335
Colorado,Rio Grande County,12,769,379,390
Colorado,Rio Grande County,13,853,427,426
Colorado,Rio Grande County,14,761,389,372
Colorado,Rio Grande County,15,568,265,303
Colorado,Rio Grande County,16,430,225,205
Colorado,Rio Grande County,17,229,104,125
Colorado,Rio Grande County,18,288,116,172
Colorado,Routt County,0,25733,13399,12334
Colorado,Routt County,1,1166,569,597
Colorado,Routt County,2,1235,611,624
Colorado,Routt County,3,1386,721,665
Colorado,Routt County,4,1419,750,669
Colorado,Routt County,5,1461,766,695
Colorado,Routt County,6,1954,1082,872
Colorado,Routt County,7,1893,1031,862
Colorado,Routt County,8,1928,992,936
Colorado,Routt County,9,1778,973,805
Colorado,Routt County,10,1885,979,906
Colorado,Routt County,11,1670,875,795
Colorado,Routt County,12,1952,942,1010
Colorado,Routt County,13,2032,1018,1014
Colorado,Routt County,14,1648,894,754
Colorado,Routt County,15,1128,599,529
Colorado,Routt County,16,596,324,272
Colorado,Routt County,17,315,162,153
Colorado,Routt County,18,287,111,176
Colorado,Saguache County,0,6843,3426,3417
Colorado,Saguache County,1,398,180,218
Colorado,Saguache County,2,358,181,177
Colorado,Saguache County,3,457,260,197
Colorado,Saguache County,4,404,192,212
Colorado,Saguache County,5,269,142,127
Colorado,Saguache County,6,286,148,138
Colorado,Saguache County,7,297,146,151
Colorado,Saguache County,8,372,186,186
Colorado,Saguache County,9,391,193,198
Colorado,Saguache County,10,328,174,154
Colorado,Saguache County,11,461,210,251
Colorado,Saguache County,12,558,237,321
Colorado,Saguache County,13,692,362,330
Colorado,Saguache County,14,651,336,315
Colorado,Saguache County,15,461,250,211
Colorado,Saguache County,16,245,126,119
Colorado,Saguache County,17,115,56,59
Colorado,Saguache County,18,100,47,53
Colorado,San Juan County,0,762,427,335
Colorado,San Juan County,1,28,11,17
Colorado,San Juan County,2,25,15,10
Colorado,San Juan County,3,31,16,15
Colorado,San Juan County,4,21,15,6
Colorado,San Juan County,5,27,19,8
Colorado,San Juan County,6,54,27,27
Colorado,San Juan County,7,44,23,21
Colorado,San Juan County,8,53,29,24
Colorado,San Juan County,9,57,26,31
Colorado,San Juan County,10,49,29,20
Colorado,San Juan County,11,51,38,13
Colorado,San Juan County,12,62,41,21
Colorado,San Juan County,13,82,46,36
Colorado,San Juan County,14,57,28,29
Colorado,San Juan County,15,61,31,30
Colorado,San Juan County,16,30,18,12
Colorado,San Juan County,17,18,10,8
Colorado,San Juan County,18,12,5,7
Colorado,San Miguel County,0,8191,4359,3832
Colorado,San Miguel County,1,326,169,157
Colorado,San Miguel County,2,391,198,193
Colorado,San Miguel County,3,469,254,215
Colorado,San Miguel County,4,368,192,176
Colorado,San Miguel County,5,380,187,193
Colorado,San Miguel County,6,636,358,278
Colorado,San Miguel County,7,662,373,289
Colorado,San Miguel County,8,586,293,293
Colorado,San Miguel County,9,616,295,321
Colorado,San Miguel County,10,681,362,319
Colorado,San Miguel County,11,639,339,300
Colorado,San Miguel County,12,607,335,272
Colorado,San Miguel County,13,629,345,284
Colorado,San Miguel County,14,558,295,263
Colorado,San Miguel County,15,358,208,150
Colorado,San Miguel County,16,159,91,68
Colorado,San Miguel County,17,65,35,30
Colorado,San Miguel County,18,61,30,31
Colorado,Sedgwick County,0,2303,1137,1166
Colorado,Sedgwick County,1,120,60,60
Colorado,Sedgwick County,2,130,64,66
Colorado,Sedgwick County,3,132,61,71
Colorado,Sedgwick County,4,123,64,59
Colorado,Sedgwick County,5,101,54,47
Colorado,Sedgwick County,6,112,60,52
Colorado,Sedgwick County,7,129,60,69
Colorado,Sedgwick County,8,127,62,65
Colorado,Sedgwick County,9,118,50,68
Colorado,Sedgwick County,10,112,63,49
Colorado,Sedgwick County,11,107,57,50
Colorado,Sedgwick County,12,169,81,88
Colorado,Sedgwick County,13,219,118,101
Colorado,Sedgwick County,14,167,86,81
Colorado,Sedgwick County,15,138,70,68
Colorado,Sedgwick County,16,108,48,60
Colorado,Sedgwick County,17,85,42,43
Colorado,Sedgwick County,18,106,37,69
Colorado,Summit County,0,31007,16816,14191
Colorado,Summit County,1,1404,772,632
Colorado,Summit County,2,1363,688,675
Colorado,Summit County,3,1449,750,699
Colorado,Summit County,4,1234,655,579
Colorado,Summit County,5,1722,896,826
Colorado,Summit County,6,3378,1956,1422
Colorado,Summit County,7,2919,1638,1281
Colorado,Summit County,8,2456,1344,1112
Colorado,Summit County,9,2206,1237,969
Colorado,Summit County,10,2326,1320,1006
Colorado,Summit County,11,2050,1058,992
Colorado,Summit County,12,2108,1131,977
Colorado,Summit County,13,2157,1149,1008
Colorado,Summit County,14,1833,930,903
Colorado,Summit County,15,1245,667,578
Colorado,Summit County,16,714,388,326
Colorado,Summit County,17,262,145,117
Colorado,Summit County,18,181,92,89
Colorado,Teller County,0,25083,12734,12349
Colorado,Teller County,1,994,492,502
Colorado,Teller County,2,1132,586,546
Colorado,Teller County,3,1358,708,650
Colorado,Teller County,4,1216,647,569
Colorado,Teller County,5,1090,575,515
Colorado,Teller County,6,1155,623,532
Colorado,Teller County,7,1222,637,585
Colorado,Teller County,8,1308,646,662
Colorado,Teller County,9,1239,611,628
Colorado,Teller County,10,1638,823,815
Colorado,Teller County,11,1894,962,932
Colorado,Teller County,12,2609,1245,1364
Colorado,Teller County,13,2723,1343,1380
Colorado,Teller County,14,2373,1213,1160
Colorado,Teller County,15,1589,862,727
Colorado,Teller County,16,854,446,408
Colorado,Teller County,17,402,196,206
Colorado,Teller County,18,287,119,168
Colorado,Washington County,0,4909,2552,2357
Colorado,Washington County,1,291,157,134
Colorado,Washington County,2,315,168,147
Colorado,Washington County,3,318,164,154
Colorado,Washington County,4,290,157,133
Colorado,Washington County,5,262,141,121
Colorado,Washington County,6,289,159,130
Colorado,Washington County,7,293,162,131
Colorado,Washington County,8,293,151,142
Colorado,Washington County,9,258,151,107
Colorado,Washington County,10,262,141,121
Colorado,Washington County,11,297,162,135
Colorado,Washington County,12,347,171,176
Colorado,Washington County,13,378,182,196
Colorado,Washington County,14,331,172,159
Colorado,Washington County,15,201,105,96
Colorado,Washington County,16,194,99,95
Colorado,Washington County,17,129,57,72
Colorado,Washington County,18,161,53,108
Colorado,Weld County,0,314305,158475,155830
Colorado,Weld County,1,22837,11593,11244
Colorado,Weld County,2,22960,11796,11164
Colorado,Weld County,3,23564,12142,11422
Colorado,Weld County,4,22401,11151,11250
Colorado,Weld County,5,19205,9787,9418
Colorado,Weld County,6,23806,12096,11710
Colorado,Weld County,7,24225,12479,11746
Colorado,Weld County,8,22874,11918,10956
Colorado,Weld County,9,20110,10501,9609
Colorado,Weld County,10,19925,10158,9767
Colorado,Weld County,11,18039,9122,8917
Colorado,Weld County,12,18942,9424,9518
Colorado,Weld County,13,17193,8442,8751
Colorado,Weld County,14,13957,6731,7226
Colorado,Weld County,15,10103,4941,5162
Colorado,Weld County,16,6299,2918,3381
Colorado,Weld County,17,4031,1790,2241
Colorado,Weld County,18,3834,1486,2348
Colorado,Yuma County,0,10020,4989,5031
Colorado,Yuma County,1,745,374,371
Colorado,Yuma County,2,788,406,382
Colorado,Yuma County,3,752,357,395
Colorado,Yuma County,4,629,335,294
Colorado,Yuma County,5,527,267,260
Colorado,Yuma County,6,595,303,292
Colorado,Yuma County,7,622,317,305
Colorado,Yuma County,8,606,297,309
Colorado,Yuma County,9,519,261,258
Colorado,Yuma County,10,586,318,268
Colorado,Yuma County,11,568,302,266
Colorado,Yuma County,12,611,310,301
Colorado,Yuma County,13,621,325,296
Colorado,Yuma County,14,533,245,288
Colorado,Yuma County,15,477,214,263
Colorado,Yuma County,16,338,163,175
Colorado,Yuma County,17,226,102,124
Colorado,Yuma County,18,277,93,184
Connecticut,Fairfield County,0,943823,459748,484075
Connecticut,Fairfield County,1,51672,26405,25267
Connecticut,Fairfield County,2,56713,28741,27972
Connecticut,Fairfield County,3,64049,32573,31476
Connecticut,Fairfield County,4,65906,33577,32329
Connecticut,Fairfield County,5,59743,30515,29228
Connecticut,Fairfield County,6,52874,27196,25678
Connecticut,Fairfield County,7,55047,27430,27617
Connecticut,Fairfield County,8,58183,28323,29860
Connecticut,Fairfield County,9,58887,28953,29934
Connecticut,Fairfield County,10,66466,32365,34101
Connecticut,Fairfield County,11,72070,34736,37334
Connecticut,Fairfield County,12,71103,34235,36868
Connecticut,Fairfield County,13,61192,29730,31462
Connecticut,Fairfield County,14,45485,21315,24170
Connecticut,Fairfield County,15,36410,16632,19778
Connecticut,Fairfield County,16,26273,11455,14818
Connecticut,Fairfield County,17,18084,7490,10594
Connecticut,Fairfield County,18,23666,8077,15589
Connecticut,Hartford County,0,892697,434117,458580
Connecticut,Hartford County,1,47866,24552,23314
Connecticut,Hartford County,2,50488,25495,24993
Connecticut,Hartford County,3,54513,27691,26822
Connecticut,Hartford County,4,57686,29752,27934
Connecticut,Hartford County,5,57352,29539,27813
Connecticut,Hartford County,6,59143,30678,28465
Connecticut,Hartford County,7,59330,29934,29396
Connecticut,Hartford County,8,57715,28622,29093
Connecticut,Hartford County,9,52224,25447,26777
Connecticut,Hartford County,10,57317,27660,29657
Connecticut,Hartford County,11,62607,30327,32280
Connecticut,Hartford County,12,64910,31201,33709
Connecticut,Hartford County,13,58672,27906,30766
Connecticut,Hartford County,14,46515,21577,24938
Connecticut,Hartford County,15,37764,16978,20786
Connecticut,Hartford County,16,26407,11384,15023
Connecticut,Hartford County,17,18420,7443,10977
Connecticut,Hartford County,18,23768,7931,15837
Connecticut,Litchfield County,0,181111,89551,91560
Connecticut,Litchfield County,1,7493,3808,3685
Connecticut,Litchfield County,2,8500,4430,4070
Connecticut,Litchfield County,3,10126,5147,4979
Connecticut,Litchfield County,4,10627,5571,5056
Connecticut,Litchfield County,5,9725,5029,4696
Connecticut,Litchfield County,6,9495,5019,4476
Connecticut,Litchfield County,7,9398,4816,4582
Connecticut,Litchfield County,8,9626,4839,4787
Connecticut,Litchfield County,9,9299,4564,4735
Connecticut,Litchfield County,10,12158,5900,6258
Connecticut,Litchfield County,11,14709,7221,7488
Connecticut,Litchfield County,12,15970,7855,8115
Connecticut,Litchfield County,13,15483,7667,7816
Connecticut,Litchfield County,14,12389,6109,6280
Connecticut,Litchfield County,15,10004,4735,5269
Connecticut,Litchfield County,16,6827,3207,3620
Connecticut,Litchfield County,17,4282,1844,2438
Connecticut,Litchfield County,18,5000,1790,3210
Connecticut,Middlesex County,0,162682,79242,83440
Connecticut,Middlesex County,1,6729,3425,3304
Connecticut,Middlesex County,2,7379,3750,3629
Connecticut,Middlesex County,3,8715,4481,4234
Connecticut,Middlesex County,4,10204,5239,4965
Connecticut,Middlesex County,5,10049,5202,4847
Connecticut,Middlesex County,6,9166,4744,4422
Connecticut,Middlesex County,7,9490,4750,4740
Connecticut,Middlesex County,8,9066,4396,4670
Connecticut,Middlesex County,9,8575,4202,4373
Connecticut,Middlesex County,10,10963,5298,5665
Connecticut,Middlesex County,11,12806,6221,6585
Connecticut,Middlesex County,12,13849,6707,7142
Connecticut,Middlesex County,13,12624,6184,6440
Connecticut,Middlesex County,14,10384,4889,5495
Connecticut,Middlesex County,15,8386,3935,4451
Connecticut,Middlesex County,16,5757,2572,3185
Connecticut,Middlesex County,17,3651,1551,2100
Connecticut,Middlesex County,18,4889,1696,3193
Connecticut,New Haven County,0,857620,413494,444126
Connecticut,New Haven County,1,44160,22607,21553
Connecticut,New Haven County,2,46082,23676,22406
Connecticut,New Haven County,3,50768,25855,24913
Connecticut,New Haven County,4,58409,29410,28999
Connecticut,New Haven County,5,59257,29677,29580
Connecticut,New Haven County,6,58453,29693,28760
Connecticut,New Haven County,7,56564,27922,28642
Connecticut,New Haven County,8,52347,25486,26861
Connecticut,New Haven County,9,48260,23055,25205
Connecticut,New Haven County,10,54875,26279,28596
Connecticut,New Haven County,11,59909,28907,31002
Connecticut,New Haven County,12,62657,30100,32557
Connecticut,New Haven County,13,56993,27091,29902
Connecticut,New Haven County,14,46011,21318,24693
Connecticut,New Haven County,15,37144,16761,20383
Connecticut,New Haven County,16,25740,11200,14540
Connecticut,New Haven County,17,17388,7029,10359
Connecticut,New Haven County,18,22603,7428,15175
Connecticut,New London County,0,266784,133702,133082
Connecticut,New London County,1,13233,6825,6408
Connecticut,New London County,2,13846,7111,6735
Connecticut,New London County,3,15056,7633,7423
Connecticut,New London County,4,16686,8741,7945
Connecticut,New London County,5,19639,11312,8327
Connecticut,New London County,6,18062,10002,8060
Connecticut,New London County,7,16932,8818,8114
Connecticut,New London County,8,15492,7710,7782
Connecticut,New London County,9,14179,7009,7170
Connecticut,New London County,10,16376,7878,8498
Connecticut,New London County,11,19059,9259,9800
Connecticut,New London County,12,20608,10091,10517
Connecticut,New London County,13,19005,9330,9675
Connecticut,New London County,14,15379,7485,7894
Connecticut,New London County,15,12450,5895,6555
Connecticut,New London County,16,8653,4021,4632
Connecticut,New London County,17,5614,2276,3338
Connecticut,New London County,18,6515,2306,4209
Connecticut,Tolland County,0,150921,75598,75323
Connecticut,Tolland County,1,6245,3157,3088
Connecticut,Tolland County,2,6738,3538,3200
Connecticut,Tolland County,3,7871,3975,3896
Connecticut,Tolland County,4,14271,7090,7181
Connecticut,Tolland County,5,19651,9870,9781
Connecticut,Tolland County,6,8281,4549,3732
Connecticut,Tolland County,7,8164,4370,3794
Connecticut,Tolland County,8,8126,4201,3925
Connecticut,Tolland County,9,7308,3789,3519
Connecticut,Tolland County,10,9106,4503,4603
Connecticut,Tolland County,11,10324,5018,5306
Connecticut,Tolland County,12,11024,5521,5503
Connecticut,Tolland County,13,9967,4933,5034
Connecticut,Tolland County,14,7666,3717,3949
Connecticut,Tolland County,15,6097,2950,3147
Connecticut,Tolland County,16,4450,2125,2325
Connecticut,Tolland County,17,2663,1180,1483
Connecticut,Tolland County,18,2969,1112,1857
Connecticut,Windham County,0,117027,57943,59084
Connecticut,Windham County,1,5736,2908,2828
Connecticut,Windham County,2,6265,3202,3063
Connecticut,Windham County,3,6799,3442,3357
Connecticut,Windham County,4,8115,4147,3968
Connecticut,Windham County,5,7700,4024,3676
Connecticut,Windham County,6,7449,3879,3570
Connecticut,Windham County,7,7542,3817,3725
Connecticut,Windham County,8,7321,3658,3663
Connecticut,Windham County,9,6728,3351,3377
Connecticut,Windham County,10,7715,3859,3856
Connecticut,Windham County,11,8491,4166,4325
Connecticut,Windham County,12,9346,4600,4746
Connecticut,Windham County,13,8402,4145,4257
Connecticut,Windham County,14,6491,3132,3359
Connecticut,Windham County,15,4995,2386,2609
Connecticut,Windham County,16,3279,1493,1786
Connecticut,Windham County,17,2192,911,1281
Connecticut,Windham County,18,2461,823,1638
Delaware,Kent County,0,178550,86023,92527
Delaware,Kent County,1,11170,5572,5598
Delaware,Kent County,2,11264,5713,5551
Delaware,Kent County,3,11516,5821,5695
Delaware,Kent County,4,12105,6053,6052
Delaware,Kent County,5,12492,6378,6114
Delaware,Kent County,6,12835,6585,6250
Delaware,Kent County,7,11499,5600,5899
Delaware,Kent County,8,10898,5284,5614
Delaware,Kent County,9,9841,4567,5274
Delaware,Kent County,10,10345,4903,5442
Delaware,Kent County,11,11305,5371,5934
Delaware,Kent County,12,11933,5659,6274
Delaware,Kent County,13,10864,4952,5912
Delaware,Kent County,14,9479,4318,5161
Delaware,Kent County,15,8345,3800,4545
Delaware,Kent County,16,5877,2655,3222
Delaware,Kent County,17,3631,1574,2057
Delaware,Kent County,18,3151,1218,1933
Delaware,New Castle County,0,559335,271123,288212
Delaware,New Castle County,1,32142,16381,15761
Delaware,New Castle County,2,33133,16707,16426
Delaware,New Castle County,3,33905,17047,16858
Delaware,New Castle County,4,37412,18913,18499
Delaware,New Castle County,5,35542,17929,17613
Delaware,New Castle County,6,42067,21063,21004
Delaware,New Castle County,7,39244,19794,19450
Delaware,New Castle County,8,36710,18193,18517
Delaware,New Castle County,9,32417,15862,16555
Delaware,New Castle County,10,35910,17377,18533
Delaware,New Castle County,11,38448,18293,20155
Delaware,New Castle County,12,39526,18823,20703
Delaware,New Castle County,13,35851,17008,18843
Delaware,New Castle County,14,28539,13003,15536
Delaware,New Castle County,15,22280,10014,12266
Delaware,New Castle County,16,15297,6600,8697
Delaware,New Castle County,17,9978,4184,5794
Delaware,New Castle County,18,10934,3932,7002
Delaware,Sussex County,0,229286,110781,118505
Delaware,Sussex County,1,11499,5705,5794
Delaware,Sussex County,2,11850,6068,5782
Delaware,Sussex County,3,12233,6182,6051
Delaware,Sussex County,4,10846,5614,5232
Delaware,Sussex County,5,10315,5385,4930
Delaware,Sussex County,6,12078,6122,5956
Delaware,Sussex County,7,11340,5585,5755
Delaware,Sussex County,8,11242,5579,5663
Delaware,Sussex County,9,10360,4988,5372
Delaware,Sussex County,10,12177,5933,6244
Delaware,Sussex County,11,14306,6864,7442
Delaware,Sussex County,12,17334,8051,9283
Delaware,Sussex County,13,20131,9108,11023
Delaware,Sussex County,14,21496,10029,11467
Delaware,Sussex County,15,18055,8666,9389
Delaware,Sussex County,16,11631,5613,6018
Delaware,Sussex County,17,6641,3120,3521
Delaware,Sussex County,18,5752,2169,3583
District of Columbia,District of Columbia,0,702455,333307,369148
District of Columbia,District of Columbia,1,45617,23103,22514
District of Columbia,District of Columbia,2,37622,19126,18496
District of Columbia,District of Columbia,3,28573,14294,14279
District of Columbia,District of Columbia,4,36900,17535,19365
District of Columbia,District of Columbia,5,52924,23793,29131
District of Columbia,District of Columbia,6,83096,38651,44445
District of Columbia,District of Columbia,7,80991,38517,42474
District of Columbia,District of Columbia,8,62212,30585,31627
District of Columbia,District of Columbia,9,43462,21565,21897
District of Columbia,District of Columbia,10,38787,19559,19228
District of Columbia,District of Columbia,11,36666,18277,18389
District of Columbia,District of Columbia,12,36676,17999,18677
District of Columbia,District of Columbia,13,33626,15465,18161
District of Columbia,District of Columbia,14,27984,12184,15800
District of Columbia,District of Columbia,15,21120,9000,12120
District of Columbia,District of Columbia,16,14419,5904,8515
District of Columbia,District of Columbia,17,9627,3744,5883
District of Columbia,District of Columbia,18,12153,4006,8147
Florida,Alachua County,0,269956,130428,139528
Florida,Alachua County,1,14113,7120,6993
Florida,Alachua County,2,13902,7036,6866
Florida,Alachua County,3,13045,6686,6359
Florida,Alachua County,4,21562,10135,11427
Florida,Alachua County,5,42197,20774,21423
Florida,Alachua County,6,24072,12066,12006
Florida,Alachua County,7,18174,9070,9104
Florida,Alachua County,8,16084,8048,8036
Florida,Alachua County,9,13386,6529,6857
Florida,Alachua County,10,13232,6526,6706
Florida,Alachua County,11,13099,6280,6819
Florida,Alachua County,12,14630,6830,7800
Florida,Alachua County,13,14624,6660,7964
Florida,Alachua County,14,12921,5885,7036
Florida,Alachua County,15,9826,4518,5308
Florida,Alachua County,16,6451,2934,3517
Florida,Alachua County,17,4039,1672,2367
Florida,Alachua County,18,4599,1659,2940
Florida,Baker County,0,28355,14917,13438
Florida,Baker County,1,1778,887,891
Florida,Baker County,2,1845,955,890
Florida,Baker County,3,1931,991,940
Florida,Baker County,4,1831,939,892
Florida,Baker County,5,1655,985,670
Florida,Baker County,6,2247,1306,941
Florida,Baker County,7,2020,1130,890
Florida,Baker County,8,1892,1036,856
Florida,Baker County,9,1770,955,815
Florida,Baker County,10,1971,1101,870
Florida,Baker County,11,1877,1027,850
Florida,Baker County,12,1880,970,910
Florida,Baker County,13,1643,794,849
Florida,Baker County,14,1379,686,693
Florida,Baker County,15,1040,482,558
Florida,Baker County,16,738,329,409
Florida,Baker County,17,486,203,283
Florida,Baker County,18,372,141,231
Florida,Bay County,0,185287,91929,93358
Florida,Bay County,1,11333,5862,5471
Florida,Bay County,2,11233,5684,5549
Florida,Bay County,3,10920,5488,5432
Florida,Bay County,4,9920,5121,4799
Florida,Bay County,5,10927,5951,4976
Florida,Bay County,6,13877,7017,6860
Florida,Bay County,7,12840,6618,6222
Florida,Bay County,8,11878,6101,5777
Florida,Bay County,9,10503,5244,5259
Florida,Bay County,10,11498,5669,5829
Florida,Bay County,11,12294,6014,6280
Florida,Bay County,12,13879,6762,7117
Florida,Bay County,13,12507,5899,6608
Florida,Bay County,14,10189,4793,5396
Florida,Bay County,15,8218,3895,4323
Florida,Bay County,16,5683,2607,3076
Florida,Bay County,17,3785,1632,2153
Florida,Bay County,18,3803,1572,2231
Florida,Bradford County,0,27732,15318,12414
Florida,Bradford County,1,1494,779,715
Florida,Bradford County,2,1536,804,732
Florida,Bradford County,3,1512,756,756
Florida,Bradford County,4,1399,712,687
Florida,Bradford County,5,1676,1082,594
Florida,Bradford County,6,2294,1485,809
Florida,Bradford County,7,1960,1243,717
Florida,Bradford County,8,1978,1238,740
Florida,Bradford County,9,1674,1050,624
Florida,Bradford County,10,1817,1095,722
Florida,Bradford County,11,1772,1029,743
Florida,Bradford County,12,1888,998,890
Florida,Bradford County,13,1797,871,926
Florida,Bradford County,14,1484,718,766
Florida,Bradford County,15,1258,568,690
Florida,Bradford County,16,994,430,564
Florida,Bradford County,17,588,254,334
Florida,Bradford County,18,611,206,405
Florida,Brevard County,0,596849,291903,304946
Florida,Brevard County,1,27825,14305,13520
Florida,Brevard County,2,29480,15251,14229
Florida,Brevard County,3,31999,16252,15747
Florida,Brevard County,4,31780,16770,15010
Florida,Brevard County,5,30980,16551,14429
Florida,Brevard County,6,35253,18363,16890
Florida,Brevard County,7,32892,16495,16397
Florida,Brevard County,8,32127,15771,16356
Florida,Brevard County,9,29794,14472,15322
Florida,Brevard County,10,34825,16664,18161
Florida,Brevard County,11,40729,19599,21130
Florida,Brevard County,12,50094,23988,26106
Florida,Brevard County,13,47726,22682,25044
Florida,Brevard County,14,40994,19652,21342
Florida,Brevard County,15,35234,16578,18656
Florida,Brevard County,16,27375,12600,14775
Florida,Brevard County,17,19135,8446,10689
Florida,Brevard County,18,18607,7464,11143
Florida,Broward County,0,1951260,950568,1000692
Florida,Broward County,1,113117,57889,55228
Florida,Broward County,2,112738,57220,55518
Florida,Broward County,3,116835,58899,57936
Florida,Broward County,4,111640,56733,54907
Florida,Broward County,5,111833,57024,54809
Florida,Broward County,6,132021,66390,65631
Florida,Broward County,7,131927,65464,66463
Florida,Broward County,8,133163,65092,68071
Florida,Broward County,9,127383,61863,65520
Florida,Broward County,10,134502,65330,69172
Florida,Broward County,11,140067,68494,71573
Florida,Broward County,12,140176,69102,71074
Florida,Broward County,13,121545,58245,63300
Florida,Broward County,14,99831,46623,53208
Florida,Broward County,15,81189,37062,44127
Florida,Broward County,16,57616,25610,32006
Florida,Broward County,17,39563,16600,22963
Florida,Broward County,18,46114,16928,29186
Florida,Calhoun County,0,14587,7962,6625
Florida,Calhoun County,1,715,373,342
Florida,Calhoun County,2,814,395,419
Florida,Calhoun County,3,913,476,437
Florida,Calhoun County,4,775,401,374
Florida,Calhoun County,5,784,470,314
Florida,Calhoun County,6,1092,680,412
Florida,Calhoun County,7,1019,629,390
Florida,Calhoun County,8,970,578,392
Florida,Calhoun County,9,952,584,368
Florida,Calhoun County,10,1020,625,395
Florida,Calhoun County,11,999,564,435
Florida,Calhoun County,12,963,503,460
Florida,Calhoun County,13,940,459,481
Florida,Calhoun County,14,803,395,408
Florida,Calhoun County,15,669,303,366
Florida,Calhoun County,16,513,245,268
Florida,Calhoun County,17,336,164,172
Florida,Calhoun County,18,310,118,192
Florida,Charlotte County,0,184998,90256,94742
Florida,Charlotte County,1,5536,2828,2708
Florida,Charlotte County,2,5793,3026,2767
Florida,Charlotte County,3,6513,3404,3109
Florida,Charlotte County,4,6715,3494,3221
Florida,Charlotte County,5,6910,3704,3206
Florida,Charlotte County,6,7595,4100,3495
Florida,Charlotte County,7,6748,3507,3241
Florida,Charlotte County,8,6721,3396,3325
Florida,Charlotte County,9,6824,3433,3391
Florida,Charlotte County,10,8643,4111,4532
Florida,Charlotte County,11,10769,5035,5734
Florida,Charlotte County,12,14547,6639,7908
Florida,Charlotte County,13,17290,7863,9427
Florida,Charlotte County,14,19931,9295,10636
Florida,Charlotte County,15,19646,9574,10072
Florida,Charlotte County,16,15236,7556,7680
Florida,Charlotte County,17,9979,4971,5008
Florida,Charlotte County,18,9602,4320,5282
Florida,Citrus County,0,147929,71714,76215
Florida,Citrus County,1,5633,2843,2790
Florida,Citrus County,2,5926,2981,2945
Florida,Citrus County,3,6494,3317,3177
Florida,Citrus County,4,6144,3235,2909
Florida,Citrus County,5,5594,2976,2618
Florida,Citrus County,6,6659,3478,3181
Florida,Citrus County,7,6010,3072,2938
Florida,Citrus County,8,5758,2820,2938
Florida,Citrus County,9,5690,2772,2918
Florida,Citrus County,10,7425,3489,3936
Florida,Citrus County,11,8810,4157,4653
Florida,Citrus County,12,11106,5136,5970
Florida,Citrus County,13,12975,5792,7183
Florida,Citrus County,14,14472,6714,7758
Florida,Citrus County,15,14395,6906,7489
Florida,Citrus County,16,11509,5710,5799
Florida,Citrus County,17,7057,3537,3520
Florida,Citrus County,18,6272,2779,3493
Florida,Clay County,0,216072,106560,109512
Florida,Clay County,1,11957,6073,5884
Florida,Clay County,2,13556,7000,6556
Florida,Clay County,3,15249,7859,7390
Florida,Clay County,4,14520,7574,6946
Florida,Clay County,5,11890,6047,5843
Florida,Clay County,6,13637,7033,6604
Florida,Clay County,7,13604,6756,6848
Florida,Clay County,8,14231,6936,7295
Florida,Clay County,9,13632,6529,7103
Florida,Clay County,10,14901,7202,7699
Florida,Clay County,11,15017,7382,7635
Florida,Clay County,12,15690,7750,7940
Florida,Clay County,13,14084,6673,7411
Florida,Clay County,14,12003,5734,6269
Florida,Clay County,15,9444,4590,4854
Florida,Clay County,16,6061,2744,3317
Florida,Clay County,17,3523,1563,1960
Florida,Clay County,18,3073,1115,1958
Florida,Collier County,0,378488,186769,191719
Florida,Collier County,1,16634,8611,8023
Florida,Collier County,2,17433,8874,8559
Florida,Collier County,3,19039,9758,9281
Florida,Collier County,4,18589,9752,8837
Florida,Collier County,5,17907,9504,8403
Florida,Collier County,6,18139,9525,8614
Florida,Collier County,7,17791,9495,8296
Florida,Collier County,8,18442,9516,8926
Florida,Collier County,9,18275,8997,9278
Florida,Collier County,10,20699,10145,10554
Florida,Collier County,11,22860,11219,11641
Florida,Collier County,12,24758,11689,13069
Florida,Collier County,13,25987,11912,14075
Florida,Collier County,14,28833,13215,15618
Florida,Collier County,15,31014,14577,16437
Florida,Collier County,16,26501,12759,13742
Florida,Collier County,17,18338,9021,9317
Florida,Collier County,18,17249,8200,9049
Florida,Columbia County,0,70503,36366,34137
Florida,Columbia County,1,4191,2096,2095
Florida,Columbia County,2,4227,2172,2055
Florida,Columbia County,3,4378,2180,2198
Florida,Columbia County,4,4188,2340,1848
Florida,Columbia County,5,4474,2783,1691
Florida,Columbia County,6,4806,2649,2157
Florida,Columbia County,7,4424,2391,2033
Florida,Columbia County,8,4253,2213,2040
Florida,Columbia County,9,3982,2189,1793
Florida,Columbia County,10,4126,2142,1984
Florida,Columbia County,11,4371,2265,2106
Florida,Columbia County,12,4786,2414,2372
Florida,Columbia County,13,4983,2353,2630
Florida,Columbia County,14,4118,1995,2123
Florida,Columbia County,15,3592,1702,1890
Florida,Columbia County,16,2542,1197,1345
Florida,Columbia County,17,1576,696,880
Florida,Columbia County,18,1486,589,897
Florida,DeSoto County,0,37489,21230,16259
Florida,DeSoto County,1,1885,979,906
Florida,DeSoto County,2,1942,982,960
Florida,DeSoto County,3,1980,1025,955
Florida,DeSoto County,4,2143,1255,888
Florida,DeSoto County,5,2501,1694,807
Florida,DeSoto County,6,2834,1845,989
Florida,DeSoto County,7,2524,1635,889
Florida,DeSoto County,8,2507,1604,903
Florida,DeSoto County,9,2041,1284,757
Florida,DeSoto County,10,2190,1299,891
Florida,DeSoto County,11,2172,1246,926
Florida,DeSoto County,12,2302,1229,1073
Florida,DeSoto County,13,2151,1082,1069
Florida,DeSoto County,14,2144,1070,1074
Florida,DeSoto County,15,2115,1035,1080
Florida,DeSoto County,16,1853,890,963
Florida,DeSoto County,17,1137,578,559
Florida,DeSoto County,18,1068,498,570
Florida,Dixie County,0,16700,9244,7456
Florida,Dixie County,1,771,411,360
Florida,Dixie County,2,861,437,424
Florida,Dixie County,3,873,467,406
Florida,Dixie County,4,813,428,385
Florida,Dixie County,5,818,523,295
Florida,Dixie County,6,1046,661,385
Florida,Dixie County,7,935,560,375
Florida,Dixie County,8,1048,630,418
Florida,Dixie County,9,944,626,318
Florida,Dixie County,10,924,529,395
Florida,Dixie County,11,1162,659,503
Florida,Dixie County,12,1308,674,634
Florida,Dixie County,13,1248,617,631
Florida,Dixie County,14,1173,591,582
Florida,Dixie County,15,1109,568,541
Florida,Dixie County,16,801,438,363
Florida,Dixie County,17,495,251,244
Florida,Dixie County,18,371,174,197
Florida,Duval County,0,950181,460434,489747
Florida,Duval County,1,64303,32939,31364
Florida,Duval County,2,60254,30530,29724
Florida,Duval County,3,57840,29625,28215
Florida,Duval County,4,53783,27373,26410
Florida,Duval County,5,62188,31744,30444
Florida,Duval County,6,82574,41123,41451
Florida,Duval County,7,75276,37246,38030
Florida,Duval County,8,65240,31901,33339
Florida,Duval County,9,55052,26744,28308
Florida,Duval County,10,58902,28528,30374
Florida,Duval County,11,59998,28643,31355
Florida,Duval County,12,63769,30189,33580
Florida,Duval County,13,57519,26531,30988
Florida,Duval County,14,46283,20998,25285
Florida,Duval County,15,35256,16056,19200
Florida,Duval County,16,22642,9639,13003
Florida,Duval County,17,14388,5825,8563
Florida,Duval County,18,14914,4800,10114
Florida,Escambia County,0,315534,156179,159355
Florida,Escambia County,1,19025,9792,9233
Florida,Escambia County,2,18228,9273,8955
Florida,Escambia County,3,18228,9270,8958
Florida,Escambia County,4,21255,11772,9483
Florida,Escambia County,5,25161,13535,11626
Florida,Escambia County,6,25326,13105,12221
Florida,Escambia County,7,21117,10715,10402
Florida,Escambia County,8,18577,9439,9138
Florida,Escambia County,9,16032,7892,8140
Florida,Escambia County,10,17848,8907,8941
Florida,Escambia County,11,18751,8912,9839
Florida,Escambia County,12,22052,10545,11507
Florida,Escambia County,13,20786,9643,11143
Florida,Escambia County,14,17313,7945,9368
Florida,Escambia County,15,14022,6415,7607
Florida,Escambia County,16,9436,4145,5291
Florida,Escambia County,17,6316,2672,3644
Florida,Escambia County,18,6061,2202,3859
Florida,Flagler County,0,112067,53927,58140
Florida,Flagler County,1,4369,2196,2173
Florida,Flagler County,2,4974,2574,2400
Florida,Flagler County,3,5825,3012,2813
Florida,Flagler County,4,5748,2940,2808
Florida,Flagler County,5,4812,2531,2281
Florida,Flagler County,6,5198,2673,2525
Florida,Flagler County,7,4890,2311,2579
Florida,Flagler County,8,5286,2505,2781
Florida,Flagler County,9,5480,2630,2850
Florida,Flagler County,10,6410,3040,3370
Florida,Flagler County,11,7015,3275,3740
Florida,Flagler County,12,8179,3653,4526
Florida,Flagler County,13,9453,4229,5224
Florida,Flagler County,14,10413,4769,5644
Florida,Flagler County,15,9531,4682,4849
Florida,Flagler County,16,6720,3322,3398
Florida,Flagler County,17,4067,1996,2071
Florida,Flagler County,18,3697,1589,2108
Florida,Franklin County,0,11736,6545,5191
Florida,Franklin County,1,531,285,246
Florida,Franklin County,2,523,270,253
Florida,Franklin County,3,550,284,266
Florida,Franklin County,4,456,241,215
Florida,Franklin County,5,583,384,199
Florida,Franklin County,6,919,637,282
Florida,Franklin County,7,790,513,277
Florida,Franklin County,8,720,444,276
Florida,Franklin County,9,612,381,231
Florida,Franklin County,10,728,416,312
Florida,Franklin County,11,765,413,352
Florida,Franklin County,12,844,420,424
Florida,Franklin County,13,901,434,467
Florida,Franklin County,14,960,466,494
Florida,Franklin County,15,772,381,391
Florida,Franklin County,16,566,311,255
Florida,Franklin County,17,301,160,141
Florida,Franklin County,18,215,105,110
Florida,Gadsden County,0,45894,21790,24104
Florida,Gadsden County,1,2747,1359,1388
Florida,Gadsden County,2,2761,1388,1373
Florida,Gadsden County,3,2945,1472,1473
Florida,Gadsden County,4,2685,1344,1341
Florida,Gadsden County,5,2697,1301,1396
Florida,Gadsden County,6,2903,1466,1437
Florida,Gadsden County,7,2580,1213,1367
Florida,Gadsden County,8,2917,1345,1572
Florida,Gadsden County,9,2838,1327,1511
Florida,Gadsden County,10,2946,1390,1556
Florida,Gadsden County,11,3035,1486,1549
Florida,Gadsden County,12,3412,1586,1826
Florida,Gadsden County,13,3231,1559,1672
Florida,Gadsden County,14,2806,1284,1522
Florida,Gadsden County,15,2156,952,1204
Florida,Gadsden County,16,1412,629,783
Florida,Gadsden County,17,932,365,567
Florida,Gadsden County,18,891,324,567
Florida,Gilchrist County,0,18256,9429,8827
Florida,Gilchrist County,1,1037,567,470
Florida,Gilchrist County,2,1007,516,491
Florida,Gilchrist County,3,995,476,519
Florida,Gilchrist County,4,1323,816,507
Florida,Gilchrist County,5,1486,1080,406
Florida,Gilchrist County,6,941,482,459
Florida,Gilchrist County,7,953,475,478
Florida,Gilchrist County,8,986,511,475
Florida,Gilchrist County,9,881,438,443
Florida,Gilchrist County,10,1084,511,573
Florida,Gilchrist County,11,1191,613,578
Florida,Gilchrist County,12,1315,649,666
Florida,Gilchrist County,13,1316,624,692
Florida,Gilchrist County,14,1122,532,590
Florida,Gilchrist County,15,935,453,482
Florida,Gilchrist County,16,747,339,408
Florida,Gilchrist County,17,454,193,261
Florida,Gilchrist County,18,483,154,329
Florida,Glades County,0,13724,7719,6005
Florida,Glades County,1,427,215,212
Florida,Glades County,2,570,286,284
Florida,Glades County,3,676,332,344
Florida,Glades County,4,649,372,277
Florida,Glades County,5,663,396,267
Florida,Glades County,6,920,593,327
Florida,Glades County,7,866,573,293
Florida,Glades County,8,874,563,311
Florida,Glades County,9,820,537,283
Florida,Glades County,10,877,520,357
Florida,Glades County,11,835,473,362
Florida,Glades County,12,868,486,382
Florida,Glades County,13,935,477,458
Florida,Glades County,14,927,435,492
Florida,Glades County,15,1021,505,516
Florida,Glades County,16,868,469,399
Florida,Glades County,17,547,280,267
Florida,Glades County,18,381,207,174
Florida,Gulf County,0,16164,9461,6703
Florida,Gulf County,1,647,344,303
Florida,Gulf County,2,718,367,351
Florida,Gulf County,3,717,356,361
Florida,Gulf County,4,696,366,330
Florida,Gulf County,5,898,626,272
Florida,Gulf County,6,1227,890,337
Florida,Gulf County,7,1095,794,301
Florida,Gulf County,8,1003,693,310
Florida,Gulf County,9,1025,680,345
Florida,Gulf County,10,1119,727,392
Florida,Gulf County,11,1175,697,478
Florida,Gulf County,12,1181,637,544
Florida,Gulf County,13,1176,603,573
Florida,Gulf County,14,1155,577,578
Florida,Gulf County,15,964,483,481
Florida,Gulf County,16,643,302,341
Florida,Gulf County,17,388,168,220
Florida,Gulf County,18,337,151,186
Florida,Hamilton County,0,14310,8283,6027
Florida,Hamilton County,1,781,403,378
Florida,Hamilton County,2,703,343,360
Florida,Hamilton County,3,762,398,364
Florida,Hamilton County,4,798,482,316
Florida,Hamilton County,5,1298,1025,273
Florida,Hamilton County,6,1124,756,368
Florida,Hamilton County,7,871,566,305
Florida,Hamilton County,8,807,529,278
Florida,Hamilton County,9,840,501,339
Florida,Hamilton County,10,891,536,355
Florida,Hamilton County,11,948,562,386
Florida,Hamilton County,12,943,525,418
Florida,Hamilton County,13,969,477,492
Florida,Hamilton County,14,827,423,404
Florida,Hamilton County,15,738,338,400
Florida,Hamilton County,16,445,207,238
Florida,Hamilton County,17,275,108,167
Florida,Hamilton County,18,290,104,186
Florida,Hardee County,0,27245,14376,12869
Florida,Hardee County,1,1879,961,918
Florida,Hardee County,2,1983,1045,938
Florida,Hardee County,3,2079,1064,1015
Florida,Hardee County,4,1953,1066,887
Florida,Hardee County,5,1966,1180,786
Florida,Hardee County,6,2026,1151,875
Florida,Hardee County,7,1624,914,710
Florida,Hardee County,8,1505,816,689
Florida,Hardee County,9,1565,784,781
Florida,Hardee County,10,1662,887,775
Florida,Hardee County,11,1601,880,721
Florida,Hardee County,12,1529,803,726
Florida,Hardee County,13,1341,633,708
Florida,Hardee County,14,1365,701,664
Florida,Hardee County,15,1141,537,604
Florida,Hardee County,16,844,414,430
Florida,Hardee County,17,635,302,333
Florida,Hardee County,18,547,238,309
Florida,Hendry County,0,41556,22163,19393
Florida,Hendry County,1,3072,1653,1419
Florida,Hendry County,2,3107,1702,1405
Florida,Hendry County,3,3064,1572,1492
Florida,Hendry County,4,2762,1506,1256
Florida,Hendry County,5,2822,1649,1173
Florida,Hendry County,6,3174,1733,1441
Florida,Hendry County,7,2838,1575,1263
Florida,Hendry County,8,2696,1450,1246
Florida,Hendry County,9,2469,1351,1118
Florida,Hendry County,10,2592,1380,1212
Florida,Hendry County,11,2679,1420,1259
Florida,Hendry County,12,2416,1229,1187
Florida,Hendry County,13,2153,1065,1088
Florida,Hendry County,14,1637,841,796
Florida,Hendry County,15,1564,828,736
Florida,Hendry County,16,1111,529,582
Florida,Hendry County,17,669,356,313
Florida,Hendry County,18,731,324,407
Florida,Hernando County,0,190865,91975,98890
Florida,Hernando County,1,8695,4375,4320
Florida,Hernando County,2,9413,4868,4545
Florida,Hernando County,3,10457,5211,5246
Florida,Hernando County,4,10000,5041,4959
Florida,Hernando County,5,9110,4628,4482
Florida,Hernando County,6,10434,5299,5135
Florida,Hernando County,7,9684,4715,4969
Florida,Hernando County,8,9810,4806,5004
Florida,Hernando County,9,9547,4703,4844
Florida,Hernando County,10,11351,5378,5973
Florida,Hernando County,11,12104,5675,6429
Florida,Hernando County,12,13658,6473,7185
Florida,Hernando County,13,14190,6475,7715
Florida,Hernando County,14,14263,6606,7657
Florida,Hernando County,15,13859,6537,7322
Florida,Hernando County,16,10828,5172,5656
Florida,Hernando County,17,7017,3326,3691
Florida,Hernando County,18,6445,2687,3758
Florida,Highlands County,0,105424,51515,53909
Florida,Highlands County,1,4810,2408,2402
Florida,Highlands County,2,4935,2485,2450
Florida,Highlands County,3,5296,2710,2586
Florida,Highlands County,4,4664,2401,2263
Florida,Highlands County,5,4709,2516,2193
Florida,Highlands County,6,5258,2783,2475
Florida,Highlands County,7,4932,2496,2436
Florida,Highlands County,8,4827,2463,2364
Florida,Highlands County,9,4397,2192,2205
Florida,Highlands County,10,4852,2364,2488
Florida,Highlands County,11,5443,2713,2730
Florida,Highlands County,12,6561,3066,3495
Florida,Highlands County,13,7518,3411,4107
Florida,Highlands County,14,8324,3724,4600
Florida,Highlands County,15,9218,4351,4867
Florida,Highlands County,16,8377,4055,4322
Florida,Highlands County,17,5802,2865,2937
Florida,Highlands County,18,5501,2512,2989
Florida,Hillsborough County,0,1436888,702940,733948
Florida,Hillsborough County,1,89013,45807,43206
Florida,Hillsborough County,2,90293,46469,43824
Florida,Hillsborough County,3,90952,46717,44235
Florida,Hillsborough County,4,90507,46166,44341
Florida,Hillsborough County,5,92141,45872,46269
Florida,Hillsborough County,6,112397,55958,56439
Florida,Hillsborough County,7,106818,52948,53870
Florida,Hillsborough County,8,102443,50187,52256
Florida,Hillsborough County,9,93296,45570,47726
Florida,Hillsborough County,10,97559,48275,49284
Florida,Hillsborough County,11,93423,45853,47570
Florida,Hillsborough County,12,92010,44674,47336
Florida,Hillsborough County,13,80721,37883,42838
Florida,Hillsborough County,14,67823,31361,36462
Florida,Hillsborough County,15,54620,25055,29565
Florida,Hillsborough County,16,35658,15708,19950
Florida,Hillsborough County,17,23482,9734,13748
Florida,Hillsborough County,18,23732,8703,15029
Florida,Holmes County,0,19477,10336,9141
Florida,Holmes County,1,1072,541,531
Florida,Holmes County,2,1022,516,506
Florida,Holmes County,3,1160,617,543
Florida,Holmes County,4,1063,581,482
Florida,Holmes County,5,1244,790,454
Florida,Holmes County,6,1325,799,526
Florida,Holmes County,7,1142,665,477
Florida,Holmes County,8,1147,642,505
Florida,Holmes County,9,1150,652,498
Florida,Holmes County,10,1315,767,548
Florida,Holmes County,11,1286,653,633
Florida,Holmes County,12,1366,688,678
Florida,Holmes County,13,1314,666,648
Florida,Holmes County,14,1187,551,636
Florida,Holmes County,15,954,446,508
Florida,Holmes County,16,767,356,411
Florida,Holmes County,17,544,236,308
Florida,Holmes County,18,419,170,249
Florida,Indian River County,0,157413,75421,81992
Florida,Indian River County,1,6403,3280,3123
Florida,Indian River County,2,6776,3389,3387
Florida,Indian River County,3,7282,3690,3592
Florida,Indian River County,4,7658,4249,3409
Florida,Indian River County,5,6805,3442,3363
Florida,Indian River County,6,7627,3889,3738
Florida,Indian River County,7,6889,3476,3413
Florida,Indian River County,8,7061,3399,3662
Florida,Indian River County,9,6833,3328,3505
Florida,Indian River County,10,8187,3880,4307
Florida,Indian River County,11,9339,4482,4857
Florida,Indian River County,12,11819,5437,6382
Florida,Indian River County,13,12715,5653,7062
Florida,Indian River County,14,13692,6182,7510
Florida,Indian River County,15,13519,6192,7327
Florida,Indian River County,16,10278,4935,5343
Florida,Indian River County,17,6968,3235,3733
Florida,Indian River County,18,7562,3283,4279
Florida,Jackson County,0,48305,26615,21690
Florida,Jackson County,1,2436,1265,1171
Florida,Jackson County,2,2365,1250,1115
Florida,Jackson County,3,2544,1341,1203
Florida,Jackson County,4,2681,1424,1257
Florida,Jackson County,5,2952,1848,1104
Florida,Jackson County,6,3380,2060,1320
Florida,Jackson County,7,3164,2005,1159
Florida,Jackson County,8,3431,2222,1209
Florida,Jackson County,9,3235,2004,1231
Florida,Jackson County,10,3200,1924,1276
Florida,Jackson County,11,3060,1718,1342
Florida,Jackson County,12,3220,1698,1522
Florida,Jackson County,13,3213,1630,1583
Florida,Jackson County,14,2797,1401,1396
Florida,Jackson County,15,2461,1122,1339
Florida,Jackson County,16,1778,758,1020
Florida,Jackson County,17,1254,534,720
Florida,Jackson County,18,1134,411,723
Florida,Jefferson County,0,14288,7491,6797
Florida,Jefferson County,1,638,350,288
Florida,Jefferson County,2,688,351,337
Florida,Jefferson County,3,718,367,351
Florida,Jefferson County,4,639,323,316
Florida,Jefferson County,5,646,370,276
Florida,Jefferson County,6,856,517,339
Florida,Jefferson County,7,820,504,316
Florida,Jefferson County,8,800,472,328
Florida,Jefferson County,9,844,520,324
Florida,Jefferson County,10,943,488,455
Florida,Jefferson County,11,1082,583,499
Florida,Jefferson County,12,1113,547,566
Florida,Jefferson County,13,1139,538,601
Florida,Jefferson County,14,1093,539,554
Florida,Jefferson County,15,943,444,499
Florida,Jefferson County,16,591,297,294
Florida,Jefferson County,17,365,158,207
Florida,Jefferson County,18,370,123,247
Florida,Lafayette County,0,8732,4986,3746
Florida,Lafayette County,1,371,172,199
Florida,Lafayette County,2,483,198,285
Florida,Lafayette County,3,553,281,272
Florida,Lafayette County,4,589,333,256
Florida,Lafayette County,5,670,509,161
Florida,Lafayette County,6,707,440,267
Florida,Lafayette County,7,546,384,162
Florida,Lafayette County,8,600,368,232
Florida,Lafayette County,9,667,395,272
Florida,Lafayette County,10,654,429,225
Florida,Lafayette County,11,513,280,233
Florida,Lafayette County,12,509,293,216
Florida,Lafayette County,13,469,239,230
Florida,Lafayette County,14,442,235,207
Florida,Lafayette County,15,353,165,188
Florida,Lafayette County,16,262,115,147
Florida,Lafayette County,17,184,86,98
Florida,Lafayette County,18,160,64,96
Florida,Lake County,0,356495,172515,183980
Florida,Lake County,1,17502,8934,8568
Florida,Lake County,2,18700,9587,9113
Florida,Lake County,3,20244,10281,9963
Florida,Lake County,4,18405,9434,8971
Florida,Lake County,5,17030,8514,8516
Florida,Lake County,6,20010,9861,10149
Florida,Lake County,7,19163,9566,9597
Florida,Lake County,8,19411,9471,9940
Florida,Lake County,9,18990,9146,9844
Florida,Lake County,10,21181,10322,10859
Florida,Lake County,11,21912,10609,11303
Florida,Lake County,12,23941,11555,12386
Florida,Lake County,13,24897,11537,13360
Florida,Lake County,14,25712,11616,14096
Florida,Lake County,15,25562,11920,13642
Florida,Lake County,16,19674,9313,10361
Florida,Lake County,17,12938,6155,6783
Florida,Lake County,18,11223,4694,6529
Florida,Lee County,0,754610,369372,385238
Florida,Lee County,1,34544,17708,16836
Florida,Lee County,2,36201,18457,17744
Florida,Lee County,3,38518,19815,18703
Florida,Lee County,4,38127,19351,18776
Florida,Lee County,5,36961,18564,18397
Florida,Lee County,6,42278,21501,20777
Florida,Lee County,7,40395,20337,20058
Florida,Lee County,8,39649,20073,19576
Florida,Lee County,9,37722,18621,19101
Florida,Lee County,10,42829,21053,21776
Florida,Lee County,11,45388,21721,23667
Florida,Lee County,12,51742,24230,27512
Florida,Lee County,13,54362,25110,29252
Florida,Lee County,14,58873,27376,31497
Florida,Lee County,15,58402,28201,30201
Florida,Lee County,16,44700,21910,22790
Florida,Lee County,17,27869,13796,14073
Florida,Lee County,18,26050,11548,14502
Florida,Leon County,0,292502,138642,153860
Florida,Leon County,1,15155,7731,7424
Florida,Leon County,2,14874,7589,7285
Florida,Leon County,3,15301,7809,7492
Florida,Leon County,4,25727,11819,13908
Florida,Leon County,5,46218,21754,24464
Florida,Leon County,6,24574,12139,12435
Florida,Leon County,7,17950,8775,9175
Florida,Leon County,8,17366,8289,9077
Florida,Leon County,9,14752,6926,7826
Florida,Leon County,10,15171,7329,7842
Florida,Leon County,11,14584,6832,7752
Florida,Leon County,12,16211,7549,8662
Florida,Leon County,13,15464,7010,8454
Florida,Leon County,14,13837,6287,7550
Florida,Leon County,15,10577,4908,5669
Florida,Leon County,16,6550,2858,3692
Florida,Leon County,17,3968,1573,2395
Florida,Leon County,18,4223,1465,2758
Florida,Levy County,0,40770,19903,20867
Florida,Levy County,1,2069,1073,996
Florida,Levy County,2,2222,1169,1053
Florida,Levy County,3,2304,1178,1126
Florida,Levy County,4,2103,1080,1023
Florida,Levy County,5,1848,937,911
Florida,Levy County,6,2470,1238,1232
Florida,Levy County,7,2099,996,1103
Florida,Levy County,8,2066,985,1081
Florida,Levy County,9,1967,948,1019
Florida,Levy County,10,2385,1154,1231
Florida,Levy County,11,2647,1296,1351
Florida,Levy County,12,3258,1485,1773
Florida,Levy County,13,3229,1523,1706
Florida,Levy County,14,3182,1461,1721
Florida,Levy County,15,2790,1356,1434
Florida,Levy County,16,2020,1021,999
Florida,Levy County,17,1222,602,620
Florida,Levy County,18,889,401,488
Florida,Liberty County,0,8457,5215,3242
Florida,Liberty County,1,396,199,197
Florida,Liberty County,2,376,192,184
Florida,Liberty County,3,439,230,209
Florida,Liberty County,4,458,268,190
Florida,Liberty County,5,538,378,160
Florida,Liberty County,6,796,583,213
Florida,Liberty County,7,642,451,191
Florida,Liberty County,8,672,479,193
Florida,Liberty County,9,646,446,200
Florida,Liberty County,10,662,452,210
Florida,Liberty County,11,561,355,206
Florida,Liberty County,12,558,313,245
Florida,Liberty County,13,484,266,218
Florida,Liberty County,14,412,221,191
Florida,Liberty County,15,319,166,153
Florida,Liberty County,16,229,94,135
Florida,Liberty County,17,167,81,86
Florida,Liberty County,18,102,41,61
Florida,Madison County,0,18529,9799,8730
Florida,Madison County,1,940,506,434
Florida,Madison County,2,963,492,471
Florida,Madison County,3,970,488,482
Florida,Madison County,4,968,547,421
Florida,Madison County,5,1011,602,409
Florida,Madison County,6,1391,805,586
Florida,Madison County,7,1202,677,525
Florida,Madison County,8,1123,644,479
Florida,Madison County,9,1099,650,449
Florida,Madison County,10,1244,719,525
Florida,Madison County,11,1209,644,565
Florida,Madison County,12,1286,656,630
Florida,Madison County,13,1325,610,715
Florida,Madison County,14,1274,625,649
Florida,Madison County,15,962,494,468
Florida,Madison County,16,698,311,387
Florida,Madison County,17,448,197,251
Florida,Madison County,18,416,132,284
Florida,Manatee County,0,394855,190647,204208
Florida,Manatee County,1,18437,9418,9019
Florida,Manatee County,2,19742,9986,9756
Florida,Manatee County,3,21222,10585,10637
Florida,Manatee County,4,19781,10273,9508
Florida,Manatee County,5,18678,9598,9080
Florida,Manatee County,6,21410,10675,10735
Florida,Manatee County,7,20358,10002,10356
Florida,Manatee County,8,20677,10059,10618
Florida,Manatee County,9,19979,9805,10174
Florida,Manatee County,10,23124,11123,12001
Florida,Manatee County,11,24976,11886,13090
Florida,Manatee County,12,28612,13359,15253
Florida,Manatee County,13,29686,13671,16015
Florida,Manatee County,14,29855,13668,16187
Florida,Manatee County,15,28696,13573,15123
Florida,Manatee County,16,21120,9993,11127
Florida,Manatee County,17,13885,6636,7249
Florida,Manatee County,18,14617,6337,8280
Florida,Marion County,0,359977,172642,187335
Florida,Marion County,1,17802,9118,8684
Florida,Marion County,2,18497,9466,9031
Florida,Marion County,3,19162,9767,9395
Florida,Marion County,4,18023,9239,8784
Florida,Marion County,5,17376,8848,8528
Florida,Marion County,6,20564,10151,10413
Florida,Marion County,7,18645,9130,9515
Florida,Marion County,8,18372,8780,9592
Florida,Marion County,9,17020,8095,8925
Florida,Marion County,10,19734,9493,10241
Florida,Marion County,11,21194,10050,11144
Florida,Marion County,12,23725,10918,12807
Florida,Marion County,13,25685,11544,14141
Florida,Marion County,14,27853,12437,15416
Florida,Marion County,15,28220,13118,15102
Florida,Marion County,16,22305,10683,11622
Florida,Marion County,17,14151,6767,7384
Florida,Marion County,18,11649,5038,6611
Florida,Martin County,0,160912,79518,81394
Florida,Martin County,1,6622,3413,3209
Florida,Martin County,2,6991,3515,3476
Florida,Martin County,3,7834,3988,3846
Florida,Martin County,4,7693,3945,3748
Florida,Martin County,5,7024,3787,3237
Florida,Martin County,6,7637,4278,3359
Florida,Martin County,7,7443,3983,3460
Florida,Martin County,8,7440,3929,3511
Florida,Martin County,9,7497,3847,3650
Florida,Martin County,10,9220,4654,4566
Florida,Martin County,11,10520,5113,5407
Florida,Martin County,12,12470,5975,6495
Florida,Martin County,13,12831,6124,6707
Florida,Martin County,14,12201,5745,6456
Florida,Martin County,15,12171,5686,6485
Florida,Martin County,16,10268,4797,5471
Florida,Martin County,17,6992,3241,3751
Florida,Martin County,18,8058,3498,4560
Florida,Miami-Dade County,0,2761581,1340718,1420863
Florida,Miami-Dade County,1,159444,81251,78193
Florida,Miami-Dade County,2,151347,77092,74255
Florida,Miami-Dade County,3,154046,78093,75953
Florida,Miami-Dade County,4,157450,80212,77238
Florida,Miami-Dade County,5,167734,85087,82647
Florida,Miami-Dade County,6,197832,100675,97157
Florida,Miami-Dade County,7,196227,100627,95600
Florida,Miami-Dade County,8,188044,94717,93327
Florida,Miami-Dade County,9,191592,94796,96796
Florida,Miami-Dade County,10,202497,100797,101700
Florida,Miami-Dade County,11,202557,99792,102765
Florida,Miami-Dade County,12,187328,89367,97961
Florida,Miami-Dade County,13,157371,71904,85467
Florida,Miami-Dade County,14,133374,59019,74355
Florida,Miami-Dade County,15,106937,46583,60354
Florida,Miami-Dade County,16,83044,34655,48389
Florida,Miami-Dade County,17,60440,23740,36700
Florida,Miami-Dade County,18,64317,22311,42006
Florida,Monroe County,0,75027,39005,36022
Florida,Monroe County,1,3467,1784,1683
Florida,Monroe County,2,3055,1535,1520
Florida,Monroe County,3,3109,1615,1494
Florida,Monroe County,4,2828,1417,1411
Florida,Monroe County,5,3527,1888,1639
Florida,Monroe County,6,4628,2469,2159
Florida,Monroe County,7,4646,2447,2199
Florida,Monroe County,8,4565,2411,2154
Florida,Monroe County,9,4591,2400,2191
Florida,Monroe County,10,5087,2627,2460
Florida,Monroe County,11,5810,3065,2745
Florida,Monroe County,12,6301,3223,3078
Florida,Monroe County,13,6147,3126,3021
Florida,Monroe County,14,5807,2971,2836
Florida,Monroe County,15,4750,2566,2184
Florida,Monroe County,16,3226,1694,1532
Florida,Monroe County,17,1760,970,790
Florida,Monroe County,18,1723,797,926
Florida,Nassau County,0,85832,42254,43578
Florida,Nassau County,1,4365,2238,2127
Florida,Nassau County,2,4721,2389,2332
Florida,Nassau County,3,4867,2546,2321
Florida,Nassau County,4,4633,2409,2224
Florida,Nassau County,5,3982,2047,1935
Florida,Nassau County,6,4944,2478,2466
Florida,Nassau County,7,4932,2492,2440
Florida,Nassau County,8,4988,2492,2496
Florida,Nassau County,9,4701,2296,2405
Florida,Nassau County,10,5469,2659,2810
Florida,Nassau County,11,5862,2842,3020
Florida,Nassau County,12,6572,3111,3461
Florida,Nassau County,13,6754,3167,3587
Florida,Nassau County,14,6385,3058,3327
Florida,Nassau County,15,5516,2662,2854
Florida,Nassau County,16,3413,1682,1731
Florida,Nassau County,17,1972,933,1039
Florida,Nassau County,18,1756,753,1003
Florida,Okaloosa County,0,207269,104997,102272
Florida,Okaloosa County,1,13607,6958,6649
Florida,Okaloosa County,2,13142,6631,6511
Florida,Okaloosa County,3,12314,6244,6070
Florida,Okaloosa County,4,11250,6053,5197
Florida,Okaloosa County,5,14139,8173,5966
Florida,Okaloosa County,6,17424,9425,7999
Florida,Okaloosa County,7,15862,8456,7406
Florida,Okaloosa County,8,13785,7193,6592
Florida,Okaloosa County,9,11353,5665,5688
Florida,Okaloosa County,10,11045,5447,5598
Florida,Okaloosa County,11,12335,6088,6247
Florida,Okaloosa County,12,14726,7266,7460
Florida,Okaloosa County,13,13098,6282,6816
Florida,Okaloosa County,14,10810,5190,5620
Florida,Okaloosa County,15,8618,4144,4474
Florida,Okaloosa County,16,5911,2649,3262
Florida,Okaloosa County,17,4236,1736,2500
Florida,Okaloosa County,18,3614,1397,2217
Florida,Okeechobee County,0,41537,22289,19248
Florida,Okeechobee County,1,2503,1309,1194
Florida,Okeechobee County,2,2366,1254,1112
Florida,Okeechobee County,3,2428,1246,1182
Florida,Okeechobee County,4,2482,1393,1089
Florida,Okeechobee County,5,2291,1322,969
Florida,Okeechobee County,6,2888,1590,1298
Florida,Okeechobee County,7,2630,1526,1104
Florida,Okeechobee County,8,2532,1477,1055
Florida,Okeechobee County,9,2558,1419,1139
Florida,Okeechobee County,10,2601,1496,1105
Florida,Okeechobee County,11,2662,1519,1143
Florida,Okeechobee County,12,2751,1409,1342
Florida,Okeechobee County,13,2627,1319,1308
Florida,Okeechobee County,14,2258,1112,1146
Florida,Okeechobee County,15,2135,1044,1091
Florida,Okeechobee County,16,1731,829,902
Florida,Okeechobee County,17,1152,588,564
Florida,Okeechobee County,18,942,437,505
Florida,Orange County,0,1380645,677345,703300
Florida,Orange County,1,84175,42956,41219
Florida,Orange County,2,84530,43201,41329
Florida,Orange County,3,86099,44197,41902
Florida,Orange County,4,90181,44958,45223
Florida,Orange County,5,104861,51224,53637
Florida,Orange County,6,123446,62488,60958
Florida,Orange County,7,109757,55249,54508
Florida,Orange County,8,103213,51100,52113
Florida,Orange County,9,94249,46345,47904
Florida,Orange County,10,92647,45630,47017
Florida,Orange County,11,87910,43360,44550
Florida,Orange County,12,83790,40930,42860
Florida,Orange County,13,70967,33598,37369
Florida,Orange County,14,56480,25945,30535
Florida,Orange County,15,43274,19666,23608
Florida,Orange County,16,27667,12007,15660
Florida,Orange County,17,18336,7706,10630
Florida,Orange County,18,19063,6785,12278
Florida,Osceola County,0,367990,181463,186527
Florida,Osceola County,1,22984,11744,11240
Florida,Osceola County,2,24573,12879,11694
Florida,Osceola County,3,26401,13405,12996
Florida,Osceola County,4,25496,13092,12404
Florida,Osceola County,5,24333,12499,11834
Florida,Osceola County,6,27190,13789,13401
Florida,Osceola County,7,26484,13496,12988
Florida,Osceola County,8,27369,13813,13556
Florida,Osceola County,9,26220,12670,13550
Florida,Osceola County,10,25104,12132,12972
Florida,Osceola County,11,23615,11598,12017
Florida,Osceola County,12,21217,10275,10942
Florida,Osceola County,13,18399,8479,9920
Florida,Osceola County,14,16120,7386,8734
Florida,Osceola County,15,13364,6061,7303
Florida,Osceola County,16,8936,4002,4934
Florida,Osceola County,17,5449,2343,3106
Florida,Osceola County,18,4736,1800,2936
Florida,Palm Beach County,0,1485941,720762,765179
Florida,Palm Beach County,1,75576,38741,36835
Florida,Palm Beach County,2,76292,38870,37422
Florida,Palm Beach County,3,81782,41618,40164
Florida,Palm Beach County,4,81909,41940,39969
Florida,Palm Beach County,5,79705,40723,38982
Florida,Palm Beach County,6,90697,46250,44447
Florida,Palm Beach County,7,86880,44437,42443
Florida,Palm Beach County,8,86045,42944,43101
Florida,Palm Beach County,9,84216,41384,42832
Florida,Palm Beach County,10,93268,45608,47660
Florida,Palm Beach County,11,96769,46825,49944
Florida,Palm Beach County,12,102500,49289,53211
Florida,Palm Beach County,13,95036,44644,50392
Florida,Palm Beach County,14,87716,40041,47675
Florida,Palm Beach County,15,84611,37601,47010
Florida,Palm Beach County,16,69186,30821,38365
Florida,Palm Beach County,17,50542,22471,28071
Florida,Palm Beach County,18,63211,26555,36656
Florida,Pasco County,0,539630,262406,277224
Florida,Pasco County,1,28068,14250,13818
Florida,Pasco County,2,30083,15374,14709
Florida,Pasco County,3,32206,16605,15601
Florida,Pasco County,4,30322,15429,14893
Florida,Pasco County,5,26635,13632,13003
Florida,Pasco County,6,29905,14758,15147
Florida,Pasco County,7,30092,14540,15552
Florida,Pasco County,8,32838,15839,16999
Florida,Pasco County,9,32467,15963,16504
Florida,Pasco County,10,35894,17884,18010
Florida,Pasco County,11,36180,17695,18485
Florida,Pasco County,12,37639,18237,19402
Florida,Pasco County,13,35196,16301,18895
Florida,Pasco County,14,34282,15829,18453
Florida,Pasco County,15,32606,15172,17434
Florida,Pasco County,16,24560,11449,13111
Florida,Pasco County,17,15813,7441,8372
Florida,Pasco County,18,14844,6008,8836
Florida,Pinellas County,0,975280,467828,507452
Florida,Pinellas County,1,42298,21566,20732
Florida,Pinellas County,2,42716,21693,21023
Florida,Pinellas County,3,45163,22960,22203
Florida,Pinellas County,4,44284,22731,21553
Florida,Pinellas County,5,47661,23949,23712
Florida,Pinellas County,6,61542,30457,31085
Florida,Pinellas County,7,56926,28135,28791
Florida,Pinellas County,8,55187,26972,28215
Florida,Pinellas County,9,51521,25212,26309
Florida,Pinellas County,10,61065,29606,31459
Florida,Pinellas County,11,68612,33114,35498
Florida,Pinellas County,12,79411,37880,41531
Florida,Pinellas County,13,77253,36034,41219
Florida,Pinellas County,14,69272,32258,37014
Florida,Pinellas County,15,60484,27987,32497
Florida,Pinellas County,16,44634,20163,24471
Florida,Pinellas County,17,30554,13289,17265
Florida,Pinellas County,18,36697,13822,22875
Florida,Polk County,0,708009,346929,361080
Florida,Polk County,1,40901,20911,19990
Florida,Polk County,2,42841,22076,20765
Florida,Polk County,3,45624,23375,22249
Florida,Polk County,4,44325,22591,21734
Florida,Polk County,5,42126,21143,20983
Florida,Polk County,6,48503,24257,24246
Florida,Polk County,7,44174,22233,21941
Florida,Polk County,8,43678,21335,22343
Florida,Polk County,9,40749,19823,20926
Florida,Polk County,10,42928,21258,21670
Florida,Polk County,11,42117,20828,21289
Florida,Polk County,12,43799,21078,22721
Florida,Polk County,13,43102,20198,22904
Florida,Polk County,14,41555,19113,22442
Florida,Polk County,15,38654,17865,20789
Florida,Polk County,16,28484,13520,14964
Florida,Polk County,17,18391,8582,9809
Florida,Polk County,18,16058,6743,9315
Florida,Putnam County,0,74163,36699,37464
Florida,Putnam County,1,4313,2253,2060
Florida,Putnam County,2,4357,2217,2140
Florida,Putnam County,3,4610,2361,2249
Florida,Putnam County,4,4074,2146,1928
Florida,Putnam County,5,3726,1932,1794
Florida,Putnam County,6,4504,2326,2178
Florida,Putnam County,7,3815,1887,1928
Florida,Putnam County,8,3787,1857,1930
Florida,Putnam County,9,3568,1778,1790
Florida,Putnam County,10,4142,1996,2146
Florida,Putnam County,11,4634,2293,2341
Florida,Putnam County,12,5807,2756,3051
Florida,Putnam County,13,5622,2676,2946
Florida,Putnam County,14,5520,2724,2796
Florida,Putnam County,15,4453,2194,2259
Florida,Putnam County,16,3367,1603,1764
Florida,Putnam County,17,2007,924,1083
Florida,Putnam County,18,1857,776,1081
Florida,St. Johns County,0,254261,124017,130244
Florida,St. Johns County,1,12573,6430,6143
Florida,St. Johns County,2,15205,7727,7478
Florida,St. Johns County,3,17156,8691,8465
Florida,St. Johns County,4,16284,8358,7926
Florida,St. Johns County,5,11710,6036,5674
Florida,St. Johns County,6,11474,5784,5690
Florida,St. Johns County,7,13268,6346,6922
Florida,St. Johns County,8,16309,7879,8430
Florida,St. Johns County,9,16597,8173,8424
Florida,St. Johns County,10,18190,8978,9212
Florida,St. Johns County,11,17656,8607,9049
Florida,St. Johns County,12,18563,8808,9755
Florida,St. Johns County,13,17796,8300,9496
Florida,St. Johns County,14,17056,7974,9082
Florida,St. Johns County,15,14300,6906,7394
Florida,St. Johns County,16,9188,4355,4833
Florida,St. Johns County,17,5362,2455,2907
Florida,St. Johns County,18,5574,2210,3364
Florida,St. Lucie County,0,321128,156975,164153
Florida,St. Lucie County,1,16190,8466,7724
Florida,St. Lucie County,2,17108,8828,8280
Florida,St. Lucie County,3,18783,9696,9087
Florida,St. Lucie County,4,17757,9391,8366
Florida,St. Lucie County,5,16678,8492,8186
Florida,St. Lucie County,6,19102,9706,9396
Florida,St. Lucie County,7,17625,8755,8870
Florida,St. Lucie County,8,17907,8690,9217
Florida,St. Lucie County,9,17508,8460,9048
Florida,St. Lucie County,10,19125,9206,9919
Florida,St. Lucie County,11,20756,9980,10776
Florida,St. Lucie County,12,22582,10645,11937
Florida,St. Lucie County,13,22504,10621,11883
Florida,St. Lucie County,14,21905,10122,11783
Florida,St. Lucie County,15,20290,9695,10595
Florida,St. Lucie County,16,15388,7251,8137
Florida,St. Lucie County,17,10115,4771,5344
Florida,St. Lucie County,18,9805,4200,5605
Florida,Santa Rosa County,0,179349,91404,87945
Florida,Santa Rosa County,1,10122,5143,4979
Florida,Santa Rosa County,2,10655,5477,5178
Florida,Santa Rosa County,3,11630,6029,5601
Florida,Santa Rosa County,4,10747,5632,5115
Florida,Santa Rosa County,5,9993,5635,4358
Florida,Santa Rosa County,6,12482,6949,5533
Florida,Santa Rosa County,7,12556,6729,5827
Florida,Santa Rosa County,8,11939,6211,5728
Florida,Santa Rosa County,9,11174,5760,5414
Florida,Santa Rosa County,10,12076,6123,5953
Florida,Santa Rosa County,11,12371,6142,6229
Florida,Santa Rosa County,12,13494,6652,6842
Florida,Santa Rosa County,13,11465,5503,5962
Florida,Santa Rosa County,14,9751,4724,5027
Florida,Santa Rosa County,15,7758,3740,4018
Florida,Santa Rosa County,16,5329,2425,2904
Florida,Santa Rosa County,17,3274,1515,1759
Florida,Santa Rosa County,18,2533,1015,1518
Florida,Sarasota County,0,426718,203342,223376
Florida,Sarasota County,1,15073,7650,7423
Florida,Sarasota County,2,16178,8347,7831
Florida,Sarasota County,3,18121,9357,8764
Florida,Sarasota County,4,18241,9383,8858
Florida,Sarasota County,5,17075,8641,8434
Florida,Sarasota County,6,18619,9591,9028
Florida,Sarasota County,7,17134,8566,8568
Florida,Sarasota County,8,17858,8815,9043
Florida,Sarasota County,9,17961,8560,9401
Florida,Sarasota County,10,22114,10631,11483
Florida,Sarasota County,11,25182,11854,13328
Florida,Sarasota County,12,31495,14479,17016
Florida,Sarasota County,13,35158,15833,19325
Florida,Sarasota County,14,39228,17636,21592
Florida,Sarasota County,15,39633,18507,21126
Florida,Sarasota County,16,31573,14941,16632
Florida,Sarasota County,17,21868,10281,11587
Florida,Sarasota County,18,24207,10270,13937
Florida,Seminole County,0,467832,226010,241822
Florida,Seminole County,1,24795,12828,11967
Florida,Seminole County,2,26798,13540,13258
Florida,Seminole County,3,29080,14619,14461
Florida,Seminole County,4,27743,13989,13754
Florida,Seminole County,5,28716,14492,14224
Florida,Seminole County,6,34680,17614,17066
Florida,Seminole County,7,33296,16584,16712
Florida,Seminole County,8,33772,16595,17177
Florida,Seminole County,9,31031,14899,16132
Florida,Seminole County,10,32588,15666,16922
Florida,Seminole County,11,31964,15275,16689
Florida,Seminole County,12,32145,15280,16865
Florida,Seminole County,13,28691,13426,15265
Florida,Seminole County,14,23706,10662,13044
Florida,Seminole County,15,19024,8539,10485
Florida,Seminole County,16,12364,5391,6973
Florida,Seminole County,17,8004,3238,4766
Florida,Seminole County,18,9435,3373,6062
Florida,Sumter County,0,128754,64194,64560
Florida,Sumter County,1,2523,1310,1213
Florida,Sumter County,2,2509,1256,1253
Florida,Sumter County,3,2627,1323,1304
Florida,Sumter County,4,2295,1217,1078
Florida,Sumter County,5,3076,1765,1311
Florida,Sumter County,6,3631,2222,1409
Florida,Sumter County,7,3892,2595,1297
Florida,Sumter County,8,3956,2639,1317
Florida,Sumter County,9,3613,2210,1403
Florida,Sumter County,10,4037,2381,1656
Florida,Sumter County,11,4551,2364,2187
Florida,Sumter County,12,6533,2959,3574
Florida,Sumter County,13,11365,4543,6822
Florida,Sumter County,14,19461,8365,11096
Florida,Sumter County,15,23106,11007,12099
Florida,Sumter County,16,17230,8673,8557
Florida,Sumter County,17,8775,4615,4160
Florida,Sumter County,18,5574,2750,2824
Florida,Suwannee County,0,44191,22743,21448
Florida,Suwannee County,1,2383,1195,1188
Florida,Suwannee County,2,2644,1347,1297
Florida,Suwannee County,3,2742,1405,1337
Florida,Suwannee County,4,2519,1330,1189
Florida,Suwannee County,5,2417,1410,1007
Florida,Suwannee County,6,2833,1693,1140
Florida,Suwannee County,7,2664,1501,1163
Florida,Suwannee County,8,2532,1378,1154
Florida,Suwannee County,9,2286,1229,1057
Florida,Suwannee County,10,2646,1376,1270
Florida,Suwannee County,11,2822,1437,1385
Florida,Suwannee County,12,3075,1505,1570
Florida,Suwannee County,13,3186,1506,1680
Florida,Suwannee County,14,2851,1373,1478
Florida,Suwannee County,15,2417,1188,1229
Florida,Suwannee County,16,1828,880,948
Florida,Suwannee County,17,1189,561,628
Florida,Suwannee County,18,1157,429,728
Florida,Taylor County,0,21623,11798,9825
Florida,Taylor County,1,1228,624,604
Florida,Taylor County,2,1272,674,598
Florida,Taylor County,3,1187,593,594
Florida,Taylor County,4,1032,548,484
Florida,Taylor County,5,1199,724,475
Florida,Taylor County,6,1709,1100,609
Florida,Taylor County,7,1453,918,535
Florida,Taylor County,8,1269,774,495
Florida,Taylor County,9,1252,765,487
Florida,Taylor County,10,1329,775,554
Florida,Taylor County,11,1375,750,625
Florida,Taylor County,12,1414,740,674
Florida,Taylor County,13,1484,728,756
Florida,Taylor County,14,1366,686,680
Florida,Taylor County,15,1227,579,648
Florida,Taylor County,16,830,381,449
Florida,Taylor County,17,568,259,309
Florida,Taylor County,18,429,180,249
Florida,Union County,0,14940,9623,5317
Florida,Union County,1,785,414,371
Florida,Union County,2,793,394,399
Florida,Union County,3,862,434,428
Florida,Union County,4,806,457,349
Florida,Union County,5,970,689,281
Florida,Union County,6,1170,854,316
Florida,Union County,7,1107,791,316
Florida,Union County,8,1025,708,317
Florida,Union County,9,957,670,287
Florida,Union County,10,991,695,296
Florida,Union County,11,1060,764,296
Florida,Union County,12,1206,877,329
Florida,Union County,13,971,682,289
Florida,Union County,14,719,442,277
Florida,Union County,15,653,342,311
Florida,Union County,16,384,181,203
Florida,Union County,17,318,155,163
Florida,Union County,18,163,74,89
Florida,Volusia County,0,547538,267217,280321
Florida,Volusia County,1,25929,13188,12741
Florida,Volusia County,2,26609,13566,13043
Florida,Volusia County,3,27464,14063,13401
Florida,Volusia County,4,29836,15648,14188
Florida,Volusia County,5,31342,16102,15240
Florida,Volusia County,6,33998,17423,16575
Florida,Volusia County,7,30393,15546,14847
Florida,Volusia County,8,29072,14567,14505
Florida,Volusia County,9,27996,13847,14149
Florida,Volusia County,10,31905,15828,16077
Florida,Volusia County,11,35406,16923,18483
Florida,Volusia County,12,41852,19790,22062
Florida,Volusia County,13,42003,19611,22392
Florida,Volusia County,14,40141,18832,21309
Florida,Volusia County,15,34873,16573,18300
Florida,Volusia County,16,25082,11739,13343
Florida,Volusia County,17,16658,7313,9345
Florida,Volusia County,18,16979,6658,10321
Florida,Wakulla County,0,32461,17327,15134
Florida,Wakulla County,1,1803,897,906
Florida,Wakulla County,2,1821,945,876
Florida,Wakulla County,3,2088,1102,986
Florida,Wakulla County,4,1914,1004,910
Florida,Wakulla County,5,1583,902,681
Florida,Wakulla County,6,2179,1253,926
Florida,Wakulla County,7,2276,1333,943
Florida,Wakulla County,8,2283,1316,967
Florida,Wakulla County,9,2155,1182,973
Florida,Wakulla County,10,2452,1422,1030
Florida,Wakulla County,11,2317,1256,1061
Florida,Wakulla County,12,2316,1188,1128
Florida,Wakulla County,13,2188,1047,1141
Florida,Wakulla County,14,1797,891,906
Florida,Wakulla County,15,1494,759,735
Florida,Wakulla County,16,906,446,460
Florida,Wakulla County,17,487,231,256
Florida,Wakulla County,18,402,153,249
Florida,Walton County,0,71375,36080,35295
Florida,Walton County,1,4098,2076,2022
Florida,Walton County,2,3989,2007,1982
Florida,Walton County,3,4054,2054,2000
Florida,Walton County,4,3439,1759,1680
Florida,Walton County,5,3045,1695,1350
Florida,Walton County,6,4246,2326,1920
Florida,Walton County,7,4372,2284,2088
Florida,Walton County,8,4567,2427,2140
Florida,Walton County,9,4164,2219,1945
Florida,Walton County,10,4498,2351,2147
Florida,Walton County,11,5023,2454,2569
Florida,Walton County,12,5675,2746,2929
Florida,Walton County,13,5528,2678,2850
Florida,Walton County,14,5011,2429,2582
Florida,Walton County,15,4170,2055,2115
Florida,Walton County,16,2630,1271,1359
Florida,Walton County,17,1526,687,839
Florida,Walton County,18,1340,562,778
Florida,Washington County,0,24880,13350,11530
Florida,Washington County,1,1275,631,644
Florida,Washington County,2,1328,666,662
Florida,Washington County,3,1486,732,754
Florida,Washington County,4,1362,748,614
Florida,Washington County,5,1618,976,642
Florida,Washington County,6,1833,1119,714
Florida,Washington County,7,1657,1002,655
Florida,Washington County,8,1504,900,604
Florida,Washington County,9,1598,926,672
Florida,Washington County,10,1714,947,767
Florida,Washington County,11,1739,959,780
Florida,Washington County,12,1815,926,889
Florida,Washington County,13,1588,789,799
Florida,Washington County,14,1406,669,737
Florida,Washington County,15,1200,561,639
Florida,Washington County,16,885,399,486
Florida,Washington County,17,503,241,262
Florida,Washington County,18,369,159,210
Georgia,Appling County,0,18507,9240,9267
Georgia,Appling County,1,1255,648,607
Georgia,Appling County,2,1279,650,629
Georgia,Appling County,3,1302,642,660
Georgia,Appling County,4,1159,605,554
Georgia,Appling County,5,1105,621,484
Georgia,Appling County,6,1160,608,552
Georgia,Appling County,7,1037,527,510
Georgia,Appling County,8,1108,567,541
Georgia,Appling County,9,1098,521,577
Georgia,Appling County,10,1134,571,563
Georgia,Appling County,11,1178,595,583
Georgia,Appling County,12,1255,647,608
Georgia,Appling County,13,1248,582,666
Georgia,Appling County,14,1038,510,528
Georgia,Appling County,15,858,434,424
Georgia,Appling County,16,587,256,331
Georgia,Appling County,17,379,151,228
Georgia,Appling County,18,327,105,222
Georgia,Atkinson County,0,8297,4188,4109
Georgia,Atkinson County,1,598,293,305
Georgia,Atkinson County,2,604,307,297
Georgia,Atkinson County,3,605,311,294
Georgia,Atkinson County,4,574,290,284
Georgia,Atkinson County,5,549,276,273
Georgia,Atkinson County,6,581,309,272
Georgia,Atkinson County,7,513,265,248
Georgia,Atkinson County,8,495,234,261
Georgia,Atkinson County,9,531,277,254
Georgia,Atkinson County,10,554,289,265
Georgia,Atkinson County,11,517,278,239
Georgia,Atkinson County,12,540,259,281
Georgia,Atkinson County,13,469,235,234
Georgia,Atkinson County,14,403,193,210
Georgia,Atkinson County,15,305,152,153
Georgia,Atkinson County,16,241,113,128
Georgia,Atkinson County,17,130,65,65
Georgia,Atkinson County,18,88,42,46
Georgia,Bacon County,0,11185,5468,5717
Georgia,Bacon County,1,732,366,366
Georgia,Bacon County,2,784,376,408
Georgia,Bacon County,3,843,428,415
Georgia,Bacon County,4,734,369,365
Georgia,Bacon County,5,700,380,320
Georgia,Bacon County,6,723,371,352
Georgia,Bacon County,7,661,334,327
Georgia,Bacon County,8,677,315,362
Georgia,Bacon County,9,777,392,385
Georgia,Bacon County,10,713,382,331
Georgia,Bacon County,11,682,345,337
Georgia,Bacon County,12,637,301,336
Georgia,Bacon County,13,728,337,391
Georgia,Bacon County,14,636,290,346
Georgia,Bacon County,15,464,224,240
Georgia,Bacon County,16,311,134,177
Georgia,Bacon County,17,228,84,144
Georgia,Bacon County,18,155,40,115
Georgia,Baker County,0,3092,1529,1563
Georgia,Baker County,1,164,91,73
Georgia,Baker County,2,145,68,77
Georgia,Baker County,3,177,84,93
Georgia,Baker County,4,169,83,86
Georgia,Baker County,5,177,91,86
Georgia,Baker County,6,182,101,81
Georgia,Baker County,7,158,80,78
Georgia,Baker County,8,151,66,85
Georgia,Baker County,9,156,78,78
Georgia,Baker County,10,196,104,92
Georgia,Baker County,11,207,105,102
Georgia,Baker County,12,265,124,141
Georgia,Baker County,13,249,130,119
Georgia,Baker County,14,244,119,125
Georgia,Baker County,15,168,81,87
Georgia,Baker County,16,115,51,64
Georgia,Baker County,17,72,33,39
Georgia,Baker County,18,97,40,57
Georgia,Baldwin County,0,44823,22742,22081
Georgia,Baldwin County,1,2125,1087,1038
Georgia,Baldwin County,2,2320,1159,1161
Georgia,Baldwin County,3,2544,1333,1211
Georgia,Baldwin County,4,4238,1968,2270
Georgia,Baldwin County,5,5416,2783,2633
Georgia,Baldwin County,6,2917,1549,1368
Georgia,Baldwin County,7,2383,1258,1125
Georgia,Baldwin County,8,2490,1310,1180
Georgia,Baldwin County,9,2265,1201,1064
Georgia,Baldwin County,10,2465,1340,1125
Georgia,Baldwin County,11,2725,1453,1272
Georgia,Baldwin County,12,2947,1486,1461
Georgia,Baldwin County,13,2811,1453,1358
Georgia,Baldwin County,14,2423,1198,1225
Georgia,Baldwin County,15,1924,873,1051
Georgia,Baldwin County,16,1269,584,685
Georgia,Baldwin County,17,826,381,445
Georgia,Baldwin County,18,735,326,409
Georgia,Banks County,0,18988,9645,9343
Georgia,Banks County,1,1119,575,544
Georgia,Banks County,2,1068,530,538
Georgia,Banks County,3,1232,671,561
Georgia,Banks County,4,1274,739,535
Georgia,Banks County,5,1056,540,516
Georgia,Banks County,6,1163,573,590
Georgia,Banks County,7,1087,560,527
Georgia,Banks County,8,1153,551,602
Georgia,Banks County,9,1216,616,600
Georgia,Banks County,10,1315,677,638
Georgia,Banks County,11,1392,725,667
Georgia,Banks County,12,1322,667,655
Georgia,Banks County,13,1270,665,605
Georgia,Banks County,14,1082,521,561
Georgia,Banks County,15,1001,455,546
Georgia,Banks County,16,647,310,337
Georgia,Banks County,17,349,163,186
Georgia,Banks County,18,242,107,135
Georgia,Barrow County,0,80809,39597,41212
Georgia,Barrow County,1,5433,2778,2655
Georgia,Barrow County,2,5903,3001,2902
Georgia,Barrow County,3,6188,3136,3052
Georgia,Barrow County,4,5215,2696,2519
Georgia,Barrow County,5,4695,2345,2350
Georgia,Barrow County,6,5838,2894,2944
Georgia,Barrow County,7,5981,2928,3053
Georgia,Barrow County,8,6053,3056,2997
Georgia,Barrow County,9,5318,2645,2673
Georgia,Barrow County,10,5603,2781,2822
Georgia,Barrow County,11,5190,2502,2688
Georgia,Barrow County,12,4971,2439,2532
Georgia,Barrow County,13,4363,2050,2313
Georgia,Barrow County,14,3510,1685,1825
Georgia,Barrow County,15,2847,1294,1553
Georgia,Barrow County,16,1757,698,1059
Georgia,Barrow County,17,1001,365,636
Georgia,Barrow County,18,943,304,639
Georgia,Bartow County,0,106408,52478,53930
Georgia,Bartow County,1,6886,3511,3375
Georgia,Bartow County,2,6821,3470,3351
Georgia,Bartow County,3,7421,3773,3648
Georgia,Bartow County,4,6957,3652,3305
Georgia,Bartow County,5,6459,3220,3239
Georgia,Bartow County,6,7582,3777,3805
Georgia,Bartow County,7,6903,3395,3508
Georgia,Bartow County,8,6741,3262,3479
Georgia,Bartow County,9,6606,3265,3341
Georgia,Bartow County,10,7577,3813,3764
Georgia,Bartow County,11,7636,3773,3863
Georgia,Bartow County,12,7425,3694,3731
Georgia,Bartow County,13,6478,3197,3281
Georgia,Bartow County,14,5048,2353,2695
Georgia,Bartow County,15,4289,1994,2295
Georgia,Bartow County,16,2659,1201,1458
Georgia,Bartow County,17,1543,643,900
Georgia,Bartow County,18,1377,485,892
Georgia,Ben Hill County,0,16787,7965,8822
Georgia,Ben Hill County,1,1074,523,551
Georgia,Ben Hill County,2,1160,593,567
Georgia,Ben Hill County,3,1230,615,615
Georgia,Ben Hill County,4,1071,564,507
Georgia,Ben Hill County,5,961,452,509
Georgia,Ben Hill County,6,1022,505,517
Georgia,Ben Hill County,7,1022,472,550
Georgia,Ben Hill County,8,993,460,533
Georgia,Ben Hill County,9,940,462,478
Georgia,Ben Hill County,10,1029,506,523
Georgia,Ben Hill County,11,1084,538,546
Georgia,Ben Hill County,12,1094,527,567
Georgia,Ben Hill County,13,1168,555,613
Georgia,Ben Hill County,14,967,424,543
Georgia,Ben Hill County,15,789,328,461
Georgia,Ben Hill County,16,550,215,335
Georgia,Ben Hill County,17,335,126,209
Georgia,Ben Hill County,18,298,100,198
Georgia,Berrien County,0,19252,9454,9798
Georgia,Berrien County,1,1227,640,587
Georgia,Berrien County,2,1175,573,602
Georgia,Berrien County,3,1415,725,690
Georgia,Berrien County,4,1263,643,620
Georgia,Berrien County,5,1041,522,519
Georgia,Berrien County,6,1231,611,620
Georgia,Berrien County,7,1197,603,594
Georgia,Berrien County,8,1103,529,574
Georgia,Berrien County,9,1096,545,551
Georgia,Berrien County,10,1285,655,630
Georgia,Berrien County,11,1310,658,652
Georgia,Berrien County,12,1391,679,712
Georgia,Berrien County,13,1226,576,650
Georgia,Berrien County,14,1006,482,524
Georgia,Berrien County,15,923,438,485
Georgia,Berrien County,16,609,280,329
Georgia,Berrien County,17,396,163,233
Georgia,Berrien County,18,358,132,226
Georgia,Bibb County,0,153095,71847,81248
Georgia,Bibb County,1,10433,5281,5152
Georgia,Bibb County,2,10664,5466,5198
Georgia,Bibb County,3,10294,5283,5011
Georgia,Bibb County,4,10722,5335,5387
Georgia,Bibb County,5,11040,5147,5893
Georgia,Bibb County,6,11410,5433,5977
Georgia,Bibb County,7,9553,4425,5128
Georgia,Bibb County,8,9397,4401,4996
Georgia,Bibb County,9,8310,3905,4405
Georgia,Bibb County,10,9037,4309,4728
Georgia,Bibb County,11,9147,4269,4878
Georgia,Bibb County,12,9833,4528,5305
Georgia,Bibb County,13,9379,4266,5113
Georgia,Bibb County,14,7928,3552,4376
Georgia,Bibb County,15,6074,2639,3435
Georgia,Bibb County,16,4161,1662,2499
Georgia,Bibb County,17,2842,1066,1776
Georgia,Bibb County,18,2871,880,1991
Georgia,Bleckley County,0,12838,6124,6714
Georgia,Bleckley County,1,678,345,333
Georgia,Bleckley County,2,723,407,316
Georgia,Bleckley County,3,713,364,349
Georgia,Bleckley County,4,1337,650,687
Georgia,Bleckley County,5,1024,498,526
Georgia,Bleckley County,6,829,399,430
Georgia,Bleckley County,7,681,308,373
Georgia,Bleckley County,8,705,317,388
Georgia,Bleckley County,9,673,314,359
Georgia,Bleckley County,10,791,384,407
Georgia,Bleckley County,11,847,416,431
Georgia,Bleckley County,12,895,429,466
Georgia,Bleckley County,13,779,370,409
Georgia,Bleckley County,14,571,274,297
Georgia,Bleckley County,15,575,256,319
Georgia,Bleckley County,16,405,174,231
Georgia,Bleckley County,17,306,118,188
Georgia,Bleckley County,18,306,101,205
Georgia,Brantley County,0,18897,9312,9585
Georgia,Brantley County,1,1146,584,562
Georgia,Brantley County,2,1213,634,579
Georgia,Brantley County,3,1293,667,626
Georgia,Brantley County,4,1216,629,587
Georgia,Brantley County,5,1110,602,508
Georgia,Brantley County,6,1200,586,614
Georgia,Brantley County,7,1113,561,552
Georgia,Brantley County,8,1056,496,560
Georgia,Brantley County,9,1138,564,574
Georgia,Brantley County,10,1354,642,712
Georgia,Brantley County,11,1356,662,694
Georgia,Brantley County,12,1365,673,692
Georgia,Brantley County,13,1197,583,614
Georgia,Brantley County,14,1097,532,565
Georgia,Brantley County,15,849,391,458
Georgia,Brantley County,16,533,241,292
Georgia,Brantley County,17,388,160,228
Georgia,Brantley County,18,273,105,168
Georgia,Brooks County,0,15513,7569,7944
Georgia,Brooks County,1,920,468,452
Georgia,Brooks County,2,955,498,457
Georgia,Brooks County,3,942,474,468
Georgia,Brooks County,4,862,480,382
Georgia,Brooks County,5,817,399,418
Georgia,Brooks County,6,925,479,446
Georgia,Brooks County,7,905,452,453
Georgia,Brooks County,8,820,422,398
Georgia,Brooks County,9,822,408,414
Georgia,Brooks County,10,997,484,513
Georgia,Brooks County,11,1086,517,569
Georgia,Brooks County,12,1253,585,668
Georgia,Brooks County,13,1133,539,594
Georgia,Brooks County,14,993,434,559
Georgia,Brooks County,15,889,419,470
Georgia,Brooks County,16,572,260,312
Georgia,Brooks County,17,374,148,226
Georgia,Brooks County,18,248,103,145
Georgia,Bryan County,0,38109,18795,19314
Georgia,Bryan County,1,2853,1486,1367
Georgia,Bryan County,2,3165,1611,1554
Georgia,Bryan County,3,3237,1644,1593
Georgia,Bryan County,4,2829,1478,1351
Georgia,Bryan County,5,1934,994,940
Georgia,Bryan County,6,2484,1248,1236
Georgia,Bryan County,7,2915,1387,1528
Georgia,Bryan County,8,3199,1553,1646
Georgia,Bryan County,9,2764,1378,1386
Georgia,Bryan County,10,2558,1242,1316
Georgia,Bryan County,11,2205,1084,1121
Georgia,Bryan County,12,2143,1039,1104
Georgia,Bryan County,13,1773,818,955
Georgia,Bryan County,14,1474,687,787
Georgia,Bryan County,15,1099,515,584
Georgia,Bryan County,16,675,321,354
Georgia,Bryan County,17,428,178,250
Georgia,Bryan County,18,374,132,242
Georgia,Bulloch County,0,77296,37919,39377
Georgia,Bulloch County,1,4466,2211,2255
Georgia,Bulloch County,2,4191,2058,2133
Georgia,Bulloch County,3,4316,2182,2134
Georgia,Bulloch County,4,8318,4289,4029
Georgia,Bulloch County,5,12319,6204,6115
Georgia,Bulloch County,6,5877,3077,2800
Georgia,Bulloch County,7,4985,2466,2519
Georgia,Bulloch County,8,4323,2102,2221
Georgia,Bulloch County,9,3869,1825,2044
Georgia,Bulloch County,10,4028,1942,2086
Georgia,Bulloch County,11,3844,1897,1947
Georgia,Bulloch County,12,4060,1885,2175
Georgia,Bulloch County,13,3840,1826,2014
Georgia,Bulloch County,14,3075,1452,1623
Georgia,Bulloch County,15,2362,1085,1277
Georgia,Bulloch County,16,1595,714,881
Georgia,Bulloch County,17,991,395,596
Georgia,Bulloch County,18,837,309,528
Georgia,Burke County,0,22423,10682,11741
Georgia,Burke County,1,1565,760,805
Georgia,Burke County,2,1559,796,763
Georgia,Burke County,3,1682,865,817
Georgia,Burke County,4,1552,798,754
Georgia,Burke County,5,1298,658,640
Georgia,Burke County,6,1435,714,721
Georgia,Burke County,7,1284,580,704
Georgia,Burke County,8,1315,615,700
Georgia,Burke County,9,1261,621,640
Georgia,Burke County,10,1379,638,741
Georgia,Burke County,11,1401,630,771
Georgia,Burke County,12,1642,760,882
Georgia,Burke County,13,1553,738,815
Georgia,Burke County,14,1262,575,687
Georgia,Burke County,15,930,441,489
Georgia,Burke County,16,603,244,359
Georgia,Burke County,17,378,134,244
Georgia,Burke County,18,324,115,209
Georgia,Butts County,0,24193,12774,11419
Georgia,Butts County,1,1401,721,680
Georgia,Butts County,2,1410,693,717
Georgia,Butts County,3,1390,659,731
Georgia,Butts County,4,1388,749,639
Georgia,Butts County,5,1723,1082,641
Georgia,Butts County,6,1885,1137,748
Georgia,Butts County,7,1604,972,632
Georgia,Butts County,8,1645,949,696
Georgia,Butts County,9,1526,893,633
Georgia,Butts County,10,1659,900,759
Georgia,Butts County,11,1661,891,770
Georgia,Butts County,12,1704,841,863
Georgia,Butts County,13,1435,688,747
Georgia,Butts County,14,1263,590,673
Georgia,Butts County,15,1023,425,598
Georgia,Butts County,16,703,325,378
Georgia,Butts County,17,376,162,214
Georgia,Butts County,18,397,97,300
Georgia,Calhoun County,0,6352,3830,2522
Georgia,Calhoun County,1,245,111,134
Georgia,Calhoun County,2,316,171,145
Georgia,Calhoun County,3,336,180,156
Georgia,Calhoun County,4,337,173,164
Georgia,Calhoun County,5,441,309,132
Georgia,Calhoun County,6,498,359,139
Georgia,Calhoun County,7,467,347,120
Georgia,Calhoun County,8,522,368,154
Georgia,Calhoun County,9,492,342,150
Georgia,Calhoun County,10,477,323,154
Georgia,Calhoun County,11,407,270,137
Georgia,Calhoun County,12,423,239,184
Georgia,Calhoun County,13,396,201,195
Georgia,Calhoun County,14,295,167,128
Georgia,Calhoun County,15,254,111,143
Georgia,Calhoun County,16,168,82,86
Georgia,Calhoun County,17,122,53,69
Georgia,Calhoun County,18,156,24,132
Georgia,Camden County,0,53677,27469,26208
Georgia,Camden County,1,3845,1973,1872
Georgia,Camden County,2,3784,1946,1838
Georgia,Camden County,3,3507,1796,1711
Georgia,Camden County,4,3302,1813,1489
Georgia,Camden County,5,4951,3149,1802
Georgia,Camden County,6,4759,2539,2220
Georgia,Camden County,7,3985,2089,1896
Georgia,Camden County,8,3360,1721,1639
Georgia,Camden County,9,2706,1288,1418
Georgia,Camden County,10,2909,1401,1508
Georgia,Camden County,11,2994,1426,1568
Georgia,Camden County,12,3359,1562,1797
Georgia,Camden County,13,2897,1382,1515
Georgia,Camden County,14,2475,1160,1315
Georgia,Camden County,15,2175,1049,1126
Georgia,Camden County,16,1354,602,752
Georgia,Camden County,17,765,350,415
Georgia,Camden County,18,550,223,327
Georgia,Candler County,0,10836,5313,5523
Georgia,Candler County,1,672,355,317
Georgia,Candler County,2,744,371,373
Georgia,Candler County,3,848,436,412
Georgia,Candler County,4,692,360,332
Georgia,Candler County,5,609,295,314
Georgia,Candler County,6,685,317,368
Georgia,Candler County,7,623,308,315
Georgia,Candler County,8,616,330,286
Georgia,Candler County,9,618,294,324
Georgia,Candler County,10,686,337,349
Georgia,Candler County,11,674,313,361
Georgia,Candler County,12,730,354,376
Georgia,Candler County,13,687,333,354
Georgia,Candler County,14,642,341,301
Georgia,Candler County,15,570,256,314
Georgia,Candler County,16,371,186,185
Georgia,Candler County,17,195,73,122
Georgia,Candler County,18,174,54,120
Georgia,Carroll County,0,118121,57613,60508
Georgia,Carroll County,1,7583,3954,3629
Georgia,Carroll County,2,7507,3854,3653
Georgia,Carroll County,3,8000,4154,3846
Georgia,Carroll County,4,9464,4650,4814
Georgia,Carroll County,5,10430,5104,5326
Georgia,Carroll County,6,8674,4218,4456
Georgia,Carroll County,7,7353,3625,3728
Georgia,Carroll County,8,7404,3645,3759
Georgia,Carroll County,9,6970,3454,3516
Georgia,Carroll County,10,7647,3666,3981
Georgia,Carroll County,11,7228,3600,3628
Georgia,Carroll County,12,7258,3534,3724
Georgia,Carroll County,13,6523,3112,3411
Georgia,Carroll County,14,5444,2482,2962
Georgia,Carroll County,15,4323,1976,2347
Georgia,Carroll County,16,3011,1344,1667
Georgia,Carroll County,17,1841,794,1047
Georgia,Carroll County,18,1461,447,1014
Georgia,Catoosa County,0,67420,32610,34810
Georgia,Catoosa County,1,3715,1893,1822
Georgia,Catoosa County,2,4126,2128,1998
Georgia,Catoosa County,3,4712,2447,2265
Georgia,Catoosa County,4,4436,2367,2069
Georgia,Catoosa County,5,3662,1910,1752
Georgia,Catoosa County,6,4151,2044,2107
Georgia,Catoosa County,7,4030,1938,2092
Georgia,Catoosa County,8,4120,1971,2149
Georgia,Catoosa County,9,4370,2110,2260
Georgia,Catoosa County,10,4791,2305,2486
Georgia,Catoosa County,11,4597,2250,2347
Georgia,Catoosa County,12,4534,2145,2389
Georgia,Catoosa County,13,4222,1995,2227
Georgia,Catoosa County,14,3784,1700,2084
Georgia,Catoosa County,15,3163,1430,1733
Georgia,Catoosa County,16,2295,952,1343
Georgia,Catoosa County,17,1511,606,905
Georgia,Catoosa County,18,1201,419,782
Georgia,Charlton County,0,12968,7436,5532
Georgia,Charlton County,1,664,290,374
Georgia,Charlton County,2,724,353,371
Georgia,Charlton County,3,722,386,336
Georgia,Charlton County,4,674,380,294
Georgia,Charlton County,5,938,588,350
Georgia,Charlton County,6,1121,762,359
Georgia,Charlton County,7,980,660,320
Georgia,Charlton County,8,868,604,264
Georgia,Charlton County,9,813,542,271
Georgia,Charlton County,10,886,517,369
Georgia,Charlton County,11,857,508,349
Georgia,Charlton County,12,904,452,452
Georgia,Charlton County,13,745,399,346
Georgia,Charlton County,14,610,309,301
Georgia,Charlton County,15,565,285,280
Georgia,Charlton County,16,415,201,214
Georgia,Charlton County,17,254,105,149
Georgia,Charlton County,18,228,95,133
Georgia,Chatham County,0,289195,138978,150217
Georgia,Chatham County,1,18249,9256,8993
Georgia,Chatham County,2,16684,8551,8133
Georgia,Chatham County,3,16782,8539,8243
Georgia,Chatham County,4,18940,9173,9767
Georgia,Chatham County,5,22480,11269,11211
Georgia,Chatham County,6,25216,12608,12608
Georgia,Chatham County,7,22106,10996,11110
Georgia,Chatham County,8,19491,9522,9969
Georgia,Chatham County,9,16397,7877,8520
Georgia,Chatham County,10,16525,7916,8609
Georgia,Chatham County,11,16799,8024,8775
Georgia,Chatham County,12,17980,8286,9694
Georgia,Chatham County,13,17068,7779,9289
Georgia,Chatham County,14,14799,6597,8202
Georgia,Chatham County,15,11785,5286,6499
Georgia,Chatham County,16,7765,3438,4327
Georgia,Chatham County,17,4890,2067,2823
Georgia,Chatham County,18,5239,1794,3445
Georgia,Chattahoochee County,0,10684,6843,3841
Georgia,Chattahoochee County,1,898,468,430
Georgia,Chattahoochee County,2,711,378,333
Georgia,Chattahoochee County,3,500,256,244
Georgia,Chattahoochee County,4,818,649,169
Georgia,Chattahoochee County,5,2334,1896,438
Georgia,Chattahoochee County,6,1680,1135,545
Georgia,Chattahoochee County,7,1006,625,381
Georgia,Chattahoochee County,8,649,368,281
Georgia,Chattahoochee County,9,471,276,195
Georgia,Chattahoochee County,10,312,167,145
Georgia,Chattahoochee County,11,343,167,176
Georgia,Chattahoochee County,12,225,120,105
Georgia,Chattahoochee County,13,221,103,118
Georgia,Chattahoochee County,14,147,71,76
Georgia,Chattahoochee County,15,129,45,84
Georgia,Chattahoochee County,16,106,56,50
Georgia,Chattahoochee County,17,75,43,32
Georgia,Chattahoochee County,18,59,20,39
Georgia,Chattooga County,0,24790,12680,12110
Georgia,Chattooga County,1,1485,775,710
Georgia,Chattooga County,2,1483,756,727
Georgia,Chattooga County,3,1611,820,791
Georgia,Chattooga County,4,1537,823,714
Georgia,Chattooga County,5,1487,837,650
Georgia,Chattooga County,6,1688,967,721
Georgia,Chattooga County,7,1454,777,677
Georgia,Chattooga County,8,1538,812,726
Georgia,Chattooga County,9,1479,821,658
Georgia,Chattooga County,10,1668,859,809
Georgia,Chattooga County,11,1634,845,789
Georgia,Chattooga County,12,1679,794,885
Georgia,Chattooga County,13,1693,854,839
Georgia,Chattooga County,14,1396,665,731
Georgia,Chattooga County,15,1116,527,589
Georgia,Chattooga County,16,819,367,452
Georgia,Chattooga County,17,505,219,286
Georgia,Chattooga County,18,518,162,356
Georgia,Cherokee County,0,254149,125168,128981
Georgia,Cherokee County,1,15017,7633,7384
Georgia,Cherokee County,2,16767,8685,8082
Georgia,Cherokee County,3,18819,9782,9037
Georgia,Cherokee County,4,17647,8993,8654
Georgia,Cherokee County,5,14293,7188,7105
Georgia,Cherokee County,6,14900,7460,7440
Georgia,Cherokee County,7,15688,7728,7960
Georgia,Cherokee County,8,17098,8356,8742
Georgia,Cherokee County,9,17924,8818,9106
Georgia,Cherokee County,10,19871,9830,10041
Georgia,Cherokee County,11,18432,9086,9346
Georgia,Cherokee County,12,17451,8575,8876
Georgia,Cherokee County,13,14862,7198,7664
Georgia,Cherokee County,14,12469,5667,6802
Georgia,Cherokee County,15,10538,4823,5715
Georgia,Cherokee County,16,6250,2912,3338
Georgia,Cherokee County,17,3417,1513,1904
Georgia,Cherokee County,18,2706,921,1785
Georgia,Clarke County,0,127330,60322,67008
Georgia,Clarke County,1,6662,3372,3290
Georgia,Clarke County,2,6279,3236,3043
Georgia,Clarke County,3,5865,2920,2945
Georgia,Clarke County,4,12317,5483,6834
Georgia,Clarke County,5,23796,11605,12191
Georgia,Clarke County,6,12085,5844,6241
Georgia,Clarke County,7,8907,4308,4599
Georgia,Clarke County,8,8005,4000,4005
Georgia,Clarke County,9,6414,3060,3354
Georgia,Clarke County,10,6081,2902,3179
Georgia,Clarke County,11,5489,2620,2869
Georgia,Clarke County,12,5780,2690,3090
Georgia,Clarke County,13,5691,2494,3197
Georgia,Clarke County,14,4965,2203,2762
Georgia,Clarke County,15,3563,1542,2021
Georgia,Clarke County,16,2402,989,1413
Georgia,Clarke County,17,1442,555,887
Georgia,Clarke County,18,1587,499,1088
Georgia,Clay County,0,2887,1362,1525
Georgia,Clay County,1,149,80,69
Georgia,Clay County,2,157,71,86
Georgia,Clay County,3,177,97,80
Georgia,Clay County,4,160,79,81
Georgia,Clay County,5,116,54,62
Georgia,Clay County,6,163,85,78
Georgia,Clay County,7,144,60,84
Georgia,Clay County,8,171,81,90
Georgia,Clay County,9,140,71,69
Georgia,Clay County,10,129,58,71
Georgia,Clay County,11,166,75,91
Georgia,Clay County,12,190,89,101
Georgia,Clay County,13,251,116,135
Georgia,Clay County,14,237,108,129
Georgia,Clay County,15,226,106,120
Georgia,Clay County,16,133,73,60
Georgia,Clay County,17,96,34,62
Georgia,Clay County,18,82,25,57
Georgia,Clayton County,0,289615,135554,154061
Georgia,Clayton County,1,21675,10953,10722
Georgia,Clayton County,2,22736,11582,11154
Georgia,Clayton County,3,23183,11763,11420
Georgia,Clayton County,4,21191,10582,10609
Georgia,Clayton County,5,20437,10040,10397
Georgia,Clayton County,6,24682,11572,13110
Georgia,Clayton County,7,20890,9470,11420
Georgia,Clayton County,8,19669,8750,10919
Georgia,Clayton County,9,18272,8104,10168
Georgia,Clayton County,10,19372,8665,10707
Georgia,Clayton County,11,18553,8422,10131
Georgia,Clayton County,12,17316,7798,9518
Georgia,Clayton County,13,14642,6472,8170
Georgia,Clayton County,14,11087,4805,6282
Georgia,Clayton County,15,7325,3189,4136
Georgia,Clayton County,16,4277,1837,2440
Georgia,Clayton County,17,2414,917,1497
Georgia,Clayton County,18,1894,633,1261
Georgia,Clinch County,0,6648,3232,3416
Georgia,Clinch County,1,438,226,212
Georgia,Clinch County,2,487,254,233
Georgia,Clinch County,3,474,243,231
Georgia,Clinch County,4,440,225,215
Georgia,Clinch County,5,412,179,233
Georgia,Clinch County,6,443,233,210
Georgia,Clinch County,7,409,179,230
Georgia,Clinch County,8,393,173,220
Georgia,Clinch County,9,391,197,194
Georgia,Clinch County,10,417,223,194
Georgia,Clinch County,11,448,225,223
Georgia,Clinch County,12,396,184,212
Georgia,Clinch County,13,423,205,218
Georgia,Clinch County,14,360,162,198
Georgia,Clinch County,15,320,165,155
Georgia,Clinch County,16,199,92,107
Georgia,Clinch County,17,118,29,89
Georgia,Clinch County,18,80,38,42
Georgia,Cobb County,0,756865,366600,390265
Georgia,Cobb County,1,46903,23934,22969
Georgia,Cobb County,2,48274,24371,23903
Georgia,Cobb County,3,51880,26117,25763
Georgia,Cobb County,4,50830,25865,24965
Georgia,Cobb County,5,48260,24213,24047
Georgia,Cobb County,6,56710,28157,28553
Georgia,Cobb County,7,54313,27018,27295
Georgia,Cobb County,8,54602,26286,28316
Georgia,Cobb County,9,52275,24812,27463
Georgia,Cobb County,10,55732,26800,28932
Georgia,Cobb County,11,52079,24851,27228
Georgia,Cobb County,12,50305,23929,26376
Georgia,Cobb County,13,41925,19689,22236
Georgia,Cobb County,14,33525,15349,18176
Georgia,Cobb County,15,25446,11421,14025
Georgia,Cobb County,16,15603,6935,8668
Georgia,Cobb County,17,9255,3790,5465
Georgia,Cobb County,18,8948,3063,5885
Georgia,Coffee County,0,43093,22140,20953
Georgia,Coffee County,1,2994,1557,1437
Georgia,Coffee County,2,2899,1464,1435
Georgia,Coffee County,3,2885,1446,1439
Georgia,Coffee County,4,2953,1596,1357
Georgia,Coffee County,5,3018,1648,1370
Georgia,Coffee County,6,3397,1886,1511
Georgia,Coffee County,7,2856,1615,1241
Georgia,Coffee County,8,2918,1560,1358
Georgia,Coffee County,9,2653,1458,1195
Georgia,Coffee County,10,2903,1478,1425
Georgia,Coffee County,11,2739,1456,1283
Georgia,Coffee County,12,2673,1305,1368
Georgia,Coffee County,13,2275,1095,1180
Georgia,Coffee County,14,2077,949,1128
Georgia,Coffee County,15,1647,749,898
Georgia,Coffee County,16,1033,447,586
Georgia,Coffee County,17,624,237,387
Georgia,Coffee County,18,549,194,355
Georgia,Colquitt County,0,45592,22585,23007
Georgia,Colquitt County,1,3069,1551,1518
Georgia,Colquitt County,2,3446,1736,1710
Georgia,Colquitt County,3,3447,1804,1643
Georgia,Colquitt County,4,3049,1671,1378
Georgia,Colquitt County,5,2841,1531,1310
Georgia,Colquitt County,6,3058,1558,1500
Georgia,Colquitt County,7,2859,1447,1412
Georgia,Colquitt County,8,2973,1470,1503
Georgia,Colquitt County,9,2794,1390,1404
Georgia,Colquitt County,10,2859,1435,1424
Georgia,Colquitt County,11,2910,1488,1422
Georgia,Colquitt County,12,2681,1262,1419
Georgia,Colquitt County,13,2552,1183,1369
Georgia,Colquitt County,14,2300,1055,1245
Georgia,Colquitt County,15,1905,883,1022
Georgia,Colquitt County,16,1263,586,677
Georgia,Colquitt County,17,816,325,491
Georgia,Colquitt County,18,770,210,560
Georgia,Columbia County,0,154291,75273,79018
Georgia,Columbia County,1,9767,5010,4757
Georgia,Columbia County,2,10970,5424,5546
Georgia,Columbia County,3,11535,5850,5685
Georgia,Columbia County,4,10380,5372,5008
Georgia,Columbia County,5,8721,4471,4250
Georgia,Columbia County,6,10538,5241,5297
Georgia,Columbia County,7,11109,5446,5663
Georgia,Columbia County,8,11440,5543,5897
Georgia,Columbia County,9,10109,4889,5220
Georgia,Columbia County,10,10534,5181,5353
Georgia,Columbia County,11,9803,4683,5120
Georgia,Columbia County,12,9774,4674,5100
Georgia,Columbia County,13,8778,4088,4690
Georgia,Columbia County,14,7464,3528,3936
Georgia,Columbia County,15,5544,2656,2888
Georgia,Columbia County,16,3579,1647,1932
Georgia,Columbia County,17,2221,903,1318
Georgia,Columbia County,18,2025,667,1358
Georgia,Cook County,0,17162,8268,8894
Georgia,Cook County,1,1095,587,508
Georgia,Cook County,2,1154,583,571
Georgia,Cook County,3,1309,650,659
Georgia,Cook County,4,1146,595,551
Georgia,Cook County,5,1081,528,553
Georgia,Cook County,6,1046,503,543
Georgia,Cook County,7,1045,496,549
Georgia,Cook County,8,1059,494,565
Georgia,Cook County,9,1022,477,545
Georgia,Cook County,10,1128,545,583
Georgia,Cook County,11,1127,533,594
Georgia,Cook County,12,1109,544,565
Georgia,Cook County,13,1002,465,537
Georgia,Cook County,14,946,446,500
Georgia,Cook County,15,724,372,352
Georgia,Cook County,16,540,216,324
Georgia,Cook County,17,363,155,208
Georgia,Cook County,18,266,79,187
Georgia,Coweta County,0,145864,70983,74881
Georgia,Coweta County,1,8758,4478,4280
Georgia,Coweta County,2,9583,4890,4693
Georgia,Coweta County,3,10779,5343,5436
Georgia,Coweta County,4,10075,5073,5002
Georgia,Coweta County,5,8483,4204,4279
Georgia,Coweta County,6,9021,4483,4538
Georgia,Coweta County,7,9025,4358,4667
Georgia,Coweta County,8,9631,4604,5027
Georgia,Coweta County,9,9573,4576,4997
Georgia,Coweta County,10,10955,5258,5697
Georgia,Coweta County,11,10998,5472,5526
Georgia,Coweta County,12,10266,4991,5275
Georgia,Coweta County,13,8475,4147,4328
Georgia,Coweta County,14,6874,3210,3664
Georgia,Coweta County,15,5743,2671,3072
Georgia,Coweta County,16,3738,1659,2079
Georgia,Coweta County,17,2208,961,1247
Georgia,Coweta County,18,1679,605,1074
Georgia,Crawford County,0,12318,6214,6104
Georgia,Crawford County,1,599,295,304
Georgia,Crawford County,2,678,341,337
Georgia,Crawford County,3,777,402,375
Georgia,Crawford County,4,707,383,324
Georgia,Crawford County,5,643,381,262
Georgia,Crawford County,6,756,405,351
Georgia,Crawford County,7,715,391,324
Georgia,Crawford County,8,664,329,335
Georgia,Crawford County,9,668,320,348
Georgia,Crawford County,10,812,423,389
Georgia,Crawford County,11,929,470,459
Georgia,Crawford County,12,1117,552,565
Georgia,Crawford County,13,937,471,466
Georgia,Crawford County,14,801,381,420
Georgia,Crawford County,15,687,310,377
Georgia,Crawford County,16,424,199,225
Georgia,Crawford County,17,248,105,143
Georgia,Crawford County,18,156,56,100
Georgia,Crisp County,0,22601,10687,11914
Georgia,Crisp County,1,1428,696,732
Georgia,Crisp County,2,1463,748,715
Georgia,Crisp County,3,1626,819,807
Georgia,Crisp County,4,1432,750,682
Georgia,Crisp County,5,1286,624,662
Georgia,Crisp County,6,1403,666,737
Georgia,Crisp County,7,1238,614,624
Georgia,Crisp County,8,1384,637,747
Georgia,Crisp County,9,1269,533,736
Georgia,Crisp County,10,1315,613,702
Georgia,Crisp County,11,1437,673,764
Georgia,Crisp County,12,1538,731,807
Georgia,Crisp County,13,1565,723,842
Georgia,Crisp County,14,1379,644,735
Georgia,Crisp County,15,1111,529,582
Georgia,Crisp County,16,675,315,360
Georgia,Crisp County,17,532,200,332
Georgia,Crisp County,18,520,172,348
Georgia,Dade County,0,16226,7971,8255
Georgia,Dade County,1,794,430,364
Georgia,Dade County,2,871,424,447
Georgia,Dade County,3,913,452,461
Georgia,Dade County,4,1161,586,575
Georgia,Dade County,5,1327,674,653
Georgia,Dade County,6,966,492,474
Georgia,Dade County,7,862,422,440
Georgia,Dade County,8,859,431,428
Georgia,Dade County,9,957,495,462
Georgia,Dade County,10,1020,505,515
Georgia,Dade County,11,1024,517,507
Georgia,Dade County,12,1139,535,604
Georgia,Dade County,13,1201,589,612
Georgia,Dade County,14,1037,485,552
Georgia,Dade County,15,804,358,446
Georgia,Dade County,16,602,293,309
Georgia,Dade County,17,373,165,208
Georgia,Dade County,18,316,118,198
Georgia,Dawson County,0,25083,12400,12683
Georgia,Dawson County,1,1355,676,679
Georgia,Dawson County,2,1321,691,630
Georgia,Dawson County,3,1568,810,758
Georgia,Dawson County,4,1456,745,711
Georgia,Dawson County,5,1368,706,662
Georgia,Dawson County,6,1528,768,760
Georgia,Dawson County,7,1476,715,761
Georgia,Dawson County,8,1369,665,704
Georgia,Dawson County,9,1437,736,701
Georgia,Dawson County,10,1764,895,869
Georgia,Dawson County,11,1812,880,932
Georgia,Dawson County,12,1840,904,936
Georgia,Dawson County,13,1744,826,918
Georgia,Dawson County,14,1681,778,903
Georgia,Dawson County,15,1522,750,772
Georgia,Dawson County,16,992,476,516
Georgia,Dawson County,17,514,236,278
Georgia,Dawson County,18,336,143,193
Georgia,Decatur County,0,26575,12857,13718
Georgia,Decatur County,1,1831,912,919
Georgia,Decatur County,2,1766,876,890
Georgia,Decatur County,3,1772,896,876
Georgia,Decatur County,4,1828,965,863
Georgia,Decatur County,5,1713,888,825
Georgia,Decatur County,6,1833,929,904
Georgia,Decatur County,7,1496,707,789
Georgia,Decatur County,8,1585,764,821
Georgia,Decatur County,9,1543,774,769
Georgia,Decatur County,10,1720,830,890
Georgia,Decatur County,11,1713,844,869
Georgia,Decatur County,12,1778,876,902
Georgia,Decatur County,13,1690,778,912
Georgia,Decatur County,14,1295,579,716
Georgia,Decatur County,15,1155,542,613
Georgia,Decatur County,16,789,328,461
Georgia,Decatur County,17,576,224,352
Georgia,Decatur County,18,492,145,347
Georgia,DeKalb County,0,756558,357770,398788
Georgia,DeKalb County,1,52440,26495,25945
Georgia,DeKalb County,2,49172,25174,23998
Georgia,DeKalb County,3,46717,23777,22940
Georgia,DeKalb County,4,43799,21898,21901
Georgia,DeKalb County,5,46519,22039,24480
Georgia,DeKalb County,6,65657,31551,34106
Georgia,DeKalb County,7,61899,29811,32088
Georgia,DeKalb County,8,57821,27473,30348
Georgia,DeKalb County,9,50220,23823,26397
Georgia,DeKalb County,10,51125,24324,26801
Georgia,DeKalb County,11,48063,22679,25384
Georgia,DeKalb County,12,47307,21703,25604
Georgia,DeKalb County,13,41699,18387,23312
Georgia,DeKalb County,14,34860,14958,19902
Georgia,DeKalb County,15,24210,10290,13920
Georgia,DeKalb County,16,15107,6385,8722
Georgia,DeKalb County,17,9622,3662,5960
Georgia,DeKalb County,18,10321,3341,6980
Georgia,Dodge County,0,20705,10787,9918
Georgia,Dodge County,1,1012,519,493
Georgia,Dodge County,2,1149,565,584
Georgia,Dodge County,3,1146,569,577
Georgia,Dodge County,4,1223,717,506
Georgia,Dodge County,5,1193,684,509
Georgia,Dodge County,6,1513,860,653
Georgia,Dodge County,7,1228,726,502
Georgia,Dodge County,8,1314,715,599
Georgia,Dodge County,9,1292,733,559
Georgia,Dodge County,10,1570,829,741
Georgia,Dodge County,11,1488,791,697
Georgia,Dodge County,12,1447,751,696
Georgia,Dodge County,13,1393,686,707
Georgia,Dodge County,14,1176,567,609
Georgia,Dodge County,15,989,464,525
Georgia,Dodge County,16,671,287,384
Georgia,Dodge County,17,508,194,314
Georgia,Dodge County,18,393,130,263
Georgia,Dooly County,0,13706,7451,6255
Georgia,Dooly County,1,521,276,245
Georgia,Dooly County,2,637,315,322
Georgia,Dooly County,3,745,367,378
Georgia,Dooly County,4,727,350,377
Georgia,Dooly County,5,782,489,293
Georgia,Dooly County,6,951,618,333
Georgia,Dooly County,7,775,512,263
Georgia,Dooly County,8,935,556,379
Georgia,Dooly County,9,883,537,346
Georgia,Dooly County,10,956,564,392
Georgia,Dooly County,11,956,535,421
Georgia,Dooly County,12,1016,502,514
Georgia,Dooly County,13,1064,549,515
Georgia,Dooly County,14,890,425,465
Georgia,Dooly County,15,698,352,346
Georgia,Dooly County,16,562,269,293
Georgia,Dooly County,17,324,134,190
Georgia,Dooly County,18,284,101,183
Georgia,Dougherty County,0,91243,41868,49375
Georgia,Dougherty County,1,5850,3023,2827
Georgia,Dougherty County,2,6036,3086,2950
Georgia,Dougherty County,3,5842,2980,2862
Georgia,Dougherty County,4,8296,3759,4537
Georgia,Dougherty County,5,7994,3682,4312
Georgia,Dougherty County,6,6672,3134,3538
Georgia,Dougherty County,7,5332,2457,2875
Georgia,Dougherty County,8,5346,2427,2919
Georgia,Dougherty County,9,4828,2123,2705
Georgia,Dougherty County,10,5009,2361,2648
Georgia,Dougherty County,11,5034,2188,2846
Georgia,Dougherty County,12,5492,2425,3067
Georgia,Dougherty County,13,5485,2471,3014
Georgia,Dougherty County,14,4895,2163,2732
Georgia,Dougherty County,15,3450,1488,1962
Georgia,Dougherty County,16,2359,975,1384
Georgia,Dougherty County,17,1613,590,1023
Georgia,Dougherty County,18,1710,536,1174
Georgia,Douglas County,0,145331,69035,76296
Georgia,Douglas County,1,9054,4612,4442
Georgia,Douglas County,2,10107,5154,4953
Georgia,Douglas County,3,11324,5775,5549
Georgia,Douglas County,4,11012,5605,5407
Georgia,Douglas County,5,9606,4741,4865
Georgia,Douglas County,6,9888,4859,5029
Georgia,Douglas County,7,8668,3937,4731
Georgia,Douglas County,8,9729,4356,5373
Georgia,Douglas County,9,10100,4439,5661
Georgia,Douglas County,10,11187,5145,6042
Georgia,Douglas County,11,10486,4907,5579
Georgia,Douglas County,12,9548,4614,4934
Georgia,Douglas County,13,7848,3717,4131
Georgia,Douglas County,14,6123,2670,3453
Georgia,Douglas County,15,4697,2090,2607
Georgia,Douglas County,16,2990,1297,1693
Georgia,Douglas County,17,1631,675,956
Georgia,Douglas County,18,1333,442,891
Georgia,Early County,0,10247,4782,5465
Georgia,Early County,1,653,328,325
Georgia,Early County,2,695,346,349
Georgia,Early County,3,750,376,374
Georgia,Early County,4,692,364,328
Georgia,Early County,5,580,279,301
Georgia,Early County,6,628,295,333
Georgia,Early County,7,518,230,288
Georgia,Early County,8,568,267,301
Georgia,Early County,9,575,265,310
Georgia,Early County,10,628,272,356
Georgia,Early County,11,666,330,336
Georgia,Early County,12,695,307,388
Georgia,Early County,13,651,310,341
Georgia,Early County,14,538,274,264
Georgia,Early County,15,525,211,314
Georgia,Early County,16,399,164,235
Georgia,Early County,17,247,101,146
Georgia,Early County,18,239,63,176
Georgia,Echols County,0,4000,2067,1933
Georgia,Echols County,1,251,163,88
Georgia,Echols County,2,327,177,150
Georgia,Echols County,3,308,131,177
Georgia,Echols County,4,259,132,127
Georgia,Echols County,5,239,129,110
Georgia,Echols County,6,270,141,129
Georgia,Echols County,7,319,173,146
Georgia,Echols County,8,244,140,104
Georgia,Echols County,9,291,143,148
Georgia,Echols County,10,253,130,123
Georgia,Echols County,11,257,143,114
Georgia,Echols County,12,243,129,114
Georgia,Echols County,13,218,107,111
Georgia,Echols County,14,188,82,106
Georgia,Echols County,15,115,53,62
Georgia,Echols County,16,79,25,54
Georgia,Echols County,17,79,38,41
Georgia,Echols County,18,60,31,29
Georgia,Effingham County,0,62190,30999,31191
Georgia,Effingham County,1,4226,2188,2038
Georgia,Effingham County,2,4603,2406,2197
Georgia,Effingham County,3,4857,2526,2331
Georgia,Effingham County,4,4258,2195,2063
Georgia,Effingham County,5,3478,1788,1690
Georgia,Effingham County,6,4331,2194,2137
Georgia,Effingham County,7,4488,2234,2254
Georgia,Effingham County,8,4547,2256,2291
Georgia,Effingham County,9,4235,2038,2197
Georgia,Effingham County,10,4287,2155,2132
Georgia,Effingham County,11,4136,2033,2103
Georgia,Effingham County,12,4042,1977,2065
Georgia,Effingham County,13,3480,1742,1738
Georgia,Effingham County,14,2605,1208,1397
Georgia,Effingham County,15,1955,918,1037
Georgia,Effingham County,16,1340,608,732
Georgia,Effingham County,17,720,330,390
Georgia,Effingham County,18,602,203,399
Georgia,Elbert County,0,19120,9147,9973
Georgia,Elbert County,1,1131,606,525
Georgia,Elbert County,2,1183,587,596
Georgia,Elbert County,3,1139,556,583
Georgia,Elbert County,4,1062,526,536
Georgia,Elbert County,5,1011,508,503
Georgia,Elbert County,6,1276,645,631
Georgia,Elbert County,7,1069,541,528
Georgia,Elbert County,8,1093,544,549
Georgia,Elbert County,9,972,475,497
Georgia,Elbert County,10,1161,547,614
Georgia,Elbert County,11,1303,601,702
Georgia,Elbert County,12,1394,638,756
Georgia,Elbert County,13,1327,641,686
Georgia,Elbert County,14,1230,569,661
Georgia,Elbert County,15,1053,488,565
Georgia,Elbert County,16,738,330,408
Georgia,Elbert County,17,512,202,310
Georgia,Elbert County,18,466,143,323
Georgia,Emanuel County,0,22612,11130,11482
Georgia,Emanuel County,1,1496,753,743
Georgia,Emanuel County,2,1564,809,755
Georgia,Emanuel County,3,1658,823,835
Georgia,Emanuel County,4,1490,748,742
Georgia,Emanuel County,5,1450,797,653
Georgia,Emanuel County,6,1548,796,752
Georgia,Emanuel County,7,1494,755,739
Georgia,Emanuel County,8,1493,800,693
Georgia,Emanuel County,9,1266,652,614
Georgia,Emanuel County,10,1307,660,647
Georgia,Emanuel County,11,1328,640,688
Georgia,Emanuel County,12,1472,719,753
Georgia,Emanuel County,13,1403,638,765
Georgia,Emanuel County,14,1221,552,669
Georgia,Emanuel County,15,953,421,532
Georgia,Emanuel County,16,662,277,385
Georgia,Emanuel County,17,437,179,258
Georgia,Emanuel County,18,370,111,259
Georgia,Evans County,0,10721,5216,5505
Georgia,Evans County,1,728,379,349
Georgia,Evans County,2,806,408,398
Georgia,Evans County,3,842,435,407
Georgia,Evans County,4,734,377,357
Georgia,Evans County,5,579,298,281
Georgia,Evans County,6,694,350,344
Georgia,Evans County,7,653,325,328
Georgia,Evans County,8,666,301,365
Georgia,Evans County,9,632,296,336
Georgia,Evans County,10,639,315,324
Georgia,Evans County,11,665,322,343
Georgia,Evans County,12,709,342,367
Georgia,Evans County,13,656,302,354
Georgia,Evans County,14,511,237,274
Georgia,Evans County,15,455,215,240
Georgia,Evans County,16,342,139,203
Georgia,Evans County,17,222,104,118
Georgia,Evans County,18,188,71,117
Georgia,Fannin County,0,25964,12610,13354
Georgia,Fannin County,1,1081,557,524
Georgia,Fannin County,2,1102,548,554
Georgia,Fannin County,3,1329,692,637
Georgia,Fannin County,4,1234,614,620
Georgia,Fannin County,5,1124,585,539
Georgia,Fannin County,6,1231,603,628
Georgia,Fannin County,7,1085,491,594
Georgia,Fannin County,8,1240,605,635
Georgia,Fannin County,9,1218,615,603
Georgia,Fannin County,10,1457,707,750
Georgia,Fannin County,11,1615,755,860
Georgia,Fannin County,12,2109,991,1118
Georgia,Fannin County,13,2476,1161,1315
Georgia,Fannin County,14,2583,1210,1373
Georgia,Fannin County,15,2155,1085,1070
Georgia,Fannin County,16,1349,679,670
Georgia,Fannin County,17,846,424,422
Georgia,Fannin County,18,730,288,442
Georgia,Fayette County,0,113459,55009,58450
Georgia,Fayette County,1,5121,2670,2451
Georgia,Fayette County,2,6679,3463,3216
Georgia,Fayette County,3,8493,4308,4185
Georgia,Fayette County,4,8836,4479,4357
Georgia,Fayette County,5,6777,3426,3351
Georgia,Fayette County,6,5215,2653,2562
Georgia,Fayette County,7,5000,2403,2597
Georgia,Fayette County,8,6225,2973,3252
Georgia,Fayette County,9,6661,3177,3484
Georgia,Fayette County,10,8058,3797,4261
Georgia,Fayette County,11,8698,4144,4554
Georgia,Fayette County,12,8837,4282,4555
Georgia,Fayette County,13,8223,3851,4372
Georgia,Fayette County,14,6890,3235,3655
Georgia,Fayette County,15,5747,2778,2969
Georgia,Fayette County,16,3741,1717,2024
Georgia,Fayette County,17,2179,965,1214
Georgia,Fayette County,18,2079,688,1391
Georgia,Floyd County,0,97927,47307,50620
Georgia,Floyd County,1,5967,3012,2955
Georgia,Floyd County,2,6148,3135,3013
Georgia,Floyd County,3,6628,3413,3215
Georgia,Floyd County,4,7235,3457,3778
Georgia,Floyd County,5,6485,3108,3377
Georgia,Floyd County,6,6721,3367,3354
Georgia,Floyd County,7,5951,2938,3013
Georgia,Floyd County,8,6049,2943,3106
Georgia,Floyd County,9,5692,2893,2799
Georgia,Floyd County,10,6164,3094,3070
Georgia,Floyd County,11,6175,2952,3223
Georgia,Floyd County,12,6304,3035,3269
Georgia,Floyd County,13,6018,2867,3151
Georgia,Floyd County,14,5192,2429,2763
Georgia,Floyd County,15,4149,1897,2252
Georgia,Floyd County,16,3098,1341,1757
Georgia,Floyd County,17,2038,791,1247
Georgia,Floyd County,18,1913,635,1278
Georgia,Forsyth County,0,236612,117339,119273
Georgia,Forsyth County,1,14131,7288,6843
Georgia,Forsyth County,2,18069,9207,8862
Georgia,Forsyth County,3,20487,10534,9953
Georgia,Forsyth County,4,17993,9268,8725
Georgia,Forsyth County,5,11611,5912,5699
Georgia,Forsyth County,6,9764,4850,4914
Georgia,Forsyth County,7,13298,6247,7051
Georgia,Forsyth County,8,18131,8641,9490
Georgia,Forsyth County,9,19837,9894,9943
Georgia,Forsyth County,10,21149,10865,10284
Georgia,Forsyth County,11,17998,9162,8836
Georgia,Forsyth County,12,14816,7455,7361
Georgia,Forsyth County,13,10907,5346,5561
Georgia,Forsyth County,14,9313,4225,5088
Georgia,Forsyth County,15,8157,3716,4441
Georgia,Forsyth County,16,5454,2448,3006
Georgia,Forsyth County,17,3111,1388,1723
Georgia,Forsyth County,18,2386,893,1493
Georgia,Franklin County,0,23023,11292,11731
Georgia,Franklin County,1,1361,712,649
Georgia,Franklin County,2,1379,692,687
Georgia,Franklin County,3,1373,690,683
Georgia,Franklin County,4,1598,848,750
Georgia,Franklin County,5,1535,757,778
Georgia,Franklin County,6,1500,748,752
Georgia,Franklin County,7,1351,712,639
Georgia,Franklin County,8,1208,608,600
Georgia,Franklin County,9,1261,592,669
Georgia,Franklin County,10,1396,706,690
Georgia,Franklin County,11,1509,754,755
Georgia,Franklin County,12,1614,828,786
Georgia,Franklin County,13,1562,754,808
Georgia,Franklin County,14,1359,647,712
Georgia,Franklin County,15,1199,532,667
Georgia,Franklin County,16,810,340,470
Georgia,Franklin County,17,540,225,315
Georgia,Franklin County,18,468,147,321
Georgia,Fulton County,0,1050114,508527,541587
Georgia,Fulton County,1,61778,31589,30189
Georgia,Fulton County,2,62660,31969,30691
Georgia,Fulton County,3,65634,33292,32342
Georgia,Fulton County,4,70934,35903,35031
Georgia,Fulton County,5,74865,37737,37128
Georgia,Fulton County,6,94302,46425,47877
Georgia,Fulton County,7,84407,41435,42972
Georgia,Fulton County,8,78276,37479,40797
Georgia,Fulton County,9,71023,33838,37185
Georgia,Fulton County,10,76057,37041,39016
Georgia,Fulton County,11,68580,34025,34555
Georgia,Fulton County,12,64908,31429,33479
Georgia,Fulton County,13,53960,24946,29014
Georgia,Fulton County,14,43059,19144,23915
Georgia,Fulton County,15,32064,14012,18052
Georgia,Fulton County,16,20615,8717,11898
Georgia,Fulton County,17,12696,4929,7767
Georgia,Fulton County,18,14296,4617,9679
Georgia,Gilmer County,0,30816,15437,15379
Georgia,Gilmer County,1,1658,849,809
Georgia,Gilmer County,2,1536,778,758
Georgia,Gilmer County,3,1691,845,846
Georgia,Gilmer County,4,1609,779,830
Georgia,Gilmer County,5,1472,769,703
Georgia,Gilmer County,6,1548,812,736
Georgia,Gilmer County,7,1487,775,712
Georgia,Gilmer County,8,1543,813,730
Georgia,Gilmer County,9,1767,926,841
Georgia,Gilmer County,10,1877,961,916
Georgia,Gilmer County,11,2045,1022,1023
Georgia,Gilmer County,12,2345,1153,1192
Georgia,Gilmer County,13,2587,1229,1358
Georgia,Gilmer County,14,2622,1304,1318
Georgia,Gilmer County,15,2223,1125,1098
Georgia,Gilmer County,16,1363,698,665
Georgia,Gilmer County,17,802,374,428
Georgia,Gilmer County,18,641,225,416
Georgia,Glascock County,0,2995,1484,1511
Georgia,Glascock County,1,142,62,80
Georgia,Glascock County,2,178,103,75
Georgia,Glascock County,3,194,117,77
Georgia,Glascock County,4,214,116,98
Georgia,Glascock County,5,168,87,81
Georgia,Glascock County,6,180,85,95
Georgia,Glascock County,7,149,84,65
Georgia,Glascock County,8,163,71,92
Georgia,Glascock County,9,200,95,105
Georgia,Glascock County,10,229,113,116
Georgia,Glascock County,11,213,107,106
Georgia,Glascock County,12,217,113,104
Georgia,Glascock County,13,210,103,107
Georgia,Glascock County,14,160,71,89
Georgia,Glascock County,15,139,70,69
Georgia,Glascock County,16,101,44,57
Georgia,Glascock County,17,54,22,32
Georgia,Glascock County,18,84,21,63
Georgia,Glynn County,0,85219,40136,45083
Georgia,Glynn County,1,4733,2361,2372
Georgia,Glynn County,2,5153,2622,2531
Georgia,Glynn County,3,5299,2662,2637
Georgia,Glynn County,4,5347,2799,2548
Georgia,Glynn County,5,4883,2450,2433
Georgia,Glynn County,6,5320,2560,2760
Georgia,Glynn County,7,4914,2239,2675
Georgia,Glynn County,8,4992,2271,2721
Georgia,Glynn County,9,4723,2214,2509
Georgia,Glynn County,10,5247,2457,2790
Georgia,Glynn County,11,5449,2585,2864
Georgia,Glynn County,12,6000,2702,3298
Georgia,Glynn County,13,5912,2701,3211
Georgia,Glynn County,14,5547,2444,3103
Georgia,Glynn County,15,4855,2209,2646
Georgia,Glynn County,16,3155,1395,1760
Georgia,Glynn County,17,1916,870,1046
Georgia,Glynn County,18,1774,595,1179
Georgia,Gordon County,0,57685,28429,29256
Georgia,Gordon County,1,3477,1818,1659
Georgia,Gordon County,2,3778,1928,1850
Georgia,Gordon County,3,4182,2149,2033
Georgia,Gordon County,4,4068,2132,1936
Georgia,Gordon County,5,3447,1747,1700
Georgia,Gordon County,6,3747,1842,1905
Georgia,Gordon County,7,3540,1812,1728
Georgia,Gordon County,8,3676,1802,1874
Georgia,Gordon County,9,3708,1817,1891
Georgia,Gordon County,10,4197,2057,2140
Georgia,Gordon County,11,4122,2062,2060
Georgia,Gordon County,12,3827,1866,1961
Georgia,Gordon County,13,3356,1615,1741
Georgia,Gordon County,14,2822,1339,1483
Georgia,Gordon County,15,2310,1079,1231
Georgia,Gordon County,16,1625,685,940
Georgia,Gordon County,17,978,393,585
Georgia,Gordon County,18,825,286,539
Georgia,Grady County,0,24748,11931,12817
Georgia,Grady County,1,1600,810,790
Georgia,Grady County,2,1649,861,788
Georgia,Grady County,3,1860,961,899
Georgia,Grady County,4,1571,766,805
Georgia,Grady County,5,1306,608,698
Georgia,Grady County,6,1432,708,724
Georgia,Grady County,7,1416,656,760
Georgia,Grady County,8,1508,719,789
Georgia,Grady County,9,1377,690,687
Georgia,Grady County,10,1517,715,802
Georgia,Grady County,11,1684,825,859
Georgia,Grady County,12,1705,830,875
Georgia,Grady County,13,1611,780,831
Georgia,Grady County,14,1457,683,774
Georgia,Grady County,15,1195,562,633
Georgia,Grady County,16,834,339,495
Georgia,Grady County,17,557,248,309
Georgia,Grady County,18,469,170,299
Georgia,Greene County,0,17698,8521,9177
Georgia,Greene County,1,884,473,411
Georgia,Greene County,2,964,451,513
Georgia,Greene County,3,902,474,428
Georgia,Greene County,4,815,428,387
Georgia,Greene County,5,775,393,382
Georgia,Greene County,6,822,407,415
Georgia,Greene County,7,837,405,432
Georgia,Greene County,8,990,456,534
Georgia,Greene County,9,889,412,477
Georgia,Greene County,10,844,385,459
Georgia,Greene County,11,1054,539,515
Georgia,Greene County,12,1229,556,673
Georgia,Greene County,13,1551,672,879
Georgia,Greene County,14,1594,761,833
Georgia,Greene County,15,1581,791,790
Georgia,Greene County,16,1062,539,523
Georgia,Greene County,17,494,251,243
Georgia,Greene County,18,411,128,283
Georgia,Gwinnett County,0,927781,452986,474795
Georgia,Gwinnett County,1,61223,31158,30065
Georgia,Gwinnett County,2,67667,34220,33447
Georgia,Gwinnett County,3,74902,37986,36916
Georgia,Gwinnett County,4,69805,35700,34105
Georgia,Gwinnett County,5,60235,30417,29818
Georgia,Gwinnett County,6,62234,30967,31267
Georgia,Gwinnett County,7,60581,29573,31008
Georgia,Gwinnett County,8,66809,32379,34430
Georgia,Gwinnett County,9,66973,31659,35314
Georgia,Gwinnett County,10,70923,34150,36773
Georgia,Gwinnett County,11,65660,31988,33672
Georgia,Gwinnett County,12,59758,28967,30791
Georgia,Gwinnett County,13,47747,22851,24896
Georgia,Gwinnett County,14,35621,16312,19309
Georgia,Gwinnett County,15,25137,11346,13791
Georgia,Gwinnett County,16,15402,6789,8613
Georgia,Gwinnett County,17,9067,3695,5372
Georgia,Gwinnett County,18,8037,2829,5208
Georgia,Habersham County,0,45388,21450,23938
Georgia,Habersham County,1,2640,1389,1251
Georgia,Habersham County,2,2752,1387,1365
Georgia,Habersham County,3,3043,1495,1548
Georgia,Habersham County,4,3067,1504,1563
Georgia,Habersham County,5,3022,1391,1631
Georgia,Habersham County,6,2945,1390,1555
Georgia,Habersham County,7,2763,1269,1494
Georgia,Habersham County,8,2723,1228,1495
Georgia,Habersham County,9,2714,1180,1534
Georgia,Habersham County,10,2944,1367,1577
Georgia,Habersham County,11,2769,1320,1449
Georgia,Habersham County,12,2958,1416,1542
Georgia,Habersham County,13,2810,1328,1482
Georgia,Habersham County,14,2557,1190,1367
Georgia,Habersham County,15,2229,1086,1143
Georgia,Habersham County,16,1598,734,864
Georgia,Habersham County,17,1036,468,568
Georgia,Habersham County,18,818,308,510
Georgia,Hall County,0,202148,100538,101610
Georgia,Hall County,1,13293,6739,6554
Georgia,Hall County,2,13602,7033,6569
Georgia,Hall County,3,15188,7848,7340
Georgia,Hall County,4,14367,7439,6928
Georgia,Hall County,5,13127,6626,6501
Georgia,Hall County,6,13732,7014,6718
Georgia,Hall County,7,12479,6347,6132
Georgia,Hall County,8,12792,6349,6443
Georgia,Hall County,9,12425,6256,6169
Georgia,Hall County,10,13985,6989,6996
Georgia,Hall County,11,13269,6715,6554
Georgia,Hall County,12,12492,6239,6253
Georgia,Hall County,13,11291,5379,5912
Georgia,Hall County,14,9491,4448,5043
Georgia,Hall County,15,8322,3836,4486
Georgia,Hall County,16,5678,2599,3079
Georgia,Hall County,17,3450,1464,1986
Georgia,Hall County,18,3165,1218,1947
Georgia,Hancock County,0,8348,4593,3755
Georgia,Hancock County,1,315,150,165
Georgia,Hancock County,2,346,185,161
Georgia,Hancock County,3,385,212,173
Georgia,Hancock County,4,383,218,165
Georgia,Hancock County,5,521,322,199
Georgia,Hancock County,6,641,437,204
Georgia,Hancock County,7,522,368,154
Georgia,Hancock County,8,470,298,172
Georgia,Hancock County,9,438,269,169
Georgia,Hancock County,10,498,291,207
Georgia,Hancock County,11,609,311,298
Georgia,Hancock County,12,610,316,294
Georgia,Hancock County,13,662,307,355
Georgia,Hancock County,14,642,326,316
Georgia,Hancock County,15,530,260,270
Georgia,Hancock County,16,326,165,161
Georgia,Hancock County,17,207,92,115
Georgia,Hancock County,18,243,66,177
Georgia,Haralson County,0,29533,14335,15198
Georgia,Haralson County,1,1773,905,868
Georgia,Haralson County,2,1975,995,980
Georgia,Haralson County,3,2048,990,1058
Georgia,Haralson County,4,1921,954,967
Georgia,Haralson County,5,1652,822,830
Georgia,Haralson County,6,1993,1003,990
Georgia,Haralson County,7,1850,914,936
Georgia,Haralson County,8,1759,827,932
Georgia,Haralson County,9,1797,895,902
Georgia,Haralson County,10,2150,1053,1097
Georgia,Haralson County,11,2105,1056,1049
Georgia,Haralson County,12,1965,1008,957
Georgia,Haralson County,13,1772,853,919
Georgia,Haralson County,14,1515,666,849
Georgia,Haralson County,15,1313,606,707
Georgia,Haralson County,16,903,402,501
Georgia,Haralson County,17,585,225,360
Georgia,Haralson County,18,457,161,296
Georgia,Harris County,0,34475,17245,17230
Georgia,Harris County,1,1635,825,810
Georgia,Harris County,2,1998,1012,986
Georgia,Harris County,3,2256,1208,1048
Georgia,Harris County,4,2282,1196,1086
Georgia,Harris County,5,1840,996,844
Georgia,Harris County,6,1789,959,830
Georgia,Harris County,7,1798,920,878
Georgia,Harris County,8,1946,934,1012
Georgia,Harris County,9,2094,1040,1054
Georgia,Harris County,10,2534,1239,1295
Georgia,Harris County,11,2610,1245,1365
Georgia,Harris County,12,2684,1371,1313
Georgia,Harris County,13,2533,1217,1316
Georgia,Harris County,14,2337,1148,1189
Georgia,Harris County,15,1854,914,940
Georgia,Harris County,16,1117,565,552
Georgia,Harris County,17,594,274,320
Georgia,Harris County,18,574,182,392
Georgia,Hart County,0,26099,12929,13170
Georgia,Hart County,1,1395,737,658
Georgia,Hart County,2,1456,746,710
Georgia,Hart County,3,1668,884,784
Georgia,Hart County,4,1478,788,690
Georgia,Hart County,5,1416,760,656
Georgia,Hart County,6,1597,863,734
Georgia,Hart County,7,1387,678,709
Georgia,Hart County,8,1413,695,718
Georgia,Hart County,9,1398,721,677
Georgia,Hart County,10,1683,825,858
Georgia,Hart County,11,1804,873,931
Georgia,Hart County,12,1851,888,963
Georgia,Hart County,13,1914,928,986
Georgia,Hart County,14,1662,774,888
Georgia,Hart County,15,1558,744,814
Georgia,Hart County,16,1113,502,611
Georgia,Hart County,17,723,303,420
Georgia,Hart County,18,583,220,363
Georgia,Heard County,0,11879,5916,5963
Georgia,Heard County,1,667,347,320
Georgia,Heard County,2,732,378,354
Georgia,Heard County,3,806,422,384
Georgia,Heard County,4,767,402,365
Georgia,Heard County,5,728,373,355
Georgia,Heard County,6,776,383,393
Georgia,Heard County,7,628,308,320
Georgia,Heard County,8,684,334,350
Georgia,Heard County,9,688,347,341
Georgia,Heard County,10,810,413,397
Georgia,Heard County,11,865,444,421
Georgia,Heard County,12,860,422,438
Georgia,Heard County,13,794,371,423
Georgia,Heard County,14,715,354,361
Georgia,Heard County,15,560,268,292
Georgia,Heard County,16,385,193,192
Georgia,Heard County,17,213,83,130
Georgia,Heard County,18,201,74,127
Georgia,Henry County,0,230220,109748,120472
Georgia,Henry County,1,13478,6901,6577
Georgia,Henry County,2,15114,7609,7505
Georgia,Henry County,3,18471,9486,8985
Georgia,Henry County,4,18308,9370,8938
Georgia,Henry County,5,15215,7588,7627
Georgia,Henry County,6,14730,7118,7612
Georgia,Henry County,7,13511,6295,7216
Georgia,Henry County,8,15131,6626,8505
Georgia,Henry County,9,16172,7184,8988
Georgia,Henry County,10,18043,8302,9741
Georgia,Henry County,11,17262,8243,9019
Georgia,Henry County,12,15507,7431,8076
Georgia,Henry County,13,12462,5831,6631
Georgia,Henry County,14,9755,4367,5388
Georgia,Henry County,15,7587,3402,4185
Georgia,Henry County,16,4689,2087,2602
Georgia,Henry County,17,2703,1160,1543
Georgia,Henry County,18,2082,748,1334
Georgia,Houston County,0,155469,75339,80130
Georgia,Houston County,1,10195,5293,4902
Georgia,Houston County,2,11262,5709,5553
Georgia,Houston County,3,11522,5873,5649
Georgia,Houston County,4,10416,5386,5030
Georgia,Houston County,5,9910,5103,4807
Georgia,Houston County,6,11440,5679,5761
Georgia,Houston County,7,11449,5427,6022
Georgia,Houston County,8,11091,5232,5859
Georgia,Houston County,9,9374,4391,4983
Georgia,Houston County,10,9774,4601,5173
Georgia,Houston County,11,10032,4774,5258
Georgia,Houston County,12,10684,5245,5439
Georgia,Houston County,13,8558,4038,4520
Georgia,Houston County,14,6682,3098,3584
Georgia,Houston County,15,5270,2393,2877
Georgia,Houston County,16,3437,1457,1980
Georgia,Houston County,17,2464,972,1492
Georgia,Houston County,18,1909,668,1241
Georgia,Irwin County,0,9398,4889,4509
Georgia,Irwin County,1,462,229,233
Georgia,Irwin County,2,542,276,266
Georgia,Irwin County,3,604,311,293
Georgia,Irwin County,4,614,338,276
Georgia,Irwin County,5,621,380,241
Georgia,Irwin County,6,702,424,278
Georgia,Irwin County,7,586,342,244
Georgia,Irwin County,8,622,321,301
Georgia,Irwin County,9,607,340,267
Georgia,Irwin County,10,628,353,275
Georgia,Irwin County,11,590,295,295
Georgia,Irwin County,12,591,306,285
Georgia,Irwin County,13,543,246,297
Georgia,Irwin County,14,458,229,229
Georgia,Irwin County,15,456,189,267
Georgia,Irwin County,16,326,159,167
Georgia,Irwin County,17,206,84,122
Georgia,Irwin County,18,240,67,173
Georgia,Jackson County,0,70422,34706,35716
Georgia,Jackson County,1,4598,2318,2280
Georgia,Jackson County,2,5026,2554,2472
Georgia,Jackson County,3,5145,2644,2501
Georgia,Jackson County,4,4617,2347,2270
Georgia,Jackson County,5,3755,1863,1892
Georgia,Jackson County,6,4656,2302,2354
Georgia,Jackson County,7,4559,2303,2256
Georgia,Jackson County,8,5070,2487,2583
Georgia,Jackson County,9,4660,2341,2319
Georgia,Jackson County,10,5041,2528,2513
Georgia,Jackson County,11,4754,2427,2327
Georgia,Jackson County,12,4473,2219,2254
Georgia,Jackson County,13,3912,1882,2030
Georgia,Jackson County,14,3269,1489,1780
Georgia,Jackson County,15,2912,1341,1571
Georgia,Jackson County,16,2079,916,1163
Georgia,Jackson County,17,1064,478,586
Georgia,Jackson County,18,832,267,565
Georgia,Jasper County,0,14040,6866,7174
Georgia,Jasper County,1,827,408,419
Georgia,Jasper County,2,926,459,467
Georgia,Jasper County,3,987,536,451
Georgia,Jasper County,4,905,479,426
Georgia,Jasper County,5,721,380,341
Georgia,Jasper County,6,810,393,417
Georgia,Jasper County,7,808,386,422
Georgia,Jasper County,8,817,381,436
Georgia,Jasper County,9,786,389,397
Georgia,Jasper County,10,922,435,487
Georgia,Jasper County,11,1011,523,488
Georgia,Jasper County,12,1054,518,536
Georgia,Jasper County,13,1012,478,534
Georgia,Jasper County,14,844,383,461
Georgia,Jasper County,15,671,317,354
Georgia,Jasper County,16,423,191,232
Georgia,Jasper County,17,283,128,155
Georgia,Jasper County,18,233,82,151
Georgia,Jeff Davis County,0,15029,7408,7621
Georgia,Jeff Davis County,1,1040,543,497
Georgia,Jeff Davis County,2,1094,562,532
Georgia,Jeff Davis County,3,1179,603,576
Georgia,Jeff Davis County,4,1066,539,527
Georgia,Jeff Davis County,5,871,432,439
Georgia,Jeff Davis County,6,923,437,486
Georgia,Jeff Davis County,7,922,472,450
Georgia,Jeff Davis County,8,879,423,456
Georgia,Jeff Davis County,9,936,460,476
Georgia,Jeff Davis County,10,964,476,488
Georgia,Jeff Davis County,11,945,490,455
Georgia,Jeff Davis County,12,963,471,492
Georgia,Jeff Davis County,13,880,430,450
Georgia,Jeff Davis County,14,765,345,420
Georgia,Jeff Davis County,15,668,347,321
Georgia,Jeff Davis County,16,484,208,276
Georgia,Jeff Davis County,17,268,99,169
Georgia,Jeff Davis County,18,182,71,111
Georgia,Jefferson County,0,15430,7447,7983
Georgia,Jefferson County,1,984,499,485
Georgia,Jefferson County,2,984,488,496
Georgia,Jefferson County,3,1023,541,482
Georgia,Jefferson County,4,998,518,480
Georgia,Jefferson County,5,893,452,441
Georgia,Jefferson County,6,1038,534,504
Georgia,Jefferson County,7,883,453,430
Georgia,Jefferson County,8,909,477,432
Georgia,Jefferson County,9,804,388,416
Georgia,Jefferson County,10,934,459,475
Georgia,Jefferson County,11,1050,484,566
Georgia,Jefferson County,12,1067,497,570
Georgia,Jefferson County,13,1044,488,556
Georgia,Jefferson County,14,926,442,484
Georgia,Jefferson County,15,736,290,446
Georgia,Jefferson County,16,550,216,334
Georgia,Jefferson County,17,315,117,198
Georgia,Jefferson County,18,292,104,188
Georgia,Jenkins County,0,8683,4658,4025
Georgia,Jenkins County,1,461,248,213
Georgia,Jenkins County,2,480,249,231
Georgia,Jenkins County,3,510,266,244
Georgia,Jenkins County,4,528,299,229
Georgia,Jenkins County,5,632,403,229
Georgia,Jenkins County,6,716,434,282
Georgia,Jenkins County,7,555,336,219
Georgia,Jenkins County,8,571,322,249
Georgia,Jenkins County,9,515,298,217
Georgia,Jenkins County,10,584,337,247
Georgia,Jenkins County,11,523,296,227
Georgia,Jenkins County,12,614,301,313
Georgia,Jenkins County,13,536,264,272
Georgia,Jenkins County,14,468,222,246
Georgia,Jenkins County,15,405,182,223
Georgia,Jenkins County,16,261,107,154
Georgia,Jenkins County,17,169,54,115
Georgia,Jenkins County,18,155,40,115
Georgia,Johnson County,0,9708,5441,4267
Georgia,Johnson County,1,498,237,261
Georgia,Johnson County,2,444,217,227
Georgia,Johnson County,3,545,278,267
Georgia,Johnson County,4,527,259,268
Georgia,Johnson County,5,576,348,228
Georgia,Johnson County,6,635,413,222
Georgia,Johnson County,7,663,429,234
Georgia,Johnson County,8,636,411,225
Georgia,Johnson County,9,659,429,230
Georgia,Johnson County,10,700,438,262
Georgia,Johnson County,11,668,418,250
Georgia,Johnson County,12,697,384,313
Georgia,Johnson County,13,636,329,307
Georgia,Johnson County,14,556,285,271
Georgia,Johnson County,15,495,254,241
Georgia,Johnson County,16,328,159,169
Georgia,Johnson County,17,201,70,131
Georgia,Johnson County,18,244,83,161
Georgia,Jones County,0,28616,13847,14769
Georgia,Jones County,1,1446,767,679
Georgia,Jones County,2,1780,898,882
Georgia,Jones County,3,2106,1070,1036
Georgia,Jones County,4,1979,998,981
Georgia,Jones County,5,1595,811,784
Georgia,Jones County,6,1672,821,851
Georgia,Jones County,7,1522,705,817
Georgia,Jones County,8,1824,898,926
Georgia,Jones County,9,1724,799,925
Georgia,Jones County,10,2011,949,1062
Georgia,Jones County,11,1987,1013,974
Georgia,Jones County,12,2062,1012,1050
Georgia,Jones County,13,1860,885,975
Georgia,Jones County,14,1744,792,952
Georgia,Jones County,15,1313,597,716
Georgia,Jones County,16,943,423,520
Georgia,Jones County,17,588,257,331
Georgia,Jones County,18,460,152,308
Georgia,Lamar County,0,19000,9150,9850
Georgia,Lamar County,1,1095,563,532
Georgia,Lamar County,2,1069,557,512
Georgia,Lamar County,3,1083,566,517
Georgia,Lamar County,4,1782,800,982
Georgia,Lamar County,5,1476,649,827
Georgia,Lamar County,6,1320,679,641
Georgia,Lamar County,7,1074,542,532
Georgia,Lamar County,8,1051,491,560
Georgia,Lamar County,9,1011,486,525
Georgia,Lamar County,10,1138,582,556
Georgia,Lamar County,11,1218,603,615
Georgia,Lamar County,12,1236,591,645
Georgia,Lamar County,13,1224,604,620
Georgia,Lamar County,14,1085,490,595
Georgia,Lamar County,15,841,382,459
Georgia,Lamar County,16,591,280,311
Georgia,Lamar County,17,378,160,218
Georgia,Lamar County,18,328,125,203
Georgia,Lanier County,0,10340,5226,5114
Georgia,Lanier County,1,687,338,349
Georgia,Lanier County,2,713,359,354
Georgia,Lanier County,3,715,367,348
Georgia,Lanier County,4,596,327,269
Georgia,Lanier County,5,576,330,246
Georgia,Lanier County,6,815,432,383
Georgia,Lanier County,7,783,396,387
Georgia,Lanier County,8,717,340,377
Georgia,Lanier County,9,633,322,311
Georgia,Lanier County,10,610,290,320
Georgia,Lanier County,11,708,362,346
Georgia,Lanier County,12,725,379,346
Georgia,Lanier County,13,606,293,313
Georgia,Lanier County,14,486,244,242
Georgia,Lanier County,15,397,182,215
Georgia,Lanier County,16,269,124,145
Georgia,Lanier County,17,179,83,96
Georgia,Lanier County,18,125,58,67
Georgia,Laurens County,0,47325,22395,24930
Georgia,Laurens County,1,3169,1635,1534
Georgia,Laurens County,2,3205,1611,1594
Georgia,Laurens County,3,3339,1679,1660
Georgia,Laurens County,4,3027,1517,1510
Georgia,Laurens County,5,2727,1431,1296
Georgia,Laurens County,6,3115,1465,1650
Georgia,Laurens County,7,2721,1211,1510
Georgia,Laurens County,8,2859,1312,1547
Georgia,Laurens County,9,2759,1304,1455
Georgia,Laurens County,10,2909,1416,1493
Georgia,Laurens County,11,3075,1487,1588
Georgia,Laurens County,12,3132,1498,1634
Georgia,Laurens County,13,2929,1347,1582
Georgia,Laurens County,14,2612,1199,1413
Georgia,Laurens County,15,2128,927,1201
Georgia,Laurens County,16,1566,661,905
Georgia,Laurens County,17,1014,402,612
Georgia,Laurens County,18,1039,293,746
Georgia,Lee County,0,29764,14924,14840
Georgia,Lee County,1,1830,981,849
Georgia,Lee County,2,2162,1096,1066
Georgia,Lee County,3,2357,1236,1121
Georgia,Lee County,4,2139,1114,1025
Georgia,Lee County,5,1599,846,753
Georgia,Lee County,6,1866,908,958
Georgia,Lee County,7,1982,1007,975
Georgia,Lee County,8,2294,1117,1177
Georgia,Lee County,9,2066,1066,1000
Georgia,Lee County,10,2252,1125,1127
Georgia,Lee County,11,1855,926,929
Georgia,Lee County,12,1849,897,952
Georgia,Lee County,13,1762,856,906
Georgia,Lee County,14,1431,710,721
Georgia,Lee County,15,1078,537,541
Georgia,Lee County,16,596,263,333
Georgia,Lee County,17,350,159,191
Georgia,Lee County,18,296,80,216
Georgia,Liberty County,0,61497,31168,30329
Georgia,Liberty County,1,6386,3260,3126
Georgia,Liberty County,2,4852,2546,2306
Georgia,Liberty County,3,3890,1928,1962
Georgia,Liberty County,4,3760,2049,1711
Georgia,Liberty County,5,6955,3989,2966
Georgia,Liberty County,6,7055,3786,3269
Georgia,Liberty County,7,4905,2511,2394
Georgia,Liberty County,8,3824,1965,1859
Georgia,Liberty County,9,2819,1411,1408
Georgia,Liberty County,10,2832,1321,1511
Georgia,Liberty County,11,2766,1256,1510
Georgia,Liberty County,12,3076,1371,1705
Georgia,Liberty County,13,2688,1245,1443
Georgia,Liberty County,14,2043,974,1069
Georgia,Liberty County,15,1622,733,889
Georgia,Liberty County,16,1081,461,620
Georgia,Liberty County,17,549,223,326
Georgia,Liberty County,18,394,139,255
Georgia,Lincoln County,0,7915,3836,4079
Georgia,Lincoln County,1,440,229,211
Georgia,Lincoln County,2,379,195,184
Georgia,Lincoln County,3,433,207,226
Georgia,Lincoln County,4,425,215,210
Georgia,Lincoln County,5,397,206,191
Georgia,Lincoln County,6,473,242,231
Georgia,Lincoln County,7,431,219,212
Georgia,Lincoln County,8,367,177,190
Georgia,Lincoln County,9,399,186,213
Georgia,Lincoln County,10,439,205,234
Georgia,Lincoln County,11,512,236,276
Georgia,Lincoln County,12,675,323,352
Georgia,Lincoln County,13,660,331,329
Georgia,Lincoln County,14,627,312,315
Georgia,Lincoln County,15,501,221,280
Georgia,Lincoln County,16,373,172,201
Georgia,Lincoln County,17,198,86,112
Georgia,Lincoln County,18,186,74,112
Georgia,Long County,0,18998,9583,9415
Georgia,Long County,1,1407,755,652
Georgia,Long County,2,1446,721,725
Georgia,Long County,3,1430,670,760
Georgia,Long County,4,1311,702,609
Georgia,Long County,5,1179,595,584
Georgia,Long County,6,1482,787,695
Georgia,Long County,7,1646,850,796
Georgia,Long County,8,1452,756,696
Georgia,Long County,9,1302,657,645
Georgia,Long County,10,1261,641,620
Georgia,Long County,11,1113,540,573
Georgia,Long County,12,1129,569,560
Georgia,Long County,13,1009,485,524
Georgia,Long County,14,733,349,384
Georgia,Long County,15,466,235,231
Georgia,Long County,16,263,117,146
Georgia,Long County,17,162,79,83
Georgia,Long County,18,207,75,132
Georgia,Lowndes County,0,116321,56320,60001
Georgia,Lowndes County,1,7897,4006,3891
Georgia,Lowndes County,2,8007,4081,3926
Georgia,Lowndes County,3,7841,3951,3890
Georgia,Lowndes County,4,9229,4508,4721
Georgia,Lowndes County,5,14408,7089,7319
Georgia,Lowndes County,6,9935,5145,4790
Georgia,Lowndes County,7,7778,3904,3874
Georgia,Lowndes County,8,7029,3454,3575
Georgia,Lowndes County,9,5979,2885,3094
Georgia,Lowndes County,10,6135,2894,3241
Georgia,Lowndes County,11,5952,2833,3119
Georgia,Lowndes County,12,6217,2961,3256
Georgia,Lowndes County,13,5548,2573,2975
Georgia,Lowndes County,14,4776,2168,2608
Georgia,Lowndes County,15,3756,1620,2136
Georgia,Lowndes County,16,2582,1058,1524
Georgia,Lowndes County,17,1765,713,1052
Georgia,Lowndes County,18,1487,477,1010
Georgia,Lumpkin County,0,32955,16335,16620
Georgia,Lumpkin County,1,1482,750,732
Georgia,Lumpkin County,2,1598,831,767
Georgia,Lumpkin County,3,1699,879,820
Georgia,Lumpkin County,4,3128,1561,1567
Georgia,Lumpkin County,5,4111,2176,1935
Georgia,Lumpkin County,6,2009,1017,992
Georgia,Lumpkin County,7,1630,816,814
Georgia,Lumpkin County,8,1710,870,840
Georgia,Lumpkin County,9,1673,803,870
Georgia,Lumpkin County,10,1827,884,943
Georgia,Lumpkin County,11,1864,944,920
Georgia,Lumpkin County,12,2226,1051,1175
Georgia,Lumpkin County,13,2212,1059,1153
Georgia,Lumpkin County,14,1939,927,1012
Georgia,Lumpkin County,15,1641,776,865
Georgia,Lumpkin County,16,1124,547,577
Georgia,Lumpkin County,17,588,258,330
Georgia,Lumpkin County,18,494,186,308
Georgia,McDuffie County,0,21531,10081,11450
Georgia,McDuffie County,1,1407,699,708
Georgia,McDuffie County,2,1554,790,764
Georgia,McDuffie County,3,1561,782,779
Georgia,McDuffie County,4,1453,708,745
Georgia,McDuffie County,5,1180,584,596
Georgia,McDuffie County,6,1381,671,710
Georgia,McDuffie County,7,1247,564,683
Georgia,McDuffie County,8,1165,535,630
Georgia,McDuffie County,9,1121,506,615
Georgia,McDuffie County,10,1326,625,701
Georgia,McDuffie County,11,1416,687,729
Georgia,McDuffie County,12,1484,705,779
Georgia,McDuffie County,13,1459,664,795
Georgia,McDuffie County,14,1217,536,681
Georgia,McDuffie County,15,1065,501,564
Georgia,McDuffie County,16,712,275,437
Georgia,McDuffie County,17,456,157,299
Georgia,McDuffie County,18,327,92,235
Georgia,McIntosh County,0,14340,7001,7339
Georgia,McIntosh County,1,592,303,289
Georgia,McIntosh County,2,581,309,272
Georgia,McIntosh County,3,722,371,351
Georgia,McIntosh County,4,680,344,336
Georgia,McIntosh County,5,690,355,335
Georgia,McIntosh County,6,821,433,388
Georgia,McIntosh County,7,685,351,334
Georgia,McIntosh County,8,657,305,352
Georgia,McIntosh County,9,694,336,358
Georgia,McIntosh County,10,929,446,483
Georgia,McIntosh County,11,978,457,521
Georgia,McIntosh County,12,1201,578,623
Georgia,McIntosh County,13,1282,605,677
Georgia,McIntosh County,14,1208,546,662
Georgia,McIntosh County,15,1065,514,551
Georgia,McIntosh County,16,753,363,390
Georgia,McIntosh County,17,435,223,212
Georgia,McIntosh County,18,367,162,205
Georgia,Macon County,0,13143,7203,5940
Georgia,Macon County,1,666,313,353
Georgia,Macon County,2,679,349,330
Georgia,Macon County,3,666,325,341
Georgia,Macon County,4,774,421,353
Georgia,Macon County,5,892,572,320
Georgia,Macon County,6,1081,712,369
Georgia,Macon County,7,938,617,321
Georgia,Macon County,8,830,515,315
Georgia,Macon County,9,758,483,275
Georgia,Macon County,10,786,483,303
Georgia,Macon County,11,902,478,424
Georgia,Macon County,12,957,452,505
Georgia,Macon County,13,944,448,496
Georgia,Macon County,14,804,386,418
Georgia,Macon County,15,627,310,317
Georgia,Macon County,16,423,180,243
Georgia,Macon County,17,226,86,140
Georgia,Macon County,18,190,73,117
Georgia,Madison County,0,29650,14661,14989
Georgia,Madison County,1,1781,921,860
Georgia,Madison County,2,1874,956,918
Georgia,Madison County,3,1991,1055,936
Georgia,Madison County,4,1811,965,846
Georgia,Madison County,5,1645,843,802
Georgia,Madison County,6,1966,992,974
Georgia,Madison County,7,1732,821,911
Georgia,Madison County,8,1772,837,935
Georgia,Madison County,9,1812,853,959
Georgia,Madison County,10,1978,978,1000
Georgia,Madison County,11,2045,1033,1012
Georgia,Madison County,12,2161,1067,1094
Georgia,Madison County,13,2050,976,1074
Georgia,Madison County,14,1670,822,848
Georgia,Madison County,15,1412,695,717
Georgia,Madison County,16,959,434,525
Georgia,Madison County,17,550,248,302
Georgia,Madison County,18,441,165,276
Georgia,Marion County,0,8351,4112,4239
Georgia,Marion County,1,416,218,198
Georgia,Marion County,2,468,220,248
Georgia,Marion County,3,539,250,289
Georgia,Marion County,4,528,271,257
Georgia,Marion County,5,435,245,190
Georgia,Marion County,6,457,236,221
Georgia,Marion County,7,443,204,239
Georgia,Marion County,8,404,200,204
Georgia,Marion County,9,455,211,244
Georgia,Marion County,10,536,268,268
Georgia,Marion County,11,597,280,317
Georgia,Marion County,12,745,392,353
Georgia,Marion County,13,657,332,325
Georgia,Marion County,14,526,267,259
Georgia,Marion County,15,470,234,236
Georgia,Marion County,16,349,155,194
Georgia,Marion County,17,197,72,125
Georgia,Marion County,18,129,57,72
Georgia,Meriwether County,0,21068,10085,10983
Georgia,Meriwether County,1,1262,640,622
Georgia,Meriwether County,2,1194,595,599
Georgia,Meriwether County,3,1301,677,624
Georgia,Meriwether County,4,1251,652,599
Georgia,Meriwether County,5,1200,631,569
Georgia,Meriwether County,6,1300,608,692
Georgia,Meriwether County,7,1193,597,596
Georgia,Meriwether County,8,1184,562,622
Georgia,Meriwether County,9,1096,521,575
Georgia,Meriwether County,10,1223,554,669
Georgia,Meriwether County,11,1389,682,707
Georgia,Meriwether County,12,1632,785,847
Georgia,Meriwether County,13,1553,734,819
Georgia,Meriwether County,14,1370,640,730
Georgia,Meriwether County,15,1175,525,650
Georgia,Meriwether County,16,770,361,409
Georgia,Meriwether County,17,494,178,316
Georgia,Meriwether County,18,481,143,338
Georgia,Miller County,0,5686,2725,2961
Georgia,Miller County,1,318,161,157
Georgia,Miller County,2,372,193,179
Georgia,Miller County,3,378,202,176
Georgia,Miller County,4,336,179,157
Georgia,Miller County,5,285,140,145
Georgia,Miller County,6,341,166,175
Georgia,Miller County,7,301,141,160
Georgia,Miller County,8,303,127,176
Georgia,Miller County,9,300,158,142
Georgia,Miller County,10,342,164,178
Georgia,Miller County,11,396,188,208
Georgia,Miller County,12,373,183,190
Georgia,Miller County,13,377,183,194
Georgia,Miller County,14,350,159,191
Georgia,Miller County,15,279,120,159
Georgia,Miller County,16,258,115,143
Georgia,Miller County,17,185,79,106
Georgia,Miller County,18,192,67,125
Georgia,Mitchell County,0,22192,11510,10682
Georgia,Mitchell County,1,1301,657,644
Georgia,Mitchell County,2,1428,757,671
Georgia,Mitchell County,3,1469,784,685
Georgia,Mitchell County,4,1389,736,653
Georgia,Mitchell County,5,1367,818,549
Georgia,Mitchell County,6,1599,944,655
Georgia,Mitchell County,7,1369,797,572
Georgia,Mitchell County,8,1440,807,633
Georgia,Mitchell County,9,1394,754,640
Georgia,Mitchell County,10,1502,781,721
Georgia,Mitchell County,11,1401,752,649
Georgia,Mitchell County,12,1513,778,735
Georgia,Mitchell County,13,1406,640,766
Georgia,Mitchell County,14,1137,519,618
Georgia,Mitchell County,15,947,411,536
Georgia,Mitchell County,16,716,282,434
Georgia,Mitchell County,17,419,174,245
Georgia,Mitchell County,18,395,119,276
Georgia,Monroe County,0,27520,13723,13797
Georgia,Monroe County,1,1402,711,691
Georgia,Monroe County,2,1537,783,754
Georgia,Monroe County,3,1616,829,787
Georgia,Monroe County,4,1728,960,768
Georgia,Monroe County,5,1678,957,721
Georgia,Monroe County,6,1650,865,785
Georgia,Monroe County,7,1577,793,784
Georgia,Monroe County,8,1586,784,802
Georgia,Monroe County,9,1609,775,834
Georgia,Monroe County,10,1907,925,982
Georgia,Monroe County,11,1939,940,999
Georgia,Monroe County,12,2021,1018,1003
Georgia,Monroe County,13,2167,1036,1131
Georgia,Monroe County,14,1637,807,830
Georgia,Monroe County,15,1326,649,677
Georgia,Monroe County,16,976,449,527
Georgia,Monroe County,17,569,274,295
Georgia,Monroe County,18,595,168,427
Georgia,Montgomery County,0,9193,4727,4466
Georgia,Montgomery County,1,481,241,240
Georgia,Montgomery County,2,529,273,256
Georgia,Montgomery County,3,512,246,266
Georgia,Montgomery County,4,706,389,317
Georgia,Montgomery County,5,767,412,355
Georgia,Montgomery County,6,632,367,265
Georgia,Montgomery County,7,533,294,239
Georgia,Montgomery County,8,523,287,236
Georgia,Montgomery County,9,546,283,263
Georgia,Montgomery County,10,594,310,284
Georgia,Montgomery County,11,576,310,266
Georgia,Montgomery County,12,652,329,323
Georgia,Montgomery County,13,567,293,274
Georgia,Montgomery County,14,533,252,281
Georgia,Montgomery County,15,425,195,230
Georgia,Montgomery County,16,300,114,186
Georgia,Montgomery County,17,204,89,115
Georgia,Montgomery County,18,113,43,70
Georgia,Morgan County,0,18853,9068,9785
Georgia,Morgan County,1,1145,544,601
Georgia,Morgan County,2,1060,568,492
Georgia,Morgan County,3,1304,664,640
Georgia,Morgan County,4,1226,629,597
Georgia,Morgan County,5,971,484,487
Georgia,Morgan County,6,1001,467,534
Georgia,Morgan County,7,1005,480,525
Georgia,Morgan County,8,1048,509,539
Georgia,Morgan County,9,1031,480,551
Georgia,Morgan County,10,1298,608,690
Georgia,Morgan County,11,1295,643,652
Georgia,Morgan County,12,1390,688,702
Georgia,Morgan County,13,1300,612,688
Georgia,Morgan County,14,1185,547,638
Georgia,Morgan County,15,1003,460,543
Georgia,Morgan County,16,740,338,402
Georgia,Morgan County,17,477,204,273
Georgia,Morgan County,18,374,143,231
Georgia,Murray County,0,39921,19623,20298
Georgia,Murray County,1,2589,1310,1279
Georgia,Murray County,2,2564,1352,1212
Georgia,Murray County,3,2973,1526,1447
Georgia,Murray County,4,2712,1371,1341
Georgia,Murray County,5,2406,1198,1208
Georgia,Murray County,6,2732,1371,1361
Georgia,Murray County,7,2324,1140,1184
Georgia,Murray County,8,2441,1155,1286
Georgia,Murray County,9,2445,1180,1265
Georgia,Murray County,10,2831,1380,1451
Georgia,Murray County,11,2904,1463,1441
Georgia,Murray County,12,2764,1418,1346
Georgia,Murray County,13,2305,1123,1182
Georgia,Murray County,14,1936,914,1022
Georgia,Murray County,15,1714,792,922
Georgia,Murray County,16,1145,493,652
Georgia,Murray County,17,657,261,396
Georgia,Murray County,18,479,176,303
Georgia,Muscogee County,0,194160,94349,99811
Georgia,Muscogee County,1,13858,7044,6814
Georgia,Muscogee County,2,13775,7048,6727
Georgia,Muscogee County,3,13095,6696,6399
Georgia,Muscogee County,4,12648,6644,6004
Georgia,Muscogee County,5,13720,7296,6424
Georgia,Muscogee County,6,16676,8560,8116
Georgia,Muscogee County,7,14867,7422,7445
Georgia,Muscogee County,8,13204,6495,6709
Georgia,Muscogee County,9,11252,5315,5937
Georgia,Muscogee County,10,11204,5383,5821
Georgia,Muscogee County,11,11164,5262,5902
Georgia,Muscogee County,12,11772,5497,6275
Georgia,Muscogee County,13,10921,5123,5798
Georgia,Muscogee County,14,8516,3816,4700
Georgia,Muscogee County,15,6686,2858,3828
Georgia,Muscogee County,16,4520,1790,2730
Georgia,Muscogee County,17,3073,1109,1964
Georgia,Muscogee County,18,3209,991,2218
Georgia,Newton County,0,109541,51731,57810
Georgia,Newton County,1,7010,3678,3332
Georgia,Newton County,2,7542,3743,3799
Georgia,Newton County,3,8633,4446,4187
Georgia,Newton County,4,8617,4358,4259
Georgia,Newton County,5,7205,3513,3692
Georgia,Newton County,6,7164,3534,3630
Georgia,Newton County,7,6589,3059,3530
Georgia,Newton County,8,6888,3067,3821
Georgia,Newton County,9,7204,3225,3979
Georgia,Newton County,10,8033,3621,4412
Georgia,Newton County,11,7612,3559,4053
Georgia,Newton County,12,7060,3305,3755
Georgia,Newton County,13,5723,2553,3170
Georgia,Newton County,14,4977,2198,2779
Georgia,Newton County,15,4002,1790,2212
Georgia,Newton County,16,2485,1053,1432
Georgia,Newton County,17,1461,628,833
Georgia,Newton County,18,1336,401,935
Georgia,Oconee County,0,39272,19271,20001
Georgia,Oconee County,1,2183,1073,1110
Georgia,Oconee County,2,2895,1533,1362
Georgia,Oconee County,3,3318,1683,1635
Georgia,Oconee County,4,3122,1614,1508
Georgia,Oconee County,5,2086,1105,981
Georgia,Oconee County,6,1627,794,833
Georgia,Oconee County,7,1949,903,1046
Georgia,Oconee County,8,2585,1183,1402
Georgia,Oconee County,9,2762,1321,1441
Georgia,Oconee County,10,3076,1499,1577
Georgia,Oconee County,11,2693,1305,1388
Georgia,Oconee County,12,2591,1264,1327
Georgia,Oconee County,13,2430,1198,1232
Georgia,Oconee County,14,2032,971,1061
Georgia,Oconee County,15,1632,801,831
Georgia,Oconee County,16,1061,527,534
Georgia,Oconee County,17,630,259,371
Georgia,Oconee County,18,600,238,362
Georgia,Oglethorpe County,0,15054,7439,7615
Georgia,Oglethorpe County,1,793,398,395
Georgia,Oglethorpe County,2,868,446,422
Georgia,Oglethorpe County,3,912,461,451
Georgia,Oglethorpe County,4,891,463,428
Georgia,Oglethorpe County,5,822,427,395
Georgia,Oglethorpe County,6,971,497,474
Georgia,Oglethorpe County,7,898,452,446
Georgia,Oglethorpe County,8,895,435,460
Georgia,Oglethorpe County,9,828,430,398
Georgia,Oglethorpe County,10,1061,482,579
Georgia,Oglethorpe County,11,1082,562,520
Georgia,Oglethorpe County,12,1131,584,547
Georgia,Oglethorpe County,13,1064,507,557
Georgia,Oglethorpe County,14,875,437,438
Georgia,Oglethorpe County,15,774,365,409
Georgia,Oglethorpe County,16,562,245,317
Georgia,Oglethorpe County,17,337,152,185
Georgia,Oglethorpe County,18,290,96,194
Georgia,Paulding County,0,164044,79857,84187
Georgia,Paulding County,1,10306,5260,5046
Georgia,Paulding County,2,11594,5891,5703
Georgia,Paulding County,3,12998,6540,6458
Georgia,Paulding County,4,12034,6118,5916
Georgia,Paulding County,5,9851,4989,4862
Georgia,Paulding County,6,11390,5615,5775
Georgia,Paulding County,7,10948,5240,5708
Georgia,Paulding County,8,11513,5532,5981
Georgia,Paulding County,9,11801,5599,6202
Georgia,Paulding County,10,13378,6513,6865
Georgia,Paulding County,11,12110,5986,6124
Georgia,Paulding County,12,10417,5158,5259
Georgia,Paulding County,13,8310,3960,4350
Georgia,Paulding County,14,6293,2811,3482
Georgia,Paulding County,15,4919,2222,2697
Georgia,Paulding County,16,3116,1312,1804
Georgia,Paulding County,17,1724,682,1042
Georgia,Paulding County,18,1342,429,913
Georgia,Peach County,0,27297,13158,14139
Georgia,Peach County,1,1532,742,790
Georgia,Peach County,2,1582,807,775
Georgia,Peach County,3,1610,826,784
Georgia,Peach County,4,2381,1142,1239
Georgia,Peach County,5,2463,1256,1207
Georgia,Peach County,6,1808,876,932
Georgia,Peach County,7,1571,781,790
Georgia,Peach County,8,1558,767,791
Georgia,Peach County,9,1367,641,726
Georgia,Peach County,10,1551,747,804
Georgia,Peach County,11,1734,834,900
Georgia,Peach County,12,1999,1001,998
Georgia,Peach County,13,1774,844,930
Georgia,Peach County,14,1482,686,796
Georgia,Peach County,15,1141,500,641
Georgia,Peach County,16,834,378,456
Georgia,Peach County,17,509,179,330
Georgia,Peach County,18,401,151,250
Georgia,Pickens County,0,31980,15696,16284
Georgia,Pickens County,1,1619,803,816
Georgia,Pickens County,2,1686,877,809
Georgia,Pickens County,3,1904,956,948
Georgia,Pickens County,4,1900,993,907
Georgia,Pickens County,5,1587,781,806
Georgia,Pickens County,6,1912,994,918
Georgia,Pickens County,7,1678,807,871
Georgia,Pickens County,8,1717,861,856
Georgia,Pickens County,9,1808,847,961
Georgia,Pickens County,10,2057,1061,996
Georgia,Pickens County,11,2218,1114,1104
Georgia,Pickens County,12,2460,1169,1291
Georgia,Pickens County,13,2430,1127,1303
Georgia,Pickens County,14,2408,1140,1268
Georgia,Pickens County,15,2005,990,1015
Georgia,Pickens County,16,1321,643,678
Georgia,Pickens County,17,711,319,392
Georgia,Pickens County,18,559,214,345
Georgia,Pierce County,0,19389,9586,9803
Georgia,Pierce County,1,1244,615,629
Georgia,Pierce County,2,1295,682,613
Georgia,Pierce County,3,1423,715,708
Georgia,Pierce County,4,1282,702,580
Georgia,Pierce County,5,1094,551,543
Georgia,Pierce County,6,1183,599,584
Georgia,Pierce County,7,1091,551,540
Georgia,Pierce County,8,1240,580,660
Georgia,Pierce County,9,1210,603,607
Georgia,Pierce County,10,1334,670,664
Georgia,Pierce County,11,1249,623,626
Georgia,Pierce County,12,1288,655,633
Georgia,Pierce County,13,1154,548,606
Georgia,Pierce County,14,1060,483,577
Georgia,Pierce County,15,927,444,483
Georgia,Pierce County,16,662,292,370
Georgia,Pierce County,17,349,162,187
Georgia,Pierce County,18,304,111,193
Georgia,Pike County,0,18634,9164,9470
Georgia,Pike County,1,990,521,469
Georgia,Pike County,2,1119,593,526
Georgia,Pike County,3,1333,679,654
Georgia,Pike County,4,1381,706,675
Georgia,Pike County,5,1076,541,535
Georgia,Pike County,6,1069,511,558
Georgia,Pike County,7,1101,524,577
Georgia,Pike County,8,1098,527,571
Georgia,Pike County,9,1250,588,662
Georgia,Pike County,10,1416,697,719
Georgia,Pike County,11,1391,698,693
Georgia,Pike County,12,1299,678,621
Georgia,Pike County,13,1142,539,603
Georgia,Pike County,14,944,458,486
Georgia,Pike County,15,816,389,427
Georgia,Pike County,16,590,267,323
Georgia,Pike County,17,339,166,173
Georgia,Pike County,18,280,82,198
Georgia,Polk County,0,42470,20992,21478
Georgia,Polk County,1,2884,1520,1364
Georgia,Polk County,2,2886,1410,1476
Georgia,Polk County,3,3157,1607,1550
Georgia,Polk County,4,2849,1501,1348
Georgia,Polk County,5,2556,1354,1202
Georgia,Polk County,6,2932,1507,1425
Georgia,Polk County,7,2868,1466,1402
Georgia,Polk County,8,2692,1399,1293
Georgia,Polk County,9,2427,1178,1249
Georgia,Polk County,10,2625,1299,1326
Georgia,Polk County,11,2693,1351,1342
Georgia,Polk County,12,2818,1348,1470
Georgia,Polk County,13,2508,1167,1341
Georgia,Polk County,14,2084,984,1100
Georgia,Polk County,15,1814,813,1001
Georgia,Polk County,16,1270,576,694
Georgia,Polk County,17,753,292,461
Georgia,Polk County,18,654,220,434
Georgia,Pulaski County,0,11069,4774,6295
Georgia,Pulaski County,1,441,234,207
Georgia,Pulaski County,2,561,273,288
Georgia,Pulaski County,3,639,322,317
Georgia,Pulaski County,4,582,301,281
Georgia,Pulaski County,5,637,267,370
Georgia,Pulaski County,6,675,252,423
Georgia,Pulaski County,7,654,209,445
Georgia,Pulaski County,8,654,239,415
Georgia,Pulaski County,9,664,266,398
Georgia,Pulaski County,10,765,298,467
Georgia,Pulaski County,11,762,325,437
Georgia,Pulaski County,12,765,336,429
Georgia,Pulaski County,13,767,337,430
Georgia,Pulaski County,14,752,353,399
Georgia,Pulaski County,15,649,317,332
Georgia,Pulaski County,16,495,202,293
Georgia,Pulaski County,17,337,157,180
Georgia,Pulaski County,18,270,86,184
Georgia,Putnam County,0,21809,10643,11166
Georgia,Putnam County,1,1100,542,558
Georgia,Putnam County,2,1204,601,603
Georgia,Putnam County,3,1277,625,652
Georgia,Putnam County,4,1197,636,561
Georgia,Putnam County,5,1044,512,532
Georgia,Putnam County,6,1165,581,584
Georgia,Putnam County,7,1168,548,620
Georgia,Putnam County,8,1166,576,590
Georgia,Putnam County,9,1025,493,532
Georgia,Putnam County,10,1318,633,685
Georgia,Putnam County,11,1428,705,723
Georgia,Putnam County,12,1700,846,854
Georgia,Putnam County,13,1771,812,959
Georgia,Putnam County,14,1777,838,939
Georgia,Putnam County,15,1467,734,733
Georgia,Putnam County,16,980,489,491
Georgia,Putnam County,17,586,286,300
Georgia,Putnam County,18,436,186,250
Georgia,Quitman County,0,2279,1090,1189
Georgia,Quitman County,1,118,54,64
Georgia,Quitman County,2,96,50,46
Georgia,Quitman County,3,107,53,54
Georgia,Quitman County,4,130,63,67
Georgia,Quitman County,5,80,45,35
Georgia,Quitman County,6,93,51,42
Georgia,Quitman County,7,109,58,51
Georgia,Quitman County,8,80,35,45
Georgia,Quitman County,9,97,43,54
Georgia,Quitman County,10,120,66,54
Georgia,Quitman County,11,148,62,86
Georgia,Quitman County,12,156,72,84
Georgia,Quitman County,13,234,112,122
Georgia,Quitman County,14,212,107,105
Georgia,Quitman County,15,198,82,116
Georgia,Quitman County,16,135,67,68
Georgia,Quitman County,17,92,38,54
Georgia,Quitman County,18,74,32,42
Georgia,Rabun County,0,16867,8295,8572
Georgia,Rabun County,1,721,367,354
Georgia,Rabun County,2,721,379,342
Georgia,Rabun County,3,805,388,417
Georgia,Rabun County,4,935,489,446
Georgia,Rabun County,5,824,456,368
Georgia,Rabun County,6,903,431,472
Georgia,Rabun County,7,813,425,388
Georgia,Rabun County,8,793,388,405
Georgia,Rabun County,9,886,424,462
Georgia,Rabun County,10,1063,516,547
Georgia,Rabun County,11,1068,542,526
Georgia,Rabun County,12,1266,624,642
Georgia,Rabun County,13,1406,691,715
Georgia,Rabun County,14,1404,679,725
Georgia,Rabun County,15,1365,650,715
Georgia,Rabun County,16,910,431,479
Georgia,Rabun County,17,538,251,287
Georgia,Rabun County,18,446,164,282
Georgia,Randolph County,0,6833,3157,3676
Georgia,Randolph County,1,386,188,198
Georgia,Randolph County,2,391,201,190
Georgia,Randolph County,3,412,220,192
Georgia,Randolph County,4,414,211,203
Georgia,Randolph County,5,396,193,203
Georgia,Randolph County,6,399,189,210
Georgia,Randolph County,7,327,139,188
Georgia,Randolph County,8,375,160,215
Georgia,Randolph County,9,293,149,144
Georgia,Randolph County,10,326,139,187
Georgia,Randolph County,11,411,187,224
Georgia,Randolph County,12,512,222,290
Georgia,Randolph County,13,559,284,275
Georgia,Randolph County,14,479,220,259
Georgia,Randolph County,15,400,172,228
Georgia,Randolph County,16,312,139,173
Georgia,Randolph County,17,166,71,95
Georgia,Randolph County,18,275,73,202
Georgia,Richmond County,0,201554,97624,103930
Georgia,Richmond County,1,13538,7007,6531
Georgia,Richmond County,2,12753,6519,6234
Georgia,Richmond County,3,12349,6334,6015
Georgia,Richmond County,4,13917,7500,6417
Georgia,Richmond County,5,16325,8839,7486
Georgia,Richmond County,6,18582,9394,9188
Georgia,Richmond County,7,14888,7255,7633
Georgia,Richmond County,8,12675,6070,6605
Georgia,Richmond County,9,10638,5003,5635
Georgia,Richmond County,10,10770,4972,5798
Georgia,Richmond County,11,11607,5400,6207
Georgia,Richmond County,12,12922,5885,7037
Georgia,Richmond County,13,12248,5604,6644
Georgia,Richmond County,14,10021,4387,5634
Georgia,Richmond County,15,7226,3187,4039
Georgia,Richmond County,16,4906,2042,2864
Georgia,Richmond County,17,3174,1236,1938
Georgia,Richmond County,18,3015,990,2025
Georgia,Rockdale County,0,90594,42596,47998
Georgia,Rockdale County,1,5295,2644,2651
Georgia,Rockdale County,2,5961,3046,2915
Georgia,Rockdale County,3,6843,3472,3371
Georgia,Rockdale County,4,6759,3386,3373
Georgia,Rockdale County,5,5672,2860,2812
Georgia,Rockdale County,6,5791,2771,3020
Georgia,Rockdale County,7,5024,2281,2743
Georgia,Rockdale County,8,5377,2330,3047
Georgia,Rockdale County,9,5457,2358,3099
Georgia,Rockdale County,10,6314,2848,3466
Georgia,Rockdale County,11,6519,2978,3541
Georgia,Rockdale County,12,6633,3094,3539
Georgia,Rockdale County,13,5890,2799,3091
Georgia,Rockdale County,14,4723,2133,2590
Georgia,Rockdale County,15,3570,1602,1968
Georgia,Rockdale County,16,2231,1001,1230
Georgia,Rockdale County,17,1285,534,751
Georgia,Rockdale County,18,1250,459,791
Georgia,Schley County,0,5236,2484,2752
Georgia,Schley County,1,267,145,122
Georgia,Schley County,2,329,159,170
Georgia,Schley County,3,450,217,233
Georgia,Schley County,4,397,206,191
Georgia,Schley County,5,264,124,140
Georgia,Schley County,6,276,134,142
Georgia,Schley County,7,264,116,148
Georgia,Schley County,8,279,124,155
Georgia,Schley County,9,335,153,182
Georgia,Schley County,10,458,197,261
Georgia,Schley County,11,380,197,183
Georgia,Schley County,12,355,172,183
Georgia,Schley County,13,285,136,149
Georgia,Schley County,14,259,126,133
Georgia,Schley County,15,259,112,147
Georgia,Schley County,16,195,100,95
Georgia,Schley County,17,96,37,59
Georgia,Schley County,18,88,29,59
Georgia,Screven County,0,13938,6902,7036
Georgia,Screven County,1,833,446,387
Georgia,Screven County,2,819,454,365
Georgia,Screven County,3,738,395,343
Georgia,Screven County,4,809,472,337
Georgia,Screven County,5,813,415,398
Georgia,Screven County,6,1009,485,524
Georgia,Screven County,7,802,403,399
Georgia,Screven County,8,759,370,389
Georgia,Screven County,9,786,392,394
Georgia,Screven County,10,847,423,424
Georgia,Screven County,11,961,451,510
Georgia,Screven County,12,1070,514,556
Georgia,Screven County,13,1070,506,564
Georgia,Screven County,14,931,453,478
Georgia,Screven County,15,669,309,360
Georgia,Screven County,16,477,193,284
Georgia,Screven County,17,291,128,163
Georgia,Screven County,18,254,93,161
Georgia,Seminole County,0,8315,3981,4334
Georgia,Seminole County,1,443,223,220
Georgia,Seminole County,2,474,242,232
Georgia,Seminole County,3,508,262,246
Georgia,Seminole County,4,484,240,244
Georgia,Seminole County,5,467,248,219
Georgia,Seminole County,6,463,215,248
Georgia,Seminole County,7,396,200,196
Georgia,Seminole County,8,439,216,223
Georgia,Seminole County,9,420,186,234
Georgia,Seminole County,10,495,241,254
Georgia,Seminole County,11,547,250,297
Georgia,Seminole County,12,617,273,344
Georgia,Seminole County,13,644,302,342
Georgia,Seminole County,14,565,282,283
Georgia,Seminole County,15,518,262,256
Georgia,Seminole County,16,376,163,213
Georgia,Seminole County,17,210,93,117
Georgia,Seminole County,18,249,83,166
Georgia,Spalding County,0,66100,31749,34351
Georgia,Spalding County,1,4163,2141,2022
Georgia,Spalding County,2,4310,2209,2101
Georgia,Spalding County,3,4526,2304,2222
Georgia,Spalding County,4,4010,2011,1999
Georgia,Spalding County,5,3807,1975,1832
Georgia,Spalding County,6,4950,2456,2494
Georgia,Spalding County,7,4079,1926,2153
Georgia,Spalding County,8,4042,1938,2104
Georgia,Spalding County,9,3664,1759,1905
Georgia,Spalding County,10,4059,1906,2153
Georgia,Spalding County,11,4194,2043,2151
Georgia,Spalding County,12,4229,2000,2229
Georgia,Spalding County,13,4264,1984,2280
Georgia,Spalding County,14,3782,1709,2073
Georgia,Spalding County,15,3319,1494,1825
Georgia,Spalding County,16,2170,961,1209
Georgia,Spalding County,17,1346,536,810
Georgia,Spalding County,18,1186,397,789
Georgia,Stephens County,0,26035,12508,13527
Georgia,Stephens County,1,1584,790,794
Georgia,Stephens County,2,1521,750,771
Georgia,Stephens County,3,1692,862,830
Georgia,Stephens County,4,1796,911,885
Georgia,Stephens County,5,1890,911,979
Georgia,Stephens County,6,1645,811,834
Georgia,Stephens County,7,1328,635,693
Georgia,Stephens County,8,1406,672,734
Georgia,Stephens County,9,1371,637,734
Georgia,Stephens County,10,1548,743,805
Georgia,Stephens County,11,1661,841,820
Georgia,Stephens County,12,1757,842,915
Georgia,Stephens County,13,1784,807,977
Georgia,Stephens County,14,1647,791,856
Georgia,Stephens County,15,1411,670,741
Georgia,Stephens County,16,983,431,552
Georgia,Stephens County,17,574,253,321
Georgia,Stephens County,18,437,151,286
Georgia,Stewart County,0,6199,4094,2105
Georgia,Stewart County,1,203,93,110
Georgia,Stewart County,2,229,121,108
Georgia,Stewart County,3,202,108,94
Georgia,Stewart County,4,254,172,82
Georgia,Stewart County,5,719,602,117
Georgia,Stewart County,6,783,648,135
Georgia,Stewart County,7,643,526,117
Georgia,Stewart County,8,509,406,103
Georgia,Stewart County,9,358,244,114
Georgia,Stewart County,10,296,195,101
Georgia,Stewart County,11,386,240,146
Georgia,Stewart County,12,318,165,153
Georgia,Stewart County,13,335,163,172
Georgia,Stewart County,14,305,137,168
Georgia,Stewart County,15,228,115,113
Georgia,Stewart County,16,170,64,106
Georgia,Stewart County,17,107,34,73
Georgia,Stewart County,18,154,61,93
Georgia,Sumter County,0,29733,13967,15766
Georgia,Sumter County,1,1799,854,945
Georgia,Sumter County,2,1878,947,931
Georgia,Sumter County,3,1947,958,989
Georgia,Sumter County,4,2314,1155,1159
Georgia,Sumter County,5,3002,1424,1578
Georgia,Sumter County,6,1949,992,957
Georgia,Sumter County,7,1584,789,795
Georgia,Sumter County,8,1656,782,874
Georgia,Sumter County,9,1513,702,811
Georgia,Sumter County,10,1679,778,901
Georgia,Sumter County,11,1868,863,1005
Georgia,Sumter County,12,1851,831,1020
Georgia,Sumter County,13,1714,786,928
Georgia,Sumter County,14,1655,718,937
Georgia,Sumter County,15,1376,626,750
Georgia,Sumter County,16,846,373,473
Georgia,Sumter County,17,571,218,353
Georgia,Sumter County,18,531,171,360
Georgia,Talbot County,0,6272,3002,3270
Georgia,Talbot County,1,257,141,116
Georgia,Talbot County,2,267,127,140
Georgia,Talbot County,3,309,154,155
Georgia,Talbot County,4,308,137,171
Georgia,Talbot County,5,281,138,143
Georgia,Talbot County,6,378,180,198
Georgia,Talbot County,7,284,139,145
Georgia,Talbot County,8,317,164,153
Georgia,Talbot County,9,295,165,130
Georgia,Talbot County,10,379,183,196
Georgia,Talbot County,11,478,206,272
Georgia,Talbot County,12,592,292,300
Georgia,Talbot County,13,598,269,329
Georgia,Talbot County,14,542,278,264
Georgia,Talbot County,15,399,196,203
Georgia,Talbot County,16,297,123,174
Georgia,Talbot County,17,157,69,88
Georgia,Talbot County,18,134,41,93
Georgia,Taliaferro County,0,1608,796,812
Georgia,Taliaferro County,1,66,33,33
Georgia,Taliaferro County,2,91,50,41
Georgia,Taliaferro County,3,73,33,40
Georgia,Taliaferro County,4,65,36,29
Georgia,Taliaferro County,5,81,43,38
Georgia,Taliaferro County,6,89,46,43
Georgia,Taliaferro County,7,84,45,39
Georgia,Taliaferro County,8,80,39,41
Georgia,Taliaferro County,9,95,61,34
Georgia,Taliaferro County,10,84,42,42
Georgia,Taliaferro County,11,123,54,69
Georgia,Taliaferro County,12,130,69,61
Georgia,Taliaferro County,13,124,61,63
Georgia,Taliaferro County,14,130,59,71
Georgia,Taliaferro County,15,110,57,53
Georgia,Taliaferro County,16,70,42,28
Georgia,Taliaferro County,17,44,14,30
Georgia,Taliaferro County,18,69,12,57
Georgia,Tattnall County,0,25391,14640,10751
Georgia,Tattnall County,1,1279,658,621
Georgia,Tattnall County,2,1527,800,727
Georgia,Tattnall County,3,1476,762,714
Georgia,Tattnall County,4,1424,783,641
Georgia,Tattnall County,5,1828,1243,585
Georgia,Tattnall County,6,2135,1468,667
Georgia,Tattnall County,7,1991,1353,638
Georgia,Tattnall County,8,1825,1183,642
Georgia,Tattnall County,9,1722,1081,641
Georgia,Tattnall County,10,1785,1122,663
Georgia,Tattnall County,11,1712,1006,706
Georgia,Tattnall County,12,1592,865,727
Georgia,Tattnall County,13,1466,731,735
Georgia,Tattnall County,14,1214,576,638
Georgia,Tattnall County,15,958,453,505
Georgia,Tattnall County,16,676,288,388
Georgia,Tattnall County,17,452,173,279
Georgia,Tattnall County,18,329,95,234
Georgia,Taylor County,0,8039,3842,4197
Georgia,Taylor County,1,402,202,200
Georgia,Taylor County,2,447,213,234
Georgia,Taylor County,3,478,242,236
Georgia,Taylor County,4,467,248,219
Georgia,Taylor County,5,426,206,220
Georgia,Taylor County,6,565,277,288
Georgia,Taylor County,7,378,187,191
Georgia,Taylor County,8,415,218,197
Georgia,Taylor County,9,475,228,247
Georgia,Taylor County,10,577,280,297
Georgia,Taylor County,11,549,274,275
Georgia,Taylor County,12,628,302,326
Georgia,Taylor County,13,606,276,330
Georgia,Taylor County,14,522,232,290
Georgia,Taylor County,15,424,179,245
Georgia,Taylor County,16,331,146,185
Georgia,Taylor County,17,173,71,102
Georgia,Taylor County,18,176,61,115
Georgia,Telfair County,0,15876,9284,6592
Georgia,Telfair County,1,626,318,308
Georgia,Telfair County,2,647,312,335
Georgia,Telfair County,3,776,398,378
Georgia,Telfair County,4,788,425,363
Georgia,Telfair County,5,915,598,317
Georgia,Telfair County,6,1146,783,363
Georgia,Telfair County,7,1313,942,371
Georgia,Telfair County,8,1268,928,340
Georgia,Telfair County,9,1187,801,386
Georgia,Telfair County,10,1142,741,401
Georgia,Telfair County,11,1071,616,455
Georgia,Telfair County,12,1061,593,468
Georgia,Telfair County,13,1063,571,492
Georgia,Telfair County,14,879,429,450
Georgia,Telfair County,15,709,332,377
Georgia,Telfair County,16,519,230,289
Georgia,Telfair County,17,338,130,208
Georgia,Telfair County,18,428,137,291
Georgia,Terrell County,0,8611,4122,4489
Georgia,Terrell County,1,507,251,256
Georgia,Terrell County,2,554,291,263
Georgia,Terrell County,3,591,289,302
Georgia,Terrell County,4,526,281,245
Georgia,Terrell County,5,493,265,228
Georgia,Terrell County,6,612,304,308
Georgia,Terrell County,7,478,259,219
Georgia,Terrell County,8,489,232,257
Georgia,Terrell County,9,403,207,196
Georgia,Terrell County,10,444,208,236
Georgia,Terrell County,11,573,259,314
Georgia,Terrell County,12,622,292,330
Georgia,Terrell County,13,611,275,336
Georgia,Terrell County,14,534,240,294
Georgia,Terrell County,15,445,192,253
Georgia,Terrell County,16,318,132,186
Georgia,Terrell County,17,232,94,138
Georgia,Terrell County,18,179,51,128
Georgia,Thomas County,0,44448,21047,23401
Georgia,Thomas County,1,2789,1417,1372
Georgia,Thomas County,2,2943,1525,1418
Georgia,Thomas County,3,3063,1565,1498
Georgia,Thomas County,4,2763,1391,1372
Georgia,Thomas County,5,2515,1228,1287
Georgia,Thomas County,6,2702,1246,1456
Georgia,Thomas County,7,2602,1181,1421
Georgia,Thomas County,8,2713,1332,1381
Georgia,Thomas County,9,2429,1131,1298
Georgia,Thomas County,10,2797,1315,1482
Georgia,Thomas County,11,2969,1430,1539
Georgia,Thomas County,12,3114,1454,1660
Georgia,Thomas County,13,2918,1385,1533
Georgia,Thomas County,14,2594,1165,1429
Georgia,Thomas County,15,2121,876,1245
Georgia,Thomas County,16,1552,696,856
Georgia,Thomas County,17,979,407,572
Georgia,Thomas County,18,885,303,582
Georgia,Tift County,0,40571,19622,20949
Georgia,Tift County,1,2787,1500,1287
Georgia,Tift County,2,2798,1427,1371
Georgia,Tift County,3,2852,1431,1421
Georgia,Tift County,4,3147,1548,1599
Georgia,Tift County,5,2878,1418,1460
Georgia,Tift County,6,2788,1404,1384
Georgia,Tift County,7,2677,1305,1372
Georgia,Tift County,8,2578,1268,1310
Georgia,Tift County,9,2349,1157,1192
Georgia,Tift County,10,2407,1149,1258
Georgia,Tift County,11,2457,1219,1238
Georgia,Tift County,12,2418,1156,1262
Georgia,Tift County,13,2398,1103,1295
Georgia,Tift County,14,1859,828,1031
Georgia,Tift County,15,1602,715,887
Georgia,Tift County,16,1180,508,672
Georgia,Tift County,17,708,278,430
Georgia,Tift County,18,688,208,480
Georgia,Toombs County,0,26887,12781,14106
Georgia,Toombs County,1,1916,995,921
Georgia,Toombs County,2,1910,966,944
Georgia,Toombs County,3,2119,1120,999
Georgia,Toombs County,4,1838,942,896
Georgia,Toombs County,5,1610,797,813
Georgia,Toombs County,6,1685,789,896
Georgia,Toombs County,7,1691,766,925
Georgia,Toombs County,8,1640,822,818
Georgia,Toombs County,9,1517,692,825
Georgia,Toombs County,10,1630,761,869
Georgia,Toombs County,11,1641,749,892
Georgia,Toombs County,12,1673,788,885
Georgia,Toombs County,13,1618,767,851
Georgia,Toombs County,14,1390,643,747
Georgia,Toombs County,15,1159,529,630
Georgia,Toombs County,16,821,328,493
Georgia,Toombs County,17,531,189,342
Georgia,Toombs County,18,498,138,360
Georgia,Towns County,0,11852,5658,6194
Georgia,Towns County,1,427,215,212
Georgia,Towns County,2,379,200,179
Georgia,Towns County,3,426,222,204
Georgia,Towns County,4,1099,514,585
Georgia,Towns County,5,793,409,384
Georgia,Towns County,6,462,254,208
Georgia,Towns County,7,412,197,215
Georgia,Towns County,8,393,197,196
Georgia,Towns County,9,453,216,237
Georgia,Towns County,10,561,273,288
Georgia,Towns County,11,626,307,319
Georgia,Towns County,12,766,355,411
Georgia,Towns County,13,962,429,533
Georgia,Towns County,14,1130,506,624
Georgia,Towns County,15,1095,541,554
Georgia,Towns County,16,845,377,468
Georgia,Towns County,17,550,257,293
Georgia,Towns County,18,473,189,284
Georgia,Treutlen County,0,6809,3386,3423
Georgia,Treutlen County,1,399,185,214
Georgia,Treutlen County,2,432,211,221
Georgia,Treutlen County,3,454,220,234
Georgia,Treutlen County,4,420,209,211
Georgia,Treutlen County,5,466,309,157
Georgia,Treutlen County,6,464,254,210
Georgia,Treutlen County,7,416,208,208
Georgia,Treutlen County,8,456,219,237
Georgia,Treutlen County,9,360,195,165
Georgia,Treutlen County,10,402,211,191
Georgia,Treutlen County,11,395,213,182
Georgia,Treutlen County,12,425,203,222
Georgia,Treutlen County,13,465,220,245
Georgia,Treutlen County,14,410,208,202
Georgia,Treutlen County,15,310,134,176
Georgia,Treutlen County,16,211,84,127
Georgia,Treutlen County,17,168,53,115
Georgia,Treutlen County,18,156,50,106
Georgia,Troup County,0,70034,33785,36249
Georgia,Troup County,1,4479,2365,2114
Georgia,Troup County,2,4579,2355,2224
Georgia,Troup County,3,4993,2518,2475
Georgia,Troup County,4,4797,2471,2326
Georgia,Troup County,5,4818,2461,2357
Georgia,Troup County,6,5107,2487,2620
Georgia,Troup County,7,4604,2169,2435
Georgia,Troup County,8,4451,2187,2264
Georgia,Troup County,9,4036,1862,2174
Georgia,Troup County,10,4433,2080,2353
Georgia,Troup County,11,4564,2226,2338
Georgia,Troup County,12,4526,2155,2371
Georgia,Troup County,13,4253,2006,2247
Georgia,Troup County,14,3429,1569,1860
Georgia,Troup County,15,2762,1266,1496
Georgia,Troup County,16,1770,793,977
Georgia,Troup County,17,1156,428,728
Georgia,Troup County,18,1277,387,890
Georgia,Turner County,0,7912,3844,4068
Georgia,Turner County,1,564,274,290
Georgia,Turner County,2,487,248,239
Georgia,Turner County,3,563,287,276
Georgia,Turner County,4,488,244,244
Georgia,Turner County,5,534,300,234
Georgia,Turner County,6,506,282,224
Georgia,Turner County,7,499,263,236
Georgia,Turner County,8,427,215,212
Georgia,Turner County,9,426,222,204
Georgia,Turner County,10,422,200,222
Georgia,Turner County,11,486,214,272
Georgia,Turner County,12,490,231,259
Georgia,Turner County,13,448,208,240
Georgia,Turner County,14,464,219,245
Georgia,Turner County,15,427,177,250
Georgia,Turner County,16,289,114,175
Georgia,Turner County,17,196,87,109
Georgia,Turner County,18,196,59,137
Georgia,Twiggs County,0,8188,4017,4171
Georgia,Twiggs County,1,428,200,228
Georgia,Twiggs County,2,421,208,213
Georgia,Twiggs County,3,461,246,215
Georgia,Twiggs County,4,402,204,198
Georgia,Twiggs County,5,376,196,180
Georgia,Twiggs County,6,486,243,243
Georgia,Twiggs County,7,460,241,219
Georgia,Twiggs County,8,420,221,199
Georgia,Twiggs County,9,413,215,198
Georgia,Twiggs County,10,473,232,241
Georgia,Twiggs County,11,607,308,299
Georgia,Twiggs County,12,693,343,350
Georgia,Twiggs County,13,686,316,370
Georgia,Twiggs County,14,604,303,301
Georgia,Twiggs County,15,541,240,301
Georgia,Twiggs County,16,362,169,193
Georgia,Twiggs County,17,222,87,135
Georgia,Twiggs County,18,133,45,88
Georgia,Union County,0,24001,11619,12382
Georgia,Union County,1,894,459,435
Georgia,Union County,2,950,473,477
Georgia,Union County,3,1237,627,610
Georgia,Union County,4,1133,597,536
Georgia,Union County,5,1041,561,480
Georgia,Union County,6,1020,508,512
Georgia,Union County,7,946,469,477
Georgia,Union County,8,1028,510,518
Georgia,Union County,9,1031,488,543
Georgia,Union County,10,1217,584,633
Georgia,Union County,11,1457,664,793
Georgia,Union County,12,1956,938,1018
Georgia,Union County,13,2168,1003,1165
Georgia,Union County,14,2441,1153,1288
Georgia,Union County,15,2215,1076,1139
Georgia,Union County,16,1540,764,776
Georgia,Union County,17,926,434,492
Georgia,Union County,18,801,311,490
Georgia,Upson County,0,26215,12447,13768
Georgia,Upson County,1,1637,836,801
Georgia,Upson County,2,1621,784,837
Georgia,Upson County,3,1593,771,822
Georgia,Upson County,4,1568,804,764
Georgia,Upson County,5,1544,761,783
Georgia,Upson County,6,1776,864,912
Georgia,Upson County,7,1388,679,709
Georgia,Upson County,8,1458,678,780
Georgia,Upson County,9,1523,728,795
Georgia,Upson County,10,1700,824,876
Georgia,Upson County,11,1770,841,929
Georgia,Upson County,12,1975,923,1052
Georgia,Upson County,13,1819,854,965
Georgia,Upson County,14,1557,738,819
Georgia,Upson County,15,1246,570,676
Georgia,Upson County,16,939,400,539
Georgia,Upson County,17,581,222,359
Georgia,Upson County,18,520,170,350
Georgia,Walker County,0,69410,34154,35256
Georgia,Walker County,1,3904,2010,1894
Georgia,Walker County,2,4047,2077,1970
Georgia,Walker County,3,4344,2265,2079
Georgia,Walker County,4,4289,2270,2019
Georgia,Walker County,5,3834,2014,1820
Georgia,Walker County,6,4332,2210,2122
Georgia,Walker County,7,4054,1998,2056
Georgia,Walker County,8,4273,2067,2206
Georgia,Walker County,9,4404,2179,2225
Georgia,Walker County,10,4704,2364,2340
Georgia,Walker County,11,4600,2314,2286
Georgia,Walker County,12,4852,2403,2449
Georgia,Walker County,13,4897,2364,2533
Georgia,Walker County,14,3950,1799,2151
Georgia,Walker County,15,3393,1562,1831
Georgia,Walker County,16,2527,1096,1431
Georgia,Walker County,17,1534,645,889
Georgia,Walker County,18,1472,517,955
Georgia,Walton County,0,93503,45507,47996
Georgia,Walton County,1,5667,2933,2734
Georgia,Walton County,2,6091,3129,2962
Georgia,Walton County,3,6994,3545,3449
Georgia,Walton County,4,6658,3445,3213
Georgia,Walton County,5,5494,2795,2699
Georgia,Walton County,6,5992,2949,3043
Georgia,Walton County,7,5553,2665,2888
Georgia,Walton County,8,5745,2639,3106
Georgia,Walton County,9,5814,2792,3022
Georgia,Walton County,10,6641,3193,3448
Georgia,Walton County,11,6693,3242,3451
Georgia,Walton County,12,6270,3133,3137
Georgia,Walton County,13,5403,2577,2826
Georgia,Walton County,14,4716,2200,2516
Georgia,Walton County,15,3927,1858,2069
Georgia,Walton County,16,2820,1282,1538
Georgia,Walton County,17,1572,647,925
Georgia,Walton County,18,1453,483,970
Georgia,Ware County,0,35680,17853,17827
Georgia,Ware County,1,2436,1248,1188
Georgia,Ware County,2,2407,1259,1148
Georgia,Ware County,3,2436,1238,1198
Georgia,Ware County,4,2100,1077,1023
Georgia,Ware County,5,2188,1262,926
Georgia,Ware County,6,2616,1448,1168
Georgia,Ware County,7,2253,1201,1052
Georgia,Ware County,8,2193,1127,1066
Georgia,Ware County,9,1956,1005,951
Georgia,Ware County,10,2224,1173,1051
Georgia,Ware County,11,2181,1074,1107
Georgia,Ware County,12,2292,1116,1176
Georgia,Ware County,13,2231,1085,1146
Georgia,Ware County,14,1978,890,1088
Georgia,Ware County,15,1514,662,852
Georgia,Ware County,16,1098,457,641
Georgia,Ware County,17,726,283,443
Georgia,Ware County,18,851,248,603
Georgia,Warren County,0,5251,2488,2763
Georgia,Warren County,1,267,130,137
Georgia,Warren County,2,283,137,146
Georgia,Warren County,3,318,154,164
Georgia,Warren County,4,283,144,139
Georgia,Warren County,5,282,146,136
Georgia,Warren County,6,332,173,159
Georgia,Warren County,7,249,114,135
Georgia,Warren County,8,264,130,134
Georgia,Warren County,9,258,131,127
Georgia,Warren County,10,317,145,172
Georgia,Warren County,11,372,171,201
Georgia,Warren County,12,401,196,205
Georgia,Warren County,13,434,209,225
Georgia,Warren County,14,357,160,197
Georgia,Warren County,15,307,131,176
Georgia,Warren County,16,235,109,126
Georgia,Warren County,17,138,68,70
Georgia,Warren County,18,154,40,114
Georgia,Washington County,0,20386,10399,9987
Georgia,Washington County,1,1155,578,577
Georgia,Washington County,2,1226,657,569
Georgia,Washington County,3,1294,632,662
Georgia,Washington County,4,1160,632,528
Georgia,Washington County,5,1279,747,532
Georgia,Washington County,6,1463,844,619
Georgia,Washington County,7,1268,733,535
Georgia,Washington County,8,1287,693,594
Georgia,Washington County,9,1135,631,504
Georgia,Washington County,10,1247,685,562
Georgia,Washington County,11,1425,708,717
Georgia,Washington County,12,1569,775,794
Georgia,Washington County,13,1338,627,711
Georgia,Washington County,14,1153,523,630
Georgia,Washington County,15,878,413,465
Georgia,Washington County,16,638,253,385
Georgia,Washington County,17,432,156,276
Georgia,Washington County,18,439,112,327
Georgia,Wayne County,0,29808,15284,14524
Georgia,Wayne County,1,1928,1010,918
Georgia,Wayne County,2,1975,999,976
Georgia,Wayne County,3,2119,1094,1025
Georgia,Wayne County,4,1875,957,918
Georgia,Wayne County,5,1674,913,761
Georgia,Wayne County,6,2053,1113,940
Georgia,Wayne County,7,1948,1032,916
Georgia,Wayne County,8,1969,1059,910
Georgia,Wayne County,9,1845,1036,809
Georgia,Wayne County,10,1984,1059,925
Georgia,Wayne County,11,1945,987,958
Georgia,Wayne County,12,1965,980,985
Georgia,Wayne County,13,1806,879,927
Georgia,Wayne County,14,1553,765,788
Georgia,Wayne County,15,1312,604,708
Georgia,Wayne County,16,862,364,498
Georgia,Wayne County,17,528,236,292
Georgia,Wayne County,18,467,197,270
Georgia,Webster County,0,2611,1303,1308
Georgia,Webster County,1,121,71,50
Georgia,Webster County,2,117,57,60
Georgia,Webster County,3,157,69,88
Georgia,Webster County,4,172,78,94
Georgia,Webster County,5,151,82,69
Georgia,Webster County,6,134,67,67
Georgia,Webster County,7,110,64,46
Georgia,Webster County,8,115,49,66
Georgia,Webster County,9,129,66,63
Georgia,Webster County,10,180,92,88
Georgia,Webster County,11,222,114,108
Georgia,Webster County,12,184,87,97
Georgia,Webster County,13,202,90,112
Georgia,Webster County,14,186,95,91
Georgia,Webster County,15,154,80,74
Georgia,Webster County,16,111,55,56
Georgia,Webster County,17,73,39,34
Georgia,Webster County,18,93,48,45
Georgia,Wheeler County,0,7879,5095,2784
Georgia,Wheeler County,1,354,173,181
Georgia,Wheeler County,2,353,171,182
Georgia,Wheeler County,3,393,203,190
Georgia,Wheeler County,4,401,228,173
Georgia,Wheeler County,5,620,488,132
Georgia,Wheeler County,6,735,587,148
Georgia,Wheeler County,7,669,529,140
Georgia,Wheeler County,8,552,406,146
Georgia,Wheeler County,9,616,466,150
Georgia,Wheeler County,10,630,482,148
Georgia,Wheeler County,11,511,337,174
Georgia,Wheeler County,12,488,288,200
Georgia,Wheeler County,13,405,199,206
Georgia,Wheeler County,14,363,177,186
Georgia,Wheeler County,15,306,155,151
Georgia,Wheeler County,16,218,100,118
Georgia,Wheeler County,17,123,60,63
Georgia,Wheeler County,18,142,46,96
Georgia,White County,0,29970,14619,15351
Georgia,White County,1,1394,672,722
Georgia,White County,2,1595,802,793
Georgia,White County,3,1854,963,891
Georgia,White County,4,1901,967,934
Georgia,White County,5,1841,969,872
Georgia,White County,6,1690,860,830
Georgia,White County,7,1430,718,712
Georgia,White County,8,1480,744,736
Georgia,White County,9,1626,772,854
Georgia,White County,10,1908,945,963
Georgia,White County,11,1965,953,1012
Georgia,White County,12,2241,1049,1192
Georgia,White County,13,2155,1048,1107
Georgia,White County,14,2117,939,1178
Georgia,White County,15,1934,931,1003
Georgia,White County,16,1389,642,747
Georgia,White County,17,814,384,430
Georgia,White County,18,636,261,375
Georgia,Whitfield County,0,104062,51848,52214
Georgia,Whitfield County,1,6798,3408,3390
Georgia,Whitfield County,2,7296,3751,3545
Georgia,Whitfield County,3,8025,4118,3907
Georgia,Whitfield County,4,7515,3914,3601
Georgia,Whitfield County,5,6863,3527,3336
Georgia,Whitfield County,6,7327,3846,3481
Georgia,Whitfield County,7,6619,3368,3251
Georgia,Whitfield County,8,6666,3374,3292
Georgia,Whitfield County,9,6425,3199,3226
Georgia,Whitfield County,10,7056,3496,3560
Georgia,Whitfield County,11,6866,3432,3434
Georgia,Whitfield County,12,6413,3171,3242
Georgia,Whitfield County,13,5573,2702,2871
Georgia,Whitfield County,14,4624,2192,2432
Georgia,Whitfield County,15,3775,1788,1987
Georgia,Whitfield County,16,2788,1279,1509
Georgia,Whitfield County,17,1792,731,1061
Georgia,Whitfield County,18,1641,552,1089
Georgia,Wilcox County,0,8812,5264,3548
Georgia,Wilcox County,1,482,245,237
Georgia,Wilcox County,2,451,254,197
Georgia,Wilcox County,3,473,257,216
Georgia,Wilcox County,4,448,241,207
Georgia,Wilcox County,5,592,401,191
Georgia,Wilcox County,6,664,460,204
Georgia,Wilcox County,7,654,460,194
Georgia,Wilcox County,8,619,425,194
Georgia,Wilcox County,9,601,424,177
Georgia,Wilcox County,10,607,411,196
Georgia,Wilcox County,11,579,360,219
Georgia,Wilcox County,12,529,305,224
Georgia,Wilcox County,13,522,284,238
Georgia,Wilcox County,14,463,238,225
Georgia,Wilcox County,15,410,192,218
Georgia,Wilcox County,16,309,146,163
Georgia,Wilcox County,17,205,97,108
Georgia,Wilcox County,18,204,64,140
Georgia,Wilkes County,0,9876,4741,5135
Georgia,Wilkes County,1,511,272,239
Georgia,Wilkes County,2,598,326,272
Georgia,Wilkes County,3,628,324,304
Georgia,Wilkes County,4,573,267,306
Georgia,Wilkes County,5,507,269,238
Georgia,Wilkes County,6,552,287,265
Georgia,Wilkes County,7,492,253,239
Georgia,Wilkes County,8,496,222,274
Georgia,Wilkes County,9,485,226,259
Georgia,Wilkes County,10,578,285,293
Georgia,Wilkes County,11,676,343,333
Georgia,Wilkes County,12,731,337,394
Georgia,Wilkes County,13,767,355,412
Georgia,Wilkes County,14,609,255,354
Georgia,Wilkes County,15,611,290,321
Georgia,Wilkes County,16,451,214,237
Georgia,Wilkes County,17,306,122,184
Georgia,Wilkes County,18,305,94,211
Georgia,Wilkinson County,0,9036,4323,4713
Georgia,Wilkinson County,1,506,267,239
Georgia,Wilkinson County,2,575,281,294
Georgia,Wilkinson County,3,612,311,301
Georgia,Wilkinson County,4,563,271,292
Georgia,Wilkinson County,5,490,249,241
Georgia,Wilkinson County,6,495,228,267
Georgia,Wilkinson County,7,495,244,251
Georgia,Wilkinson County,8,543,267,276
Georgia,Wilkinson County,9,434,216,218
Georgia,Wilkinson County,10,523,229,294
Georgia,Wilkinson County,11,629,319,310
Georgia,Wilkinson County,12,698,357,341
Georgia,Wilkinson County,13,722,346,376
Georgia,Wilkinson County,14,523,248,275
Georgia,Wilkinson County,15,428,187,241
Georgia,Wilkinson County,16,365,151,214
Georgia,Wilkinson County,17,243,91,152
Georgia,Wilkinson County,18,192,61,131
Georgia,Worth County,0,20299,9752,10547
Georgia,Worth County,1,1181,591,590
Georgia,Worth County,2,1254,623,631
Georgia,Worth County,3,1311,664,647
Georgia,Worth County,4,1221,613,608
Georgia,Worth County,5,1134,565,569
Georgia,Worth County,6,1309,655,654
Georgia,Worth County,7,1186,573,613
Georgia,Worth County,8,1097,520,577
Georgia,Worth County,9,1077,514,563
Georgia,Worth County,10,1290,602,688
Georgia,Worth County,11,1393,667,726
Georgia,Worth County,12,1556,763,793
Georgia,Worth County,13,1418,707,711
Georgia,Worth County,14,1246,589,657
Georgia,Worth County,15,1063,477,586
Georgia,Worth County,16,763,328,435
Georgia,Worth County,17,428,188,240
Georgia,Worth County,18,372,113,259
Hawaii,Hawaii County,0,200983,99602,101381
Hawaii,Hawaii County,1,11890,6084,5806
Hawaii,Hawaii County,2,12621,6398,6223
Hawaii,Hawaii County,3,12109,6206,5903
Hawaii,Hawaii County,4,11047,5628,5419
Hawaii,Hawaii County,5,10039,5005,5034
Hawaii,Hawaii County,6,11769,5857,5912
Hawaii,Hawaii County,7,12178,6032,6146
Hawaii,Hawaii County,8,12579,6258,6321
Hawaii,Hawaii County,9,11429,5664,5765
Hawaii,Hawaii County,10,11531,5676,5855
Hawaii,Hawaii County,11,11771,5789,5982
Hawaii,Hawaii County,12,13939,6745,7194
Hawaii,Hawaii County,13,16049,7810,8239
Hawaii,Hawaii County,14,15611,7843,7768
Hawaii,Hawaii County,15,11114,5756,5358
Hawaii,Hawaii County,16,6284,3177,3107
Hawaii,Hawaii County,17,3953,1778,2175
Hawaii,Hawaii County,18,5070,1896,3174
Hawaii,Honolulu County,0,980080,492574,487506
Hawaii,Honolulu County,1,61601,31629,29972
Hawaii,Honolulu County,2,59369,30388,28981
Hawaii,Honolulu County,3,55318,28437,26881
Hawaii,Honolulu County,4,53103,27568,25535
Hawaii,Honolulu County,5,69305,39387,29918
Hawaii,Honolulu County,6,77917,41886,36031
Hawaii,Honolulu County,7,71217,37063,34154
Hawaii,Honolulu County,8,67535,34442,33093
Hawaii,Honolulu County,9,57545,29160,28385
Hawaii,Honolulu County,10,58804,29705,29099
Hawaii,Honolulu County,11,57891,28861,29030
Hawaii,Honolulu County,12,59813,29820,29993
Hawaii,Honolulu County,13,56869,27530,29339
Hawaii,Honolulu County,14,51002,24201,26801
Hawaii,Honolulu County,15,43423,20296,23127
Hawaii,Honolulu County,16,28897,13062,15835
Hawaii,Honolulu County,17,20319,8458,11861
Hawaii,Honolulu County,18,30152,10681,19471
Hawaii,Kalawao County,0,88,41,47
Hawaii,Kalawao County,1,0,0,0
Hawaii,Kalawao County,2,0,0,0
Hawaii,Kalawao County,3,0,0,0
Hawaii,Kalawao County,4,0,0,0
Hawaii,Kalawao County,5,0,0,0
Hawaii,Kalawao County,6,0,0,0
Hawaii,Kalawao County,7,7,4,3
Hawaii,Kalawao County,8,4,2,2
Hawaii,Kalawao County,9,3,1,2
Hawaii,Kalawao County,10,6,3,3
Hawaii,Kalawao County,11,10,8,2
Hawaii,Kalawao County,12,8,5,3
Hawaii,Kalawao County,13,13,7,6
Hawaii,Kalawao County,14,11,7,4
Hawaii,Kalawao County,15,2,0,2
Hawaii,Kalawao County,16,4,1,3
Hawaii,Kalawao County,17,6,0,6
Hawaii,Kalawao County,18,14,3,11
Hawaii,Kauai County,0,72133,35607,36526
Hawaii,Kauai County,1,4375,2199,2176
Hawaii,Kauai County,2,4521,2340,2181
Hawaii,Kauai County,3,4348,2251,2097
Hawaii,Kauai County,4,3850,1961,1889
Hawaii,Kauai County,5,3517,1779,1738
Hawaii,Kauai County,6,4318,2178,2140
Hawaii,Kauai County,7,4441,2253,2188
Hawaii,Kauai County,8,4841,2396,2445
Hawaii,Kauai County,9,4218,2067,2151
Hawaii,Kauai County,10,4442,2254,2188
Hawaii,Kauai County,11,4464,2179,2285
Hawaii,Kauai County,12,5005,2506,2499
Hawaii,Kauai County,13,5254,2547,2707
Hawaii,Kauai County,14,5120,2547,2573
Hawaii,Kauai County,15,3748,1829,1919
Hawaii,Kauai County,16,2292,1072,1220
Hawaii,Kauai County,17,1346,553,793
Hawaii,Kauai County,18,2033,696,1337
Hawaii,Maui County,0,167207,83178,84029
Hawaii,Maui County,1,9838,5093,4745
Hawaii,Maui County,2,10358,5455,4903
Hawaii,Maui County,3,10179,5121,5058
Hawaii,Maui County,4,9179,4677,4502
Hawaii,Maui County,5,8090,3989,4101
Hawaii,Maui County,6,9973,5016,4957
Hawaii,Maui County,7,11186,5545,5641
Hawaii,Maui County,8,11837,5967,5870
Hawaii,Maui County,9,10519,5300,5219
Hawaii,Maui County,10,10722,5480,5242
Hawaii,Maui County,11,10983,5411,5572
Hawaii,Maui County,12,12042,5985,6057
Hawaii,Maui County,13,11735,5757,5978
Hawaii,Maui County,14,10748,5334,5414
Hawaii,Maui County,15,8154,4016,4138
Hawaii,Maui County,16,4918,2358,2560
Hawaii,Maui County,17,2971,1290,1681
Hawaii,Maui County,18,3775,1384,2391
Idaho,Ada County,0,469966,235266,234700
Idaho,Ada County,1,27274,13921,13353
Idaho,Ada County,2,30425,15334,15091
Idaho,Ada County,3,34003,17349,16654
Idaho,Ada County,4,32409,16738,15671
Idaho,Ada County,5,28173,14818,13355
Idaho,Ada County,6,33646,17320,16326
Idaho,Ada County,7,33633,17219,16414
Idaho,Ada County,8,34897,17789,17108
Idaho,Ada County,9,31340,15923,15417
Idaho,Ada County,10,31244,16020,15224
Idaho,Ada County,11,28515,14329,14186
Idaho,Ada County,12,29299,14379,14920
Idaho,Ada County,13,27316,13021,14295
Idaho,Ada County,14,23749,11247,12502
Idaho,Ada County,15,18278,8813,9465
Idaho,Ada County,16,11517,5268,6249
Idaho,Ada County,17,7059,3047,4012
Idaho,Ada County,18,7189,2731,4458
Idaho,Adams County,0,4250,2211,2039
Idaho,Adams County,1,169,85,84
Idaho,Adams County,2,227,142,85
Idaho,Adams County,3,226,118,108
Idaho,Adams County,4,195,102,93
Idaho,Adams County,5,132,67,65
Idaho,Adams County,6,183,102,81
Idaho,Adams County,7,176,91,85
Idaho,Adams County,8,186,98,88
Idaho,Adams County,9,198,94,104
Idaho,Adams County,10,213,116,97
Idaho,Adams County,11,221,103,118
Idaho,Adams County,12,382,167,215
Idaho,Adams County,13,521,270,251
Idaho,Adams County,14,456,246,210
Idaho,Adams County,15,315,178,137
Idaho,Adams County,16,227,121,106
Idaho,Adams County,17,123,71,52
Idaho,Adams County,18,100,40,60
Idaho,Bannock County,0,87138,43328,43810
Idaho,Bannock County,1,6205,3101,3104
Idaho,Bannock County,2,6245,3204,3041
Idaho,Bannock County,3,6497,3306,3191
Idaho,Bannock County,4,6668,3463,3205
Idaho,Bannock County,5,6248,3248,3000
Idaho,Bannock County,6,6748,3395,3353
Idaho,Bannock County,7,6165,3109,3056
Idaho,Bannock County,8,6038,3014,3024
Idaho,Bannock County,9,5049,2526,2523
Idaho,Bannock County,10,4577,2227,2350
Idaho,Bannock County,11,4248,2094,2154
Idaho,Bannock County,12,4956,2401,2555
Idaho,Bannock County,13,5094,2429,2665
Idaho,Bannock County,14,4340,2147,2193
Idaho,Bannock County,15,3280,1592,1688
Idaho,Bannock County,16,2094,985,1109
Idaho,Bannock County,17,1370,578,792
Idaho,Bannock County,18,1316,509,807
Idaho,Bear Lake County,0,6050,3017,3033
Idaho,Bear Lake County,1,405,216,189
Idaho,Bear Lake County,2,472,234,238
Idaho,Bear Lake County,3,442,210,232
Idaho,Bear Lake County,4,444,226,218
Idaho,Bear Lake County,5,282,137,145
Idaho,Bear Lake County,6,298,166,132
Idaho,Bear Lake County,7,344,168,176
Idaho,Bear Lake County,8,338,183,155
Idaho,Bear Lake County,9,334,154,180
Idaho,Bear Lake County,10,305,161,144
Idaho,Bear Lake County,11,308,139,169
Idaho,Bear Lake County,12,399,205,194
Idaho,Bear Lake County,13,431,221,210
Idaho,Bear Lake County,14,394,194,200
Idaho,Bear Lake County,15,336,174,162
Idaho,Bear Lake County,16,213,96,117
Idaho,Bear Lake County,17,155,61,94
Idaho,Bear Lake County,18,150,72,78
Idaho,Benewah County,0,9226,4718,4508
Idaho,Benewah County,1,526,284,242
Idaho,Benewah County,2,601,295,306
Idaho,Benewah County,3,597,333,264
Idaho,Benewah County,4,529,271,258
Idaho,Benewah County,5,412,221,191
Idaho,Benewah County,6,462,232,230
Idaho,Benewah County,7,436,211,225
Idaho,Benewah County,8,468,249,219
Idaho,Benewah County,9,473,243,230
Idaho,Benewah County,10,494,241,253
Idaho,Benewah County,11,622,319,303
Idaho,Benewah County,12,702,348,354
Idaho,Benewah County,13,831,404,427
Idaho,Benewah County,14,698,356,342
Idaho,Benewah County,15,579,293,286
Idaho,Benewah County,16,413,231,182
Idaho,Benewah County,17,225,115,110
Idaho,Benewah County,18,158,72,86
Idaho,Bingham County,0,46236,23036,23200
Idaho,Bingham County,1,3453,1721,1732
Idaho,Bingham County,2,3993,1988,2005
Idaho,Bingham County,3,4354,2204,2150
Idaho,Bingham County,4,3663,1948,1715
Idaho,Bingham County,5,2637,1354,1283
Idaho,Bingham County,6,2786,1358,1428
Idaho,Bingham County,7,2806,1354,1452
Idaho,Bingham County,8,2989,1489,1500
Idaho,Bingham County,9,2761,1383,1378
Idaho,Bingham County,10,2402,1212,1190
Idaho,Bingham County,11,2334,1127,1207
Idaho,Bingham County,12,2740,1396,1344
Idaho,Bingham County,13,2723,1362,1361
Idaho,Bingham County,14,2237,1086,1151
Idaho,Bingham County,15,1650,804,846
Idaho,Bingham County,16,1186,587,599
Idaho,Bingham County,17,788,363,425
Idaho,Bingham County,18,734,300,434
Idaho,Blaine County,0,22601,11456,11145
Idaho,Blaine County,1,1085,556,529
Idaho,Blaine County,2,1304,686,618
Idaho,Blaine County,3,1604,861,743
Idaho,Blaine County,4,1485,742,743
Idaho,Blaine County,5,1078,563,515
Idaho,Blaine County,6,1107,634,473
Idaho,Blaine County,7,1214,637,577
Idaho,Blaine County,8,1394,707,687
Idaho,Blaine County,9,1409,721,688
Idaho,Blaine County,10,1498,735,763
Idaho,Blaine County,11,1556,779,777
Idaho,Blaine County,12,1761,795,966
Idaho,Blaine County,13,1671,835,836
Idaho,Blaine County,14,1610,789,821
Idaho,Blaine County,15,1207,585,622
Idaho,Blaine County,16,874,466,408
Idaho,Blaine County,17,410,214,196
Idaho,Blaine County,18,334,151,183
Idaho,Boise County,0,7634,3975,3659
Idaho,Boise County,1,275,152,123
Idaho,Boise County,2,318,171,147
Idaho,Boise County,3,406,226,180
Idaho,Boise County,4,427,234,193
Idaho,Boise County,5,251,122,129
Idaho,Boise County,6,307,138,169
Idaho,Boise County,7,307,168,139
Idaho,Boise County,8,360,165,195
Idaho,Boise County,9,401,197,204
Idaho,Boise County,10,461,236,225
Idaho,Boise County,11,558,256,302
Idaho,Boise County,12,762,403,359
Idaho,Boise County,13,882,439,443
Idaho,Boise County,14,751,386,365
Idaho,Boise County,15,564,334,230
Idaho,Boise County,16,330,199,131
Idaho,Boise County,17,144,85,59
Idaho,Boise County,18,130,64,66
Idaho,Bonner County,0,44727,22306,22421
Idaho,Bonner County,1,2265,1095,1170
Idaho,Bonner County,2,2340,1162,1178
Idaho,Bonner County,3,2563,1358,1205
Idaho,Bonner County,4,2457,1241,1216
Idaho,Bonner County,5,1865,947,918
Idaho,Bonner County,6,2085,1060,1025
Idaho,Bonner County,7,2221,1116,1105
Idaho,Bonner County,8,2451,1211,1240
Idaho,Bonner County,9,2461,1212,1249
Idaho,Bonner County,10,2547,1254,1293
Idaho,Bonner County,11,2721,1329,1392
Idaho,Bonner County,12,3630,1743,1887
Idaho,Bonner County,13,4148,2015,2133
Idaho,Bonner County,14,4007,2043,1964
Idaho,Bonner County,15,2947,1582,1365
Idaho,Bonner County,16,2003,1016,987
Idaho,Bonner County,17,1044,524,520
Idaho,Bonner County,18,972,398,574
Idaho,Bonneville County,0,116854,58375,58479
Idaho,Bonneville County,1,9772,5089,4683
Idaho,Bonneville County,2,10198,5147,5051
Idaho,Bonneville County,3,10205,5269,4936
Idaho,Bonneville County,4,8612,4373,4239
Idaho,Bonneville County,5,7015,3544,3471
Idaho,Bonneville County,6,8029,3953,4076
Idaho,Bonneville County,7,7970,4015,3955
Idaho,Bonneville County,8,8336,4231,4105
Idaho,Bonneville County,9,6799,3388,3411
Idaho,Bonneville County,10,6067,3056,3011
Idaho,Bonneville County,11,5797,2978,2819
Idaho,Bonneville County,12,6531,3267,3264
Idaho,Bonneville County,13,5980,2878,3102
Idaho,Bonneville County,14,5275,2535,2740
Idaho,Bonneville County,15,3955,1907,2048
Idaho,Bonneville County,16,2769,1227,1542
Idaho,Bonneville County,17,1744,825,919
Idaho,Bonneville County,18,1800,693,1107
Idaho,Boundary County,0,11948,6005,5943
Idaho,Boundary County,1,701,363,338
Idaho,Boundary County,2,754,400,354
Idaho,Boundary County,3,789,384,405
Idaho,Boundary County,4,797,409,388
Idaho,Boundary County,5,576,298,278
Idaho,Boundary County,6,506,266,240
Idaho,Boundary County,7,557,265,292
Idaho,Boundary County,8,673,337,336
Idaho,Boundary County,9,639,339,300
Idaho,Boundary County,10,714,333,381
Idaho,Boundary County,11,729,389,340
Idaho,Boundary County,12,874,414,460
Idaho,Boundary County,13,948,446,502
Idaho,Boundary County,14,973,501,472
Idaho,Boundary County,15,704,364,340
Idaho,Boundary County,16,485,260,225
Idaho,Boundary County,17,255,136,119
Idaho,Boundary County,18,274,101,173
Idaho,Butte County,0,2611,1318,1293
Idaho,Butte County,1,143,69,74
Idaho,Butte County,2,178,89,89
Idaho,Butte County,3,192,95,97
Idaho,Butte County,4,167,82,85
Idaho,Butte County,5,132,77,55
Idaho,Butte County,6,112,52,60
Idaho,Butte County,7,114,60,54
Idaho,Butte County,8,139,69,70
Idaho,Butte County,9,133,66,67
Idaho,Butte County,10,133,75,58
Idaho,Butte County,11,128,64,64
Idaho,Butte County,12,196,91,105
Idaho,Butte County,13,232,113,119
Idaho,Butte County,14,189,94,95
Idaho,Butte County,15,159,98,61
Idaho,Butte County,16,121,66,55
Idaho,Butte County,17,72,33,39
Idaho,Butte County,18,71,25,46
Idaho,Camas County,0,1127,570,557
Idaho,Camas County,1,55,31,24
Idaho,Camas County,2,77,40,37
Idaho,Camas County,3,93,33,60
Idaho,Camas County,4,57,22,35
Idaho,Camas County,5,37,24,13
Idaho,Camas County,6,35,20,15
Idaho,Camas County,7,49,26,23
Idaho,Camas County,8,76,34,42
Idaho,Camas County,9,78,44,34
Idaho,Camas County,10,67,33,34
Idaho,Camas County,11,61,29,32
Idaho,Camas County,12,88,44,44
Idaho,Camas County,13,101,58,43
Idaho,Camas County,14,91,45,46
Idaho,Camas County,15,76,46,30
Idaho,Camas County,16,43,26,17
Idaho,Camas County,17,14,6,8
Idaho,Camas County,18,29,9,20
Idaho,Canyon County,0,223499,110725,112774
Idaho,Canyon County,1,16732,8471,8261
Idaho,Canyon County,2,17518,8927,8591
Idaho,Canyon County,3,18726,9543,9183
Idaho,Canyon County,4,17059,8672,8387
Idaho,Canyon County,5,14681,7449,7232
Idaho,Canyon County,6,15544,7744,7800
Idaho,Canyon County,7,14583,7249,7334
Idaho,Canyon County,8,14622,7220,7402
Idaho,Canyon County,9,13802,6925,6877
Idaho,Canyon County,10,13358,6667,6691
Idaho,Canyon County,11,12185,6080,6105
Idaho,Canyon County,12,12422,6004,6418
Idaho,Canyon County,13,11505,5543,5962
Idaho,Canyon County,14,10391,4920,5471
Idaho,Canyon County,15,8491,4047,4444
Idaho,Canyon County,16,5679,2666,3013
Idaho,Canyon County,17,3203,1481,1722
Idaho,Canyon County,18,2998,1117,1881
Idaho,Caribou County,0,7060,3610,3450
Idaho,Caribou County,1,486,253,233
Idaho,Caribou County,2,579,321,258
Idaho,Caribou County,3,587,292,295
Idaho,Caribou County,4,538,281,257
Idaho,Caribou County,5,344,191,153
Idaho,Caribou County,6,360,176,184
Idaho,Caribou County,7,432,225,207
Idaho,Caribou County,8,480,244,236
Idaho,Caribou County,9,422,243,179
Idaho,Caribou County,10,351,181,170
Idaho,Caribou County,11,373,174,199
Idaho,Caribou County,12,433,221,212
Idaho,Caribou County,13,441,231,210
Idaho,Caribou County,14,406,203,203
Idaho,Caribou County,15,299,136,163
Idaho,Caribou County,16,241,119,122
Idaho,Caribou County,17,142,61,81
Idaho,Caribou County,18,146,58,88
Idaho,Cassia County,0,23864,12155,11709
Idaho,Cassia County,1,1882,969,913
Idaho,Cassia County,2,2094,1084,1010
Idaho,Cassia County,3,2257,1165,1092
Idaho,Cassia County,4,2001,1066,935
Idaho,Cassia County,5,1482,798,684
Idaho,Cassia County,6,1557,849,708
Idaho,Cassia County,7,1346,681,665
Idaho,Cassia County,8,1555,768,787
Idaho,Cassia County,9,1327,675,652
Idaho,Cassia County,10,1196,620,576
Idaho,Cassia County,11,1133,560,573
Idaho,Cassia County,12,1351,701,650
Idaho,Cassia County,13,1292,643,649
Idaho,Cassia County,14,1041,522,519
Idaho,Cassia County,15,855,424,431
Idaho,Cassia County,16,640,293,347
Idaho,Cassia County,17,438,197,241
Idaho,Cassia County,18,417,140,277
Idaho,Clark County,0,852,432,420
Idaho,Clark County,1,47,26,21
Idaho,Clark County,2,50,30,20
Idaho,Clark County,3,61,25,36
Idaho,Clark County,4,78,32,46
Idaho,Clark County,5,56,23,33
Idaho,Clark County,6,40,21,19
Idaho,Clark County,7,57,35,22
Idaho,Clark County,8,52,24,28
Idaho,Clark County,9,55,30,25
Idaho,Clark County,10,49,25,24
Idaho,Clark County,11,47,22,25
Idaho,Clark County,12,48,24,24
Idaho,Clark County,13,61,36,25
Idaho,Clark County,14,48,28,20
Idaho,Clark County,15,35,15,20
Idaho,Clark County,16,24,12,12
Idaho,Clark County,17,25,13,12
Idaho,Clark County,18,19,11,8
Idaho,Clearwater County,0,8758,4818,3940
Idaho,Clearwater County,1,337,196,141
Idaho,Clearwater County,2,359,183,176
Idaho,Clearwater County,3,437,248,189
Idaho,Clearwater County,4,448,258,190
Idaho,Clearwater County,5,390,230,160
Idaho,Clearwater County,6,489,319,170
Idaho,Clearwater County,7,430,267,163
Idaho,Clearwater County,8,489,276,213
Idaho,Clearwater County,9,409,239,170
Idaho,Clearwater County,10,537,310,227
Idaho,Clearwater County,11,588,311,277
Idaho,Clearwater County,12,765,374,391
Idaho,Clearwater County,13,691,344,347
Idaho,Clearwater County,14,760,426,334
Idaho,Clearwater County,15,626,346,280
Idaho,Clearwater County,16,439,243,196
Idaho,Clearwater County,17,305,147,158
Idaho,Clearwater County,18,259,101,158
Idaho,Custer County,0,4280,2196,2084
Idaho,Custer County,1,205,99,106
Idaho,Custer County,2,182,95,87
Idaho,Custer County,3,215,104,111
Idaho,Custer County,4,213,116,97
Idaho,Custer County,5,145,78,67
Idaho,Custer County,6,184,91,93
Idaho,Custer County,7,199,97,102
Idaho,Custer County,8,210,115,95
Idaho,Custer County,9,221,118,103
Idaho,Custer County,10,232,121,111
Idaho,Custer County,11,231,112,119
Idaho,Custer County,12,388,181,207
Idaho,Custer County,13,412,222,190
Idaho,Custer County,14,449,244,205
Idaho,Custer County,15,336,187,149
Idaho,Custer County,16,234,125,109
Idaho,Custer County,17,112,44,68
Idaho,Custer County,18,112,47,65
Idaho,Elmore County,0,27259,14290,12969
Idaho,Elmore County,1,2287,1160,1127
Idaho,Elmore County,2,1903,1019,884
Idaho,Elmore County,3,1780,904,876
Idaho,Elmore County,4,1654,869,785
Idaho,Elmore County,5,2591,1570,1021
Idaho,Elmore County,6,2685,1518,1167
Idaho,Elmore County,7,1968,1058,910
Idaho,Elmore County,8,1649,877,772
Idaho,Elmore County,9,1339,684,655
Idaho,Elmore County,10,1240,630,610
Idaho,Elmore County,11,1384,673,711
Idaho,Elmore County,12,1623,847,776
Idaho,Elmore County,13,1482,706,776
Idaho,Elmore County,14,1215,626,589
Idaho,Elmore County,15,986,477,509
Idaho,Elmore County,16,671,331,340
Idaho,Elmore County,17,457,195,262
Idaho,Elmore County,18,345,146,199
Idaho,Franklin County,0,13726,7022,6704
Idaho,Franklin County,1,1017,532,485
Idaho,Franklin County,2,1174,604,570
Idaho,Franklin County,3,1354,728,626
Idaho,Franklin County,4,1239,658,581
Idaho,Franklin County,5,809,418,391
Idaho,Franklin County,6,748,378,370
Idaho,Franklin County,7,692,347,345
Idaho,Franklin County,8,875,424,451
Idaho,Franklin County,9,907,460,447
Idaho,Franklin County,10,714,379,335
Idaho,Franklin County,11,689,350,339
Idaho,Franklin County,12,812,405,407
Idaho,Franklin County,13,753,377,376
Idaho,Franklin County,14,610,310,300
Idaho,Franklin County,15,484,243,241
Idaho,Franklin County,16,365,168,197
Idaho,Franklin County,17,245,144,101
Idaho,Franklin County,18,239,97,142
Idaho,Fremont County,0,13168,6888,6280
Idaho,Fremont County,1,867,439,428
Idaho,Fremont County,2,824,423,401
Idaho,Fremont County,3,1014,511,503
Idaho,Fremont County,4,1052,595,457
Idaho,Fremont County,5,832,434,398
Idaho,Fremont County,6,780,427,353
Idaho,Fremont County,7,725,375,350
Idaho,Fremont County,8,823,440,383
Idaho,Fremont County,9,831,434,397
Idaho,Fremont County,10,732,388,344
Idaho,Fremont County,11,744,408,336
Idaho,Fremont County,12,842,445,397
Idaho,Fremont County,13,889,457,432
Idaho,Fremont County,14,709,365,344
Idaho,Fremont County,15,565,273,292
Idaho,Fremont County,16,465,236,229
Idaho,Fremont County,17,254,136,118
Idaho,Fremont County,18,220,102,118
Idaho,Gem County,0,17634,8813,8821
Idaho,Gem County,1,1052,555,497
Idaho,Gem County,2,1081,537,544
Idaho,Gem County,3,1157,626,531
Idaho,Gem County,4,1127,609,518
Idaho,Gem County,5,827,427,400
Idaho,Gem County,6,956,484,472
Idaho,Gem County,7,877,433,444
Idaho,Gem County,8,984,462,522
Idaho,Gem County,9,920,423,497
Idaho,Gem County,10,948,477,471
Idaho,Gem County,11,1165,588,577
Idaho,Gem County,12,1315,614,701
Idaho,Gem County,13,1362,681,681
Idaho,Gem County,14,1217,606,611
Idaho,Gem County,15,1030,501,529
Idaho,Gem County,16,760,399,361
Idaho,Gem County,17,462,230,232
Idaho,Gem County,18,394,161,233
Idaho,Gooding County,0,15196,7736,7460
Idaho,Gooding County,1,1081,550,531
Idaho,Gooding County,2,1169,577,592
Idaho,Gooding County,3,1253,630,623
Idaho,Gooding County,4,1072,557,515
Idaho,Gooding County,5,883,486,397
Idaho,Gooding County,6,917,472,445
Idaho,Gooding County,7,830,427,403
Idaho,Gooding County,8,898,455,443
Idaho,Gooding County,9,842,466,376
Idaho,Gooding County,10,836,414,422
Idaho,Gooding County,11,868,459,409
Idaho,Gooding County,12,954,469,485
Idaho,Gooding County,13,966,492,474
Idaho,Gooding County,14,774,410,364
Idaho,Gooding County,15,682,323,359
Idaho,Gooding County,16,518,252,266
Idaho,Gooding County,17,291,138,153
Idaho,Gooding County,18,362,159,203
Idaho,Idaho County,0,16513,8664,7849
Idaho,Idaho County,1,776,408,368
Idaho,Idaho County,2,943,476,467
Idaho,Idaho County,3,936,485,451
Idaho,Idaho County,4,933,522,411
Idaho,Idaho County,5,763,478,285
Idaho,Idaho County,6,690,403,287
Idaho,Idaho County,7,735,381,354
Idaho,Idaho County,8,843,463,380
Idaho,Idaho County,9,768,395,373
Idaho,Idaho County,10,834,432,402
Idaho,Idaho County,11,918,462,456
Idaho,Idaho County,12,1293,633,660
Idaho,Idaho County,13,1475,712,763
Idaho,Idaho County,14,1479,793,686
Idaho,Idaho County,15,1243,659,584
Idaho,Idaho County,16,861,452,409
Idaho,Idaho County,17,523,276,247
Idaho,Idaho County,18,500,234,266
Idaho,Jefferson County,0,29439,14952,14487
Idaho,Jefferson County,1,2535,1320,1215
Idaho,Jefferson County,2,2820,1408,1412
Idaho,Jefferson County,3,3024,1506,1518
Idaho,Jefferson County,4,2469,1275,1194
Idaho,Jefferson County,5,1644,838,806
Idaho,Jefferson County,6,1717,866,851
Idaho,Jefferson County,7,1810,917,893
Idaho,Jefferson County,8,2142,1064,1078
Idaho,Jefferson County,9,1880,1031,849
Idaho,Jefferson County,10,1477,722,755
Idaho,Jefferson County,11,1433,762,671
Idaho,Jefferson County,12,1632,843,789
Idaho,Jefferson County,13,1471,751,720
Idaho,Jefferson County,14,1207,619,588
Idaho,Jefferson County,15,861,421,440
Idaho,Jefferson County,16,599,310,289
Idaho,Jefferson County,17,376,166,210
Idaho,Jefferson County,18,342,133,209
Idaho,Jerome County,0,24015,12241,11774
Idaho,Jerome County,1,1996,1038,958
Idaho,Jerome County,2,2110,1055,1055
Idaho,Jerome County,3,2192,1083,1109
Idaho,Jerome County,4,1684,848,836
Idaho,Jerome County,5,1416,725,691
Idaho,Jerome County,6,1591,821,770
Idaho,Jerome County,7,1614,861,753
Idaho,Jerome County,8,1619,865,754
Idaho,Jerome County,9,1338,712,626
Idaho,Jerome County,10,1312,657,655
Idaho,Jerome County,11,1279,706,573
Idaho,Jerome County,12,1439,734,705
Idaho,Jerome County,13,1308,651,657
Idaho,Jerome County,14,1051,520,531
Idaho,Jerome County,15,794,387,407
Idaho,Jerome County,16,609,300,309
Idaho,Jerome County,17,359,159,200
Idaho,Jerome County,18,304,119,185
Idaho,Kootenai County,0,161505,79774,81731
Idaho,Kootenai County,1,9664,4981,4683
Idaho,Kootenai County,2,10169,5225,4944
Idaho,Kootenai County,3,10628,5500,5128
Idaho,Kootenai County,4,9803,5082,4721
Idaho,Kootenai County,5,8670,4540,4130
Idaho,Kootenai County,6,10628,5303,5325
Idaho,Kootenai County,7,10165,4988,5177
Idaho,Kootenai County,8,10009,5006,5003
Idaho,Kootenai County,9,9448,4697,4751
Idaho,Kootenai County,10,9668,4848,4820
Idaho,Kootenai County,11,9892,4752,5140
Idaho,Kootenai County,12,11022,5332,5690
Idaho,Kootenai County,13,11069,5216,5853
Idaho,Kootenai County,14,10378,4867,5511
Idaho,Kootenai County,15,8251,3959,4292
Idaho,Kootenai County,16,5635,2709,2926
Idaho,Kootenai County,17,3279,1566,1713
Idaho,Kootenai County,18,3127,1203,1924
Idaho,Latah County,0,40134,20398,19736
Idaho,Latah County,1,2189,1077,1112
Idaho,Latah County,2,2124,1092,1032
Idaho,Latah County,3,2014,1014,1000
Idaho,Latah County,4,3918,1961,1957
Idaho,Latah County,5,6850,3707,3143
Idaho,Latah County,6,3397,1870,1527
Idaho,Latah County,7,2348,1174,1174
Idaho,Latah County,8,2244,1124,1120
Idaho,Latah County,9,1839,953,886
Idaho,Latah County,10,1906,945,961
Idaho,Latah County,11,1765,895,870
Idaho,Latah County,12,2064,995,1069
Idaho,Latah County,13,2070,1000,1070
Idaho,Latah County,14,1922,954,968
Idaho,Latah County,15,1382,692,690
Idaho,Latah County,16,911,435,476
Idaho,Latah County,17,579,286,293
Idaho,Latah County,18,612,224,388
Idaho,Lemhi County,0,7961,4030,3931
Idaho,Lemhi County,1,394,204,190
Idaho,Lemhi County,2,395,209,186
Idaho,Lemhi County,3,420,227,193
Idaho,Lemhi County,4,409,208,201
Idaho,Lemhi County,5,296,164,132
Idaho,Lemhi County,6,328,160,168
Idaho,Lemhi County,7,366,176,190
Idaho,Lemhi County,8,459,236,223
Idaho,Lemhi County,9,333,163,170
Idaho,Lemhi County,10,335,165,170
Idaho,Lemhi County,11,435,207,228
Idaho,Lemhi County,12,633,313,320
Idaho,Lemhi County,13,749,359,390
Idaho,Lemhi County,14,736,373,363
Idaho,Lemhi County,15,644,351,293
Idaho,Lemhi County,16,496,261,235
Idaho,Lemhi County,17,255,130,125
Idaho,Lemhi County,18,278,124,154
Idaho,Lewis County,0,3861,1963,1898
Idaho,Lewis County,1,196,109,87
Idaho,Lewis County,2,258,137,121
Idaho,Lewis County,3,265,134,131
Idaho,Lewis County,4,230,135,95
Idaho,Lewis County,5,150,75,75
Idaho,Lewis County,6,176,83,93
Idaho,Lewis County,7,168,79,89
Idaho,Lewis County,8,202,106,96
Idaho,Lewis County,9,153,76,77
Idaho,Lewis County,10,187,80,107
Idaho,Lewis County,11,217,94,123
Idaho,Lewis County,12,312,160,152
Idaho,Lewis County,13,329,175,154
Idaho,Lewis County,14,308,161,147
Idaho,Lewis County,15,260,134,126
Idaho,Lewis County,16,199,107,92
Idaho,Lewis County,17,133,67,66
Idaho,Lewis County,18,118,51,67
Idaho,Lincoln County,0,5360,2780,2580
Idaho,Lincoln County,1,367,198,169
Idaho,Lincoln County,2,432,214,218
Idaho,Lincoln County,3,467,255,212
Idaho,Lincoln County,4,443,217,226
Idaho,Lincoln County,5,308,156,152
Idaho,Lincoln County,6,309,164,145
Idaho,Lincoln County,7,296,138,158
Idaho,Lincoln County,8,382,205,177
Idaho,Lincoln County,9,361,210,151
Idaho,Lincoln County,10,301,137,164
Idaho,Lincoln County,11,321,193,128
Idaho,Lincoln County,12,304,159,145
Idaho,Lincoln County,13,311,140,171
Idaho,Lincoln County,14,262,134,128
Idaho,Lincoln County,15,210,115,95
Idaho,Lincoln County,16,107,53,54
Idaho,Lincoln County,17,88,46,42
Idaho,Lincoln County,18,91,46,45
Idaho,Madison County,0,39304,19890,19414
Idaho,Madison County,1,3768,1942,1826
Idaho,Madison County,2,2460,1227,1233
Idaho,Madison County,3,2646,1349,1297
Idaho,Madison County,4,4686,1723,2963
Idaho,Madison County,5,9231,5001,4230
Idaho,Madison County,6,4142,2519,1623
Idaho,Madison County,7,1803,971,832
Idaho,Madison County,8,1606,824,782
Idaho,Madison County,9,1425,727,698
Idaho,Madison County,10,1247,612,635
Idaho,Madison County,11,1102,529,573
Idaho,Madison County,12,1256,609,647
Idaho,Madison County,13,1194,584,610
Idaho,Madison County,14,906,439,467
Idaho,Madison County,15,660,316,344
Idaho,Madison County,16,512,235,277
Idaho,Madison County,17,364,167,197
Idaho,Madison County,18,296,116,180
Idaho,Minidoka County,0,20825,10433,10392
Idaho,Minidoka County,1,1660,828,832
Idaho,Minidoka County,2,1723,839,884
Idaho,Minidoka County,3,1663,856,807
Idaho,Minidoka County,4,1384,727,657
Idaho,Minidoka County,5,1339,674,665
Idaho,Minidoka County,6,1383,707,676
Idaho,Minidoka County,7,1233,610,623
Idaho,Minidoka County,8,1166,606,560
Idaho,Minidoka County,9,1160,621,539
Idaho,Minidoka County,10,1064,544,520
Idaho,Minidoka County,11,1157,586,571
Idaho,Minidoka County,12,1268,626,642
Idaho,Minidoka County,13,1238,615,623
Idaho,Minidoka County,14,1032,504,528
Idaho,Minidoka County,15,858,423,435
Idaho,Minidoka County,16,605,287,318
Idaho,Minidoka County,17,427,198,229
Idaho,Minidoka County,18,465,182,283
Idaho,Nez Perce County,0,40408,19961,20447
Idaho,Nez Perce County,1,2387,1205,1182
Idaho,Nez Perce County,2,2367,1197,1170
Idaho,Nez Perce County,3,2408,1271,1137
Idaho,Nez Perce County,4,2431,1211,1220
Idaho,Nez Perce County,5,2506,1296,1210
Idaho,Nez Perce County,6,2902,1506,1396
Idaho,Nez Perce County,7,2498,1247,1251
Idaho,Nez Perce County,8,2368,1192,1176
Idaho,Nez Perce County,9,2233,1097,1136
Idaho,Nez Perce County,10,2343,1165,1178
Idaho,Nez Perce County,11,2431,1180,1251
Idaho,Nez Perce County,12,2711,1304,1407
Idaho,Nez Perce County,13,2762,1393,1369
Idaho,Nez Perce County,14,2486,1202,1284
Idaho,Nez Perce County,15,1907,906,1001
Idaho,Nez Perce County,16,1489,677,812
Idaho,Nez Perce County,17,1024,461,563
Idaho,Nez Perce County,18,1155,451,704
Idaho,Oneida County,0,4488,2254,2234
Idaho,Oneida County,1,273,129,144
Idaho,Oneida County,2,366,181,185
Idaho,Oneida County,3,400,215,185
Idaho,Oneida County,4,340,186,154
Idaho,Oneida County,5,190,103,87
Idaho,Oneida County,6,184,98,86
Idaho,Oneida County,7,211,99,112
Idaho,Oneida County,8,279,137,142
Idaho,Oneida County,9,245,123,122
Idaho,Oneida County,10,229,119,110
Idaho,Oneida County,11,232,104,128
Idaho,Oneida County,12,295,145,150
Idaho,Oneida County,13,332,181,151
Idaho,Oneida County,14,278,144,134
Idaho,Oneida County,15,225,111,114
Idaho,Oneida County,16,166,82,84
Idaho,Oneida County,17,112,48,64
Idaho,Oneida County,18,131,49,82
Idaho,Owyhee County,0,11693,5965,5728
Idaho,Owyhee County,1,749,370,379
Idaho,Owyhee County,2,812,441,371
Idaho,Owyhee County,3,923,454,469
Idaho,Owyhee County,4,832,439,393
Idaho,Owyhee County,5,695,374,321
Idaho,Owyhee County,6,665,331,334
Idaho,Owyhee County,7,623,322,301
Idaho,Owyhee County,8,665,339,326
Idaho,Owyhee County,9,677,334,343
Idaho,Owyhee County,10,661,335,326
Idaho,Owyhee County,11,708,344,364
Idaho,Owyhee County,12,825,430,395
Idaho,Owyhee County,13,776,404,372
Idaho,Owyhee County,14,701,355,346
Idaho,Owyhee County,15,538,283,255
Idaho,Owyhee County,16,386,184,202
Idaho,Owyhee County,17,248,131,117
Idaho,Owyhee County,18,209,95,114
Idaho,Payette County,0,23551,11755,11796
Idaho,Payette County,1,1535,796,739
Idaho,Payette County,2,1708,884,824
Idaho,Payette County,3,1826,930,896
Idaho,Payette County,4,1653,884,769
Idaho,Payette County,5,1247,652,595
Idaho,Payette County,6,1400,694,706
Idaho,Payette County,7,1298,662,636
Idaho,Payette County,8,1357,634,723
Idaho,Payette County,9,1343,673,670
Idaho,Payette County,10,1427,694,733
Idaho,Payette County,11,1419,713,706
Idaho,Payette County,12,1555,750,805
Idaho,Payette County,13,1452,710,742
Idaho,Payette County,14,1291,630,661
Idaho,Payette County,15,1144,545,599
Idaho,Payette County,16,916,436,480
Idaho,Payette County,17,548,265,283
Idaho,Payette County,18,432,203,229
Idaho,Power County,0,7768,3952,3816
Idaho,Power County,1,656,328,328
Idaho,Power County,2,699,354,345
Idaho,Power County,3,687,353,334
Idaho,Power County,4,595,322,273
Idaho,Power County,5,464,230,234
Idaho,Power County,6,483,249,234
Idaho,Power County,7,455,247,208
Idaho,Power County,8,397,202,195
Idaho,Power County,9,405,206,199
Idaho,Power County,10,345,176,169
Idaho,Power County,11,420,212,208
Idaho,Power County,12,487,237,250
Idaho,Power County,13,476,254,222
Idaho,Power County,14,417,213,204
Idaho,Power County,15,290,135,155
Idaho,Power County,16,236,119,117
Idaho,Power County,17,127,59,68
Idaho,Power County,18,129,56,73
Idaho,Shoshone County,0,12796,6422,6374
Idaho,Shoshone County,1,769,415,354
Idaho,Shoshone County,2,714,339,375
Idaho,Shoshone County,3,695,366,329
Idaho,Shoshone County,4,673,326,347
Idaho,Shoshone County,5,665,353,312
Idaho,Shoshone County,6,740,389,351
Idaho,Shoshone County,7,647,352,295
Idaho,Shoshone County,8,682,326,356
Idaho,Shoshone County,9,641,325,316
Idaho,Shoshone County,10,729,360,369
Idaho,Shoshone County,11,827,425,402
Idaho,Shoshone County,12,996,517,479
Idaho,Shoshone County,13,1095,504,591
Idaho,Shoshone County,14,990,532,458
Idaho,Shoshone County,15,765,378,387
Idaho,Shoshone County,16,521,261,260
Idaho,Shoshone County,17,354,156,198
Idaho,Shoshone County,18,293,98,195
Idaho,Teton County,0,11640,6111,5529
Idaho,Teton County,1,728,363,365
Idaho,Teton County,2,856,427,429
Idaho,Teton County,3,855,451,404
Idaho,Teton County,4,680,370,310
Idaho,Teton County,5,539,299,240
Idaho,Teton County,6,722,408,314
Idaho,Teton County,7,771,402,369
Idaho,Teton County,8,932,457,475
Idaho,Teton County,9,981,539,442
Idaho,Teton County,10,957,492,465
Idaho,Teton County,11,751,382,369
Idaho,Teton County,12,698,381,317
Idaho,Teton County,13,713,364,349
Idaho,Teton County,14,634,340,294
Idaho,Teton County,15,395,228,167
Idaho,Teton County,16,201,100,101
Idaho,Teton County,17,111,57,54
Idaho,Teton County,18,116,51,65
Idaho,Twin Falls County,0,86081,42488,43593
Idaho,Twin Falls County,1,6294,3203,3091
Idaho,Twin Falls County,2,6803,3421,3382
Idaho,Twin Falls County,3,6882,3450,3432
Idaho,Twin Falls County,4,5777,2990,2787
Idaho,Twin Falls County,5,5126,2558,2568
Idaho,Twin Falls County,6,6208,2960,3248
Idaho,Twin Falls County,7,6009,3000,3009
Idaho,Twin Falls County,8,5825,2972,2853
Idaho,Twin Falls County,9,5072,2598,2474
Idaho,Twin Falls County,10,4514,2283,2231
Idaho,Twin Falls County,11,4514,2293,2221
Idaho,Twin Falls County,12,5037,2469,2568
Idaho,Twin Falls County,13,4768,2304,2464
Idaho,Twin Falls County,14,4151,1946,2205
Idaho,Twin Falls County,15,3396,1629,1767
Idaho,Twin Falls County,16,2456,1144,1312
Idaho,Twin Falls County,17,1658,696,962
Idaho,Twin Falls County,18,1591,572,1019
Idaho,Valley County,0,11041,5720,5321
Idaho,Valley County,1,507,269,238
Idaho,Valley County,2,555,280,275
Idaho,Valley County,3,593,292,301
Idaho,Valley County,4,500,274,226
Idaho,Valley County,5,411,212,199
Idaho,Valley County,6,509,281,228
Idaho,Valley County,7,588,291,297
Idaho,Valley County,8,700,356,344
Idaho,Valley County,9,662,354,308
Idaho,Valley County,10,657,331,326
Idaho,Valley County,11,668,341,327
Idaho,Valley County,12,799,384,415
Idaho,Valley County,13,1120,563,557
Idaho,Valley County,14,1137,613,524
Idaho,Valley County,15,769,424,345
Idaho,Valley County,16,450,234,216
Idaho,Valley County,17,220,128,92
Idaho,Valley County,18,196,93,103
Idaho,Washington County,0,10161,5058,5103
Idaho,Washington County,1,575,284,291
Idaho,Washington County,2,586,314,272
Idaho,Washington County,3,700,332,368
Idaho,Washington County,4,675,344,331
Idaho,Washington County,5,506,266,240
Idaho,Washington County,6,438,226,212
Idaho,Washington County,7,437,225,212
Idaho,Washington County,8,524,250,274
Idaho,Washington County,9,532,282,250
Idaho,Washington County,10,564,267,297
Idaho,Washington County,11,559,269,290
Idaho,Washington County,12,709,350,359
Idaho,Washington County,13,802,367,435
Idaho,Washington County,14,789,417,372
Idaho,Washington County,15,665,331,334
Idaho,Washington County,16,502,256,246
Idaho,Washington County,17,332,176,156
Idaho,Washington County,18,266,102,164
Illinois,Adams County,0,65691,32308,33383
Illinois,Adams County,1,4145,2146,1999
Illinois,Adams County,2,4034,2120,1914
Illinois,Adams County,3,4135,2138,1997
Illinois,Adams County,4,3931,1989,1942
Illinois,Adams County,5,3662,1827,1835
Illinois,Adams County,6,3991,1998,1993
Illinois,Adams County,7,3986,1980,2006
Illinois,Adams County,8,3962,2000,1962
Illinois,Adams County,9,3490,1760,1730
Illinois,Adams County,10,3689,1839,1850
Illinois,Adams County,11,4120,1996,2124
Illinois,Adams County,12,4766,2358,2408
Illinois,Adams County,13,4490,2168,2322
Illinois,Adams County,14,3842,1882,1960
Illinois,Adams County,15,3020,1382,1638
Illinois,Adams County,16,2335,1042,1293
Illinois,Adams County,17,1742,759,983
Illinois,Adams County,18,2351,924,1427
Illinois,Alexander County,0,6060,2932,3128
Illinois,Alexander County,1,391,197,194
Illinois,Alexander County,2,397,191,206
Illinois,Alexander County,3,383,196,187
Illinois,Alexander County,4,333,160,173
Illinois,Alexander County,5,241,118,123
Illinois,Alexander County,6,332,175,157
Illinois,Alexander County,7,292,143,149
Illinois,Alexander County,8,308,155,153
Illinois,Alexander County,9,311,140,171
Illinois,Alexander County,10,329,145,184
Illinois,Alexander County,11,435,227,208
Illinois,Alexander County,12,494,235,259
Illinois,Alexander County,13,486,252,234
Illinois,Alexander County,14,440,201,239
Illinois,Alexander County,15,304,153,151
Illinois,Alexander County,16,266,123,143
Illinois,Alexander County,17,150,65,85
Illinois,Alexander County,18,168,56,112
Illinois,Bond County,0,16630,8645,7985
Illinois,Bond County,1,791,393,398
Illinois,Bond County,2,858,444,414
Illinois,Bond County,3,982,500,482
Illinois,Bond County,4,949,506,443
Illinois,Bond County,5,908,500,408
Illinois,Bond County,6,1148,641,507
Illinois,Bond County,7,1175,703,472
Illinois,Bond County,8,1120,659,461
Illinois,Bond County,9,1081,580,501
Illinois,Bond County,10,991,544,447
Illinois,Bond County,11,1092,586,506
Illinois,Bond County,12,1298,630,668
Illinois,Bond County,13,1151,579,572
Illinois,Bond County,14,1023,493,530
Illinois,Bond County,15,709,340,369
Illinois,Bond County,16,565,257,308
Illinois,Bond County,17,355,155,200
Illinois,Bond County,18,434,135,299
Illinois,Boone County,0,53577,26785,26792
Illinois,Boone County,1,3017,1569,1448
Illinois,Boone County,2,3390,1759,1631
Illinois,Boone County,3,4192,2144,2048
Illinois,Boone County,4,4190,2155,2035
Illinois,Boone County,5,3410,1755,1655
Illinois,Boone County,6,2902,1509,1393
Illinois,Boone County,7,2819,1413,1406
Illinois,Boone County,8,3199,1552,1647
Illinois,Boone County,9,3301,1672,1629
Illinois,Boone County,10,3910,1897,2013
Illinois,Boone County,11,3853,1956,1897
Illinois,Boone County,12,3716,1861,1855
Illinois,Boone County,13,3194,1637,1557
Illinois,Boone County,14,2653,1269,1384
Illinois,Boone County,15,2256,1070,1186
Illinois,Boone County,16,1670,805,865
Illinois,Boone County,17,986,439,547
Illinois,Boone County,18,919,323,596
Illinois,Brown County,0,6556,4245,2311
Illinois,Brown County,1,289,160,129
Illinois,Brown County,2,291,151,140
Illinois,Brown County,3,297,146,151
Illinois,Brown County,4,288,179,109
Illinois,Brown County,5,552,447,105
Illinois,Brown County,6,681,532,149
Illinois,Brown County,7,600,452,148
Illinois,Brown County,8,543,406,137
Illinois,Brown County,9,466,336,130
Illinois,Brown County,10,451,301,150
Illinois,Brown County,11,434,285,149
Illinois,Brown County,12,403,238,165
Illinois,Brown County,13,348,189,159
Illinois,Brown County,14,281,135,146
Illinois,Brown County,15,218,93,125
Illinois,Brown County,16,174,85,89
Illinois,Brown County,17,109,55,54
Illinois,Brown County,18,131,55,76
Illinois,Bureau County,0,32993,16199,16794
Illinois,Bureau County,1,1752,896,856
Illinois,Bureau County,2,1878,970,908
Illinois,Bureau County,3,2073,1043,1030
Illinois,Bureau County,4,2051,1049,1002
Illinois,Bureau County,5,1735,870,865
Illinois,Bureau County,6,1875,986,889
Illinois,Bureau County,7,1672,833,839
Illinois,Bureau County,8,1916,972,944
Illinois,Bureau County,9,1797,905,892
Illinois,Bureau County,10,1973,955,1018
Illinois,Bureau County,11,2195,1118,1077
Illinois,Bureau County,12,2426,1192,1234
Illinois,Bureau County,13,2419,1163,1256
Illinois,Bureau County,14,2131,1068,1063
Illinois,Bureau County,15,1699,789,910
Illinois,Bureau County,16,1320,602,718
Illinois,Bureau County,17,947,404,543
Illinois,Bureau County,18,1134,384,750
Illinois,Calhoun County,0,4802,2393,2409
Illinois,Calhoun County,1,245,116,129
Illinois,Calhoun County,2,273,134,139
Illinois,Calhoun County,3,303,161,142
Illinois,Calhoun County,4,263,136,127
Illinois,Calhoun County,5,231,114,117
Illinois,Calhoun County,6,227,126,101
Illinois,Calhoun County,7,229,123,106
Illinois,Calhoun County,8,232,106,126
Illinois,Calhoun County,9,268,139,129
Illinois,Calhoun County,10,305,158,147
Illinois,Calhoun County,11,352,169,183
Illinois,Calhoun County,12,388,204,184
Illinois,Calhoun County,13,365,185,180
Illinois,Calhoun County,14,310,167,143
Illinois,Calhoun County,15,285,133,152
Illinois,Calhoun County,16,215,105,110
Illinois,Calhoun County,17,167,72,95
Illinois,Calhoun County,18,144,45,99
Illinois,Carroll County,0,14312,7137,7175
Illinois,Carroll County,1,734,377,357
Illinois,Carroll County,2,729,351,378
Illinois,Carroll County,3,796,400,396
Illinois,Carroll County,4,804,448,356
Illinois,Carroll County,5,678,350,328
Illinois,Carroll County,6,727,378,349
Illinois,Carroll County,7,722,385,337
Illinois,Carroll County,8,764,373,391
Illinois,Carroll County,9,744,367,377
Illinois,Carroll County,10,847,439,408
Illinois,Carroll County,11,852,421,431
Illinois,Carroll County,12,1119,555,564
Illinois,Carroll County,13,1145,563,582
Illinois,Carroll County,14,1103,542,561
Illinois,Carroll County,15,905,459,446
Illinois,Carroll County,16,697,334,363
Illinois,Carroll County,17,443,210,233
Illinois,Carroll County,18,503,185,318
Illinois,Cass County,0,12260,6192,6068
Illinois,Cass County,1,812,405,407
Illinois,Cass County,2,760,424,336
Illinois,Cass County,3,856,447,409
Illinois,Cass County,4,745,420,325
Illinois,Cass County,5,710,370,340
Illinois,Cass County,6,720,361,359
Illinois,Cass County,7,743,421,322
Illinois,Cass County,8,767,388,379
Illinois,Cass County,9,748,383,365
Illinois,Cass County,10,756,377,379
Illinois,Cass County,11,805,399,406
Illinois,Cass County,12,857,445,412
Illinois,Cass County,13,793,384,409
Illinois,Cass County,14,672,339,333
Illinois,Cass County,15,509,236,273
Illinois,Cass County,16,398,177,221
Illinois,Cass County,17,295,112,183
Illinois,Cass County,18,314,104,210
Illinois,Champaign County,0,209983,104634,105349
Illinois,Champaign County,1,11527,5897,5630
Illinois,Champaign County,2,10788,5567,5221
Illinois,Champaign County,3,10493,5262,5231
Illinois,Champaign County,4,20934,10682,10252
Illinois,Champaign County,5,34114,18105,16009
Illinois,Champaign County,6,16388,8570,7818
Illinois,Champaign County,7,13721,6987,6734
Illinois,Champaign County,8,12441,6269,6172
Illinois,Champaign County,9,10422,5142,5280
Illinois,Champaign County,10,10337,5090,5247
Illinois,Champaign County,11,9783,4669,5114
Illinois,Champaign County,12,11121,5331,5790
Illinois,Champaign County,13,10984,5112,5872
Illinois,Champaign County,14,9326,4436,4890
Illinois,Champaign County,15,6400,2988,3412
Illinois,Champaign County,16,4357,1894,2463
Illinois,Champaign County,17,3123,1307,1816
Illinois,Champaign County,18,3724,1326,2398
Illinois,Christian County,0,32661,16620,16041
Illinois,Christian County,1,1656,852,804
Illinois,Christian County,2,1780,897,883
Illinois,Christian County,3,2004,1041,963
Illinois,Christian County,4,1811,950,861
Illinois,Christian County,5,1885,1040,845
Illinois,Christian County,6,2030,1130,900
Illinois,Christian County,7,1951,1073,878
Illinois,Christian County,8,2013,1082,931
Illinois,Christian County,9,1870,1015,855
Illinois,Christian County,10,2097,1108,989
Illinois,Christian County,11,2246,1163,1083
Illinois,Christian County,12,2466,1251,1215
Illinois,Christian County,13,2341,1186,1155
Illinois,Christian County,14,1925,928,997
Illinois,Christian County,15,1518,674,844
Illinois,Christian County,16,1217,532,685
Illinois,Christian County,17,866,375,491
Illinois,Christian County,18,985,323,662
Illinois,Clark County,0,15596,7745,7851
Illinois,Clark County,1,919,488,431
Illinois,Clark County,2,995,535,460
Illinois,Clark County,3,997,504,493
Illinois,Clark County,4,967,507,460
Illinois,Clark County,5,804,404,400
Illinois,Clark County,6,857,432,425
Illinois,Clark County,7,865,440,425
Illinois,Clark County,8,952,464,488
Illinois,Clark County,9,855,438,417
Illinois,Clark County,10,973,516,457
Illinois,Clark County,11,1039,506,533
Illinois,Clark County,12,1187,591,596
Illinois,Clark County,13,1089,568,521
Illinois,Clark County,14,956,470,486
Illinois,Clark County,15,750,340,410
Illinois,Clark County,16,605,271,334
Illinois,Clark County,17,345,152,193
Illinois,Clark County,18,441,119,322
Illinois,Clay County,0,13253,6564,6689
Illinois,Clay County,1,798,424,374
Illinois,Clay County,2,851,431,420
Illinois,Clay County,3,874,440,434
Illinois,Clay County,4,772,396,376
Illinois,Clay County,5,679,348,331
Illinois,Clay County,6,839,433,406
Illinois,Clay County,7,692,343,349
Illinois,Clay County,8,776,399,377
Illinois,Clay County,9,721,357,364
Illinois,Clay County,10,799,425,374
Illinois,Clay County,11,835,423,412
Illinois,Clay County,12,988,490,498
Illinois,Clay County,13,936,451,485
Illinois,Clay County,14,845,422,423
Illinois,Clay County,15,677,319,358
Illinois,Clay County,16,465,200,265
Illinois,Clay County,17,341,140,201
Illinois,Clay County,18,365,123,242
Illinois,Clinton County,0,37639,19499,18140
Illinois,Clinton County,1,2172,1130,1042
Illinois,Clinton County,2,2133,1122,1011
Illinois,Clinton County,3,2287,1197,1090
Illinois,Clinton County,4,2138,1111,1027
Illinois,Clinton County,5,2120,1182,938
Illinois,Clinton County,6,2472,1358,1114
Illinois,Clinton County,7,2557,1429,1128
Illinois,Clinton County,8,2526,1407,1119
Illinois,Clinton County,9,2237,1241,996
Illinois,Clinton County,10,2356,1245,1111
Illinois,Clinton County,11,2669,1388,1281
Illinois,Clinton County,12,2908,1462,1446
Illinois,Clinton County,13,2581,1299,1282
Illinois,Clinton County,14,2033,1004,1029
Illinois,Clinton County,15,1542,719,823
Illinois,Clinton County,16,1139,524,615
Illinois,Clinton County,17,807,341,466
Illinois,Clinton County,18,962,340,622
Illinois,Coles County,0,50885,24678,26207
Illinois,Coles County,1,2515,1280,1235
Illinois,Coles County,2,2492,1297,1195
Illinois,Coles County,3,2635,1344,1291
Illinois,Coles County,4,3963,1902,2061
Illinois,Coles County,5,6196,2987,3209
Illinois,Coles County,6,3550,1752,1798
Illinois,Coles County,7,3200,1633,1567
Illinois,Coles County,8,2927,1499,1428
Illinois,Coles County,9,2592,1310,1282
Illinois,Coles County,10,2757,1393,1364
Illinois,Coles County,11,2762,1342,1420
Illinois,Coles County,12,3338,1610,1728
Illinois,Coles County,13,3349,1604,1745
Illinois,Coles County,14,2709,1262,1447
Illinois,Coles County,15,2031,966,1065
Illinois,Coles County,16,1507,641,866
Illinois,Coles County,17,1124,463,661
Illinois,Coles County,18,1238,393,845
Illinois,Cook County,0,5180493,2516081,2664412
Illinois,Cook County,1,317226,162078,155148
Illinois,Cook County,2,310376,158123,152253
Illinois,Cook County,3,314589,159881,154708
Illinois,Cook County,4,309388,155829,153559
Illinois,Cook County,5,334764,165943,168821
Illinois,Cook County,6,434864,216679,218185
Illinois,Cook County,7,411099,206144,204955
Illinois,Cook County,8,372497,184932,187565
Illinois,Cook County,9,328992,163198,165794
Illinois,Cook County,10,328628,161118,167510
Illinois,Cook County,11,320954,157344,163610
Illinois,Cook County,12,331664,159800,171864
Illinois,Cook County,13,307285,144822,162463
Illinois,Cook County,14,247210,113156,134054
Illinois,Cook County,15,185406,82365,103041
Illinois,Cook County,16,130651,54440,76211
Illinois,Cook County,17,90534,35623,54911
Illinois,Cook County,18,104366,34606,69760
Illinois,Crawford County,0,18807,9832,8975
Illinois,Crawford County,1,1007,505,502
Illinois,Crawford County,2,1047,533,514
Illinois,Crawford County,3,1054,543,511
Illinois,Crawford County,4,1014,510,504
Illinois,Crawford County,5,1032,602,430
Illinois,Crawford County,6,1333,782,551
Illinois,Crawford County,7,1279,745,534
Illinois,Crawford County,8,1214,722,492
Illinois,Crawford County,9,1151,643,508
Illinois,Crawford County,10,1206,673,533
Illinois,Crawford County,11,1230,646,584
Illinois,Crawford County,12,1389,720,669
Illinois,Crawford County,13,1294,648,646
Illinois,Crawford County,14,1098,526,572
Illinois,Crawford County,15,858,399,459
Illinois,Crawford County,16,652,277,375
Illinois,Crawford County,17,470,208,262
Illinois,Crawford County,18,479,150,329
Illinois,Cumberland County,0,10808,5376,5432
Illinois,Cumberland County,1,653,335,318
Illinois,Cumberland County,2,652,334,318
Illinois,Cumberland County,3,689,354,335
Illinois,Cumberland County,4,609,304,305
Illinois,Cumberland County,5,539,259,280
Illinois,Cumberland County,6,617,319,298
Illinois,Cumberland County,7,621,318,303
Illinois,Cumberland County,8,645,329,316
Illinois,Cumberland County,9,623,328,295
Illinois,Cumberland County,10,654,320,334
Illinois,Cumberland County,11,700,364,336
Illinois,Cumberland County,12,841,423,418
Illinois,Cumberland County,13,848,426,422
Illinois,Cumberland County,14,673,327,346
Illinois,Cumberland County,15,496,238,258
Illinois,Cumberland County,16,368,176,192
Illinois,Cumberland County,17,271,119,152
Illinois,Cumberland County,18,309,103,206
Illinois,DeKalb County,0,104143,51577,52566
Illinois,DeKalb County,1,5881,3011,2870
Illinois,DeKalb County,2,6234,3171,3063
Illinois,DeKalb County,3,6250,3161,3089
Illinois,DeKalb County,4,9191,4580,4611
Illinois,DeKalb County,5,15069,7419,7650
Illinois,DeKalb County,6,7451,3813,3638
Illinois,DeKalb County,7,6334,3248,3086
Illinois,DeKalb County,8,6308,3183,3125
Illinois,DeKalb County,9,5369,2705,2664
Illinois,DeKalb County,10,5618,2842,2776
Illinois,DeKalb County,11,5677,2827,2850
Illinois,DeKalb County,12,6170,3022,3148
Illinois,DeKalb County,13,5419,2697,2722
Illinois,DeKalb County,14,4410,2126,2284
Illinois,DeKalb County,15,3251,1522,1729
Illinois,DeKalb County,16,2277,1024,1253
Illinois,DeKalb County,17,1571,648,923
Illinois,DeKalb County,18,1663,578,1085
Illinois,De Witt County,0,15769,7804,7965
Illinois,De Witt County,1,846,398,448
Illinois,De Witt County,2,886,452,434
Illinois,De Witt County,3,979,518,461
Illinois,De Witt County,4,988,509,479
Illinois,De Witt County,5,780,385,395
Illinois,De Witt County,6,932,476,456
Illinois,De Witt County,7,884,464,420
Illinois,De Witt County,8,967,471,496
Illinois,De Witt County,9,916,473,443
Illinois,De Witt County,10,1003,516,487
Illinois,De Witt County,11,1122,563,559
Illinois,De Witt County,12,1225,617,608
Illinois,De Witt County,13,1210,623,587
Illinois,De Witt County,14,958,440,518
Illinois,De Witt County,15,760,370,390
Illinois,De Witt County,16,577,251,326
Illinois,De Witt County,17,362,144,218
Illinois,De Witt County,18,374,134,240
Illinois,Douglas County,0,19479,9620,9859
Illinois,Douglas County,1,1253,642,611
Illinois,Douglas County,2,1296,659,637
Illinois,Douglas County,3,1401,697,704
Illinois,Douglas County,4,1336,698,638
Illinois,Douglas County,5,1022,523,499
Illinois,Douglas County,6,1200,598,602
Illinois,Douglas County,7,1212,622,590
Illinois,Douglas County,8,1159,572,587
Illinois,Douglas County,9,1142,562,580
Illinois,Douglas County,10,1088,535,553
Illinois,Douglas County,11,1170,610,560
Illinois,Douglas County,12,1335,665,670
Illinois,Douglas County,13,1341,662,679
Illinois,Douglas County,14,1052,519,533
Illinois,Douglas County,15,845,412,433
Illinois,Douglas County,16,619,263,356
Illinois,Douglas County,17,519,203,316
Illinois,Douglas County,18,489,178,311
Illinois,DuPage County,0,928589,456211,472378
Illinois,DuPage County,1,55018,28236,26782
Illinois,DuPage County,2,57181,29281,27900
Illinois,DuPage County,3,60589,30993,29596
Illinois,DuPage County,4,60574,30917,29657
Illinois,DuPage County,5,57328,29056,28272
Illinois,DuPage County,6,57987,29683,28304
Illinois,DuPage County,7,59982,30398,29584
Illinois,DuPage County,8,62305,31294,31011
Illinois,DuPage County,9,57819,28884,28935
Illinois,DuPage County,10,61426,30005,31421
Illinois,DuPage County,11,64286,31106,33180
Illinois,DuPage County,12,68181,32928,35253
Illinois,DuPage County,13,61975,29769,32206
Illinois,DuPage County,14,48682,23250,25432
Illinois,DuPage County,15,36439,16910,19529
Illinois,DuPage County,16,24421,10849,13572
Illinois,DuPage County,17,15690,6532,9158
Illinois,DuPage County,18,18706,6120,12586
Illinois,Edgar County,0,17360,8510,8850
Illinois,Edgar County,1,882,450,432
Illinois,Edgar County,2,951,502,449
Illinois,Edgar County,3,1050,519,531
Illinois,Edgar County,4,1012,521,491
Illinois,Edgar County,5,892,437,455
Illinois,Edgar County,6,940,477,463
Illinois,Edgar County,7,935,489,446
Illinois,Edgar County,8,1049,496,553
Illinois,Edgar County,9,972,494,478
Illinois,Edgar County,10,1125,583,542
Illinois,Edgar County,11,1064,536,528
Illinois,Edgar County,12,1376,695,681
Illinois,Edgar County,13,1335,660,675
Illinois,Edgar County,14,1136,574,562
Illinois,Edgar County,15,943,428,515
Illinois,Edgar County,16,688,302,386
Illinois,Edgar County,17,472,168,304
Illinois,Edgar County,18,538,179,359
Illinois,Edwards County,0,6392,3149,3243
Illinois,Edwards County,1,349,177,172
Illinois,Edwards County,2,389,185,204
Illinois,Edwards County,3,432,232,200
Illinois,Edwards County,4,384,198,186
Illinois,Edwards County,5,305,157,148
Illinois,Edwards County,6,350,183,167
Illinois,Edwards County,7,293,148,145
Illinois,Edwards County,8,383,189,194
Illinois,Edwards County,9,371,177,194
Illinois,Edwards County,10,400,218,182
Illinois,Edwards County,11,435,224,211
Illinois,Edwards County,12,447,225,222
Illinois,Edwards County,13,479,244,235
Illinois,Edwards County,14,424,200,224
Illinois,Edwards County,15,331,159,172
Illinois,Edwards County,16,248,104,144
Illinois,Edwards County,17,176,64,112
Illinois,Edwards County,18,196,65,131
Illinois,Effingham County,0,34208,17043,17165
Illinois,Effingham County,1,2277,1160,1117
Illinois,Effingham County,2,2279,1154,1125
Illinois,Effingham County,3,2257,1148,1109
Illinois,Effingham County,4,2008,1040,968
Illinois,Effingham County,5,1942,1035,907
Illinois,Effingham County,6,2361,1224,1137
Illinois,Effingham County,7,2126,1117,1009
Illinois,Effingham County,8,2080,1062,1018
Illinois,Effingham County,9,1805,932,873
Illinois,Effingham County,10,1861,944,917
Illinois,Effingham County,11,2228,1093,1135
Illinois,Effingham County,12,2619,1327,1292
Illinois,Effingham County,13,2322,1153,1169
Illinois,Effingham County,14,1875,933,942
Illinois,Effingham County,15,1407,645,762
Illinois,Effingham County,16,1161,503,658
Illinois,Effingham County,17,763,298,465
Illinois,Effingham County,18,837,275,562
Illinois,Fayette County,0,21416,11304,10112
Illinois,Fayette County,1,1267,641,626
Illinois,Fayette County,2,1162,613,549
Illinois,Fayette County,3,1288,662,626
Illinois,Fayette County,4,1283,691,592
Illinois,Fayette County,5,1311,768,543
Illinois,Fayette County,6,1443,839,604
Illinois,Fayette County,7,1278,719,559
Illinois,Fayette County,8,1340,741,599
Illinois,Fayette County,9,1324,780,544
Illinois,Fayette County,10,1357,743,614
Illinois,Fayette County,11,1371,756,615
Illinois,Fayette County,12,1493,763,730
Illinois,Fayette County,13,1433,735,698
Illinois,Fayette County,14,1209,602,607
Illinois,Fayette County,15,1016,467,549
Illinois,Fayette County,16,715,315,400
Illinois,Fayette County,17,557,253,304
Illinois,Fayette County,18,569,216,353
Illinois,Ford County,0,13264,6556,6708
Illinois,Ford County,1,809,430,379
Illinois,Ford County,2,781,427,354
Illinois,Ford County,3,879,458,421
Illinois,Ford County,4,861,425,436
Illinois,Ford County,5,727,382,345
Illinois,Ford County,6,803,418,385
Illinois,Ford County,7,742,382,360
Illinois,Ford County,8,774,397,377
Illinois,Ford County,9,759,377,382
Illinois,Ford County,10,771,398,373
Illinois,Ford County,11,853,408,445
Illinois,Ford County,12,1000,492,508
Illinois,Ford County,13,1018,492,526
Illinois,Ford County,14,706,357,349
Illinois,Ford County,15,526,260,266
Illinois,Ford County,16,448,187,261
Illinois,Ford County,17,349,147,202
Illinois,Ford County,18,458,119,339
Illinois,Franklin County,0,38701,19092,19609
Illinois,Franklin County,1,2345,1216,1129
Illinois,Franklin County,2,2297,1220,1077
Illinois,Franklin County,3,2408,1271,1137
Illinois,Franklin County,4,2326,1209,1117
Illinois,Franklin County,5,2029,1033,996
Illinois,Franklin County,6,2296,1185,1111
Illinois,Franklin County,7,2107,1044,1063
Illinois,Franklin County,8,2253,1104,1149
Illinois,Franklin County,9,2283,1107,1176
Illinois,Franklin County,10,2452,1251,1201
Illinois,Franklin County,11,2570,1268,1302
Illinois,Franklin County,12,2735,1338,1397
Illinois,Franklin County,13,2668,1327,1341
Illinois,Franklin County,14,2383,1149,1234
Illinois,Franklin County,15,2051,947,1104
Illinois,Franklin County,16,1561,690,871
Illinois,Franklin County,17,986,416,570
Illinois,Franklin County,18,951,317,634
Illinois,Fulton County,0,34844,18133,16711
Illinois,Fulton County,1,1734,883,851
Illinois,Fulton County,2,1866,940,926
Illinois,Fulton County,3,1999,1009,990
Illinois,Fulton County,4,1994,1063,931
Illinois,Fulton County,5,1977,1180,797
Illinois,Fulton County,6,2138,1244,894
Illinois,Fulton County,7,2101,1232,869
Illinois,Fulton County,8,2238,1277,961
Illinois,Fulton County,9,2176,1204,972
Illinois,Fulton County,10,2238,1276,962
Illinois,Fulton County,11,2273,1167,1106
Illinois,Fulton County,12,2495,1278,1217
Illinois,Fulton County,13,2428,1157,1271
Illinois,Fulton County,14,2186,1100,1086
Illinois,Fulton County,15,1753,800,953
Illinois,Fulton County,16,1302,601,701
Illinois,Fulton County,17,898,363,535
Illinois,Fulton County,18,1048,359,689
Illinois,Gallatin County,0,5058,2470,2588
Illinois,Gallatin County,1,262,145,117
Illinois,Gallatin County,2,282,128,154
Illinois,Gallatin County,3,322,163,159
Illinois,Gallatin County,4,280,137,143
Illinois,Gallatin County,5,225,110,115
Illinois,Gallatin County,6,277,143,134
Illinois,Gallatin County,7,263,133,130
Illinois,Gallatin County,8,300,155,145
Illinois,Gallatin County,9,296,142,154
Illinois,Gallatin County,10,339,179,160
Illinois,Gallatin County,11,321,171,150
Illinois,Gallatin County,12,378,175,203
Illinois,Gallatin County,13,335,164,171
Illinois,Gallatin County,14,343,151,192
Illinois,Gallatin County,15,322,154,168
Illinois,Gallatin County,16,249,118,131
Illinois,Gallatin County,17,165,68,97
Illinois,Gallatin County,18,99,34,65
Illinois,Greene County,0,13044,6566,6478
Illinois,Greene County,1,683,363,320
Illinois,Greene County,2,764,390,374
Illinois,Greene County,3,835,405,430
Illinois,Greene County,4,739,385,354
Illinois,Greene County,5,733,394,339
Illinois,Greene County,6,779,420,359
Illinois,Greene County,7,708,375,333
Illinois,Greene County,8,743,397,346
Illinois,Greene County,9,805,418,387
Illinois,Greene County,10,824,424,400
Illinois,Greene County,11,912,461,451
Illinois,Greene County,12,999,508,491
Illinois,Greene County,13,969,487,482
Illinois,Greene County,14,778,388,390
Illinois,Greene County,15,631,282,349
Illinois,Greene County,16,473,205,268
Illinois,Greene County,17,336,135,201
Illinois,Greene County,18,333,129,204
Illinois,Grundy County,0,50972,25422,25550
Illinois,Grundy County,1,3191,1653,1538
Illinois,Grundy County,2,3475,1793,1682
Illinois,Grundy County,3,3874,1994,1880
Illinois,Grundy County,4,3554,1844,1710
Illinois,Grundy County,5,2923,1477,1446
Illinois,Grundy County,6,3140,1601,1539
Illinois,Grundy County,7,3229,1578,1651
Illinois,Grundy County,8,3722,1856,1866
Illinois,Grundy County,9,3348,1707,1641
Illinois,Grundy County,10,3414,1709,1705
Illinois,Grundy County,11,3429,1725,1704
Illinois,Grundy County,12,3498,1748,1750
Illinois,Grundy County,13,3002,1488,1514
Illinois,Grundy County,14,2384,1152,1232
Illinois,Grundy County,15,1866,893,973
Illinois,Grundy County,16,1349,613,736
Illinois,Grundy County,17,783,346,437
Illinois,Grundy County,18,791,245,546
Illinois,Hamilton County,0,8163,3992,4171
Illinois,Hamilton County,1,453,222,231
Illinois,Hamilton County,2,472,238,234
Illinois,Hamilton County,3,534,250,284
Illinois,Hamilton County,4,491,263,228
Illinois,Hamilton County,5,410,221,189
Illinois,Hamilton County,6,437,221,216
Illinois,Hamilton County,7,413,200,213
Illinois,Hamilton County,8,510,255,255
Illinois,Hamilton County,9,458,227,231
Illinois,Hamilton County,10,476,251,225
Illinois,Hamilton County,11,513,256,257
Illinois,Hamilton County,12,589,304,285
Illinois,Hamilton County,13,624,298,326
Illinois,Hamilton County,14,510,259,251
Illinois,Hamilton County,15,435,211,224
Illinois,Hamilton County,16,360,164,196
Illinois,Hamilton County,17,237,99,138
Illinois,Hamilton County,18,241,53,188
Illinois,Hancock County,0,17844,8850,8994
Illinois,Hancock County,1,974,480,494
Illinois,Hancock County,2,998,543,455
Illinois,Hancock County,3,1123,586,537
Illinois,Hancock County,4,976,498,478
Illinois,Hancock County,5,856,441,415
Illinois,Hancock County,6,947,511,436
Illinois,Hancock County,7,967,489,478
Illinois,Hancock County,8,988,474,514
Illinois,Hancock County,9,964,508,456
Illinois,Hancock County,10,964,482,482
Illinois,Hancock County,11,1174,605,569
Illinois,Hancock County,12,1365,680,685
Illinois,Hancock County,13,1414,705,709
Illinois,Hancock County,14,1224,604,620
Illinois,Hancock County,15,1012,457,555
Illinois,Hancock County,16,768,334,434
Illinois,Hancock County,17,538,249,289
Illinois,Hancock County,18,592,204,388
Illinois,Hardin County,0,3910,1984,1926
Illinois,Hardin County,1,165,75,90
Illinois,Hardin County,2,187,104,83
Illinois,Hardin County,3,217,111,106
Illinois,Hardin County,4,215,116,99
Illinois,Hardin County,5,183,82,101
Illinois,Hardin County,6,168,93,75
Illinois,Hardin County,7,178,93,85
Illinois,Hardin County,8,211,99,112
Illinois,Hardin County,9,199,110,89
Illinois,Hardin County,10,261,142,119
Illinois,Hardin County,11,287,146,141
Illinois,Hardin County,12,319,161,158
Illinois,Hardin County,13,315,146,169
Illinois,Hardin County,14,325,153,172
Illinois,Hardin County,15,270,141,129
Illinois,Hardin County,16,193,109,84
Illinois,Hardin County,17,116,51,65
Illinois,Hardin County,18,101,52,49
Illinois,Henderson County,0,6709,3276,3433
Illinois,Henderson County,1,338,180,158
Illinois,Henderson County,2,328,164,164
Illinois,Henderson County,3,342,169,173
Illinois,Henderson County,4,323,160,163
Illinois,Henderson County,5,333,173,160
Illinois,Henderson County,6,324,157,167
Illinois,Henderson County,7,308,162,146
Illinois,Henderson County,8,340,170,170
Illinois,Henderson County,9,350,181,169
Illinois,Henderson County,10,366,162,204
Illinois,Henderson County,11,482,234,248
Illinois,Henderson County,12,587,300,287
Illinois,Henderson County,13,602,295,307
Illinois,Henderson County,14,497,255,242
Illinois,Henderson County,15,398,195,203
Illinois,Henderson County,16,342,155,187
Illinois,Henderson County,17,208,87,121
Illinois,Henderson County,18,241,77,164
Illinois,Henry County,0,49090,24469,24621
Illinois,Henry County,1,2765,1399,1366
Illinois,Henry County,2,3004,1534,1470
Illinois,Henry County,3,3226,1689,1537
Illinois,Henry County,4,3049,1722,1327
Illinois,Henry County,5,2438,1267,1171
Illinois,Henry County,6,2701,1411,1290
Illinois,Henry County,7,2679,1333,1346
Illinois,Henry County,8,2969,1485,1484
Illinois,Henry County,9,2930,1501,1429
Illinois,Henry County,10,2986,1453,1533
Illinois,Henry County,11,3109,1529,1580
Illinois,Henry County,12,3701,1818,1883
Illinois,Henry County,13,3552,1767,1785
Illinois,Henry County,14,3106,1545,1561
Illinois,Henry County,15,2492,1186,1306
Illinois,Henry County,16,1860,888,972
Illinois,Henry County,17,1179,477,702
Illinois,Henry County,18,1344,465,879
Illinois,Iroquois County,0,27604,13561,14043
Illinois,Iroquois County,1,1521,743,778
Illinois,Iroquois County,2,1567,777,790
Illinois,Iroquois County,3,1728,892,836
Illinois,Iroquois County,4,1761,930,831
Illinois,Iroquois County,5,1445,774,671
Illinois,Iroquois County,6,1459,761,698
Illinois,Iroquois County,7,1377,678,699
Illinois,Iroquois County,8,1606,781,825
Illinois,Iroquois County,9,1544,784,760
Illinois,Iroquois County,10,1623,821,802
Illinois,Iroquois County,11,1761,846,915
Illinois,Iroquois County,12,2111,1031,1080
Illinois,Iroquois County,13,2149,1049,1100
Illinois,Iroquois County,14,1712,867,845
Illinois,Iroquois County,15,1439,670,769
Illinois,Iroquois County,16,1135,507,628
Illinois,Iroquois County,17,781,347,434
Illinois,Iroquois County,18,885,303,582
Illinois,Jackson County,0,57419,28550,28869
Illinois,Jackson County,1,3123,1645,1478
Illinois,Jackson County,2,2860,1437,1423
Illinois,Jackson County,3,2650,1309,1341
Illinois,Jackson County,4,4702,2462,2240
Illinois,Jackson County,5,9493,4915,4578
Illinois,Jackson County,6,4325,2254,2071
Illinois,Jackson County,7,3369,1731,1638
Illinois,Jackson County,8,3044,1537,1507
Illinois,Jackson County,9,2735,1380,1355
Illinois,Jackson County,10,2781,1389,1392
Illinois,Jackson County,11,2789,1390,1399
Illinois,Jackson County,12,3283,1539,1744
Illinois,Jackson County,13,3248,1588,1660
Illinois,Jackson County,14,2987,1448,1539
Illinois,Jackson County,15,2173,1016,1157
Illinois,Jackson County,16,1490,663,827
Illinois,Jackson County,17,1046,402,644
Illinois,Jackson County,18,1321,445,876
Illinois,Jasper County,0,9611,4808,4803
Illinois,Jasper County,1,575,301,274
Illinois,Jasper County,2,604,308,296
Illinois,Jasper County,3,622,326,296
Illinois,Jasper County,4,607,298,309
Illinois,Jasper County,5,485,225,260
Illinois,Jasper County,6,532,266,266
Illinois,Jasper County,7,506,267,239
Illinois,Jasper County,8,581,297,284
Illinois,Jasper County,9,521,284,237
Illinois,Jasper County,10,573,273,300
Illinois,Jasper County,11,635,303,332
Illinois,Jasper County,12,802,443,359
Illinois,Jasper County,13,706,342,364
Illinois,Jasper County,14,587,294,293
Illinois,Jasper County,15,457,215,242
Illinois,Jasper County,16,300,140,160
Illinois,Jasper County,17,235,116,119
Illinois,Jasper County,18,283,110,173
Illinois,Jefferson County,0,37820,19447,18373
Illinois,Jefferson County,1,2384,1225,1159
Illinois,Jefferson County,2,2388,1206,1182
Illinois,Jefferson County,3,2265,1130,1135
Illinois,Jefferson County,4,2105,1158,947
Illinois,Jefferson County,5,2068,1155,913
Illinois,Jefferson County,6,2593,1441,1152
Illinois,Jefferson County,7,2238,1225,1013
Illinois,Jefferson County,8,2424,1333,1091
Illinois,Jefferson County,9,2245,1235,1010
Illinois,Jefferson County,10,2372,1244,1128
Illinois,Jefferson County,11,2441,1297,1144
Illinois,Jefferson County,12,2502,1281,1221
Illinois,Jefferson County,13,2556,1229,1327
Illinois,Jefferson County,14,2308,1130,1178
Illinois,Jefferson County,15,1810,847,963
Illinois,Jefferson County,16,1299,600,699
Illinois,Jefferson County,17,869,397,472
Illinois,Jefferson County,18,953,314,639
Illinois,Jersey County,0,21847,10677,11170
Illinois,Jersey County,1,1090,555,535
Illinois,Jersey County,2,1194,600,594
Illinois,Jersey County,3,1326,660,666
Illinois,Jersey County,4,1436,706,730
Illinois,Jersey County,5,1422,727,695
Illinois,Jersey County,6,1190,601,589
Illinois,Jersey County,7,1181,594,587
Illinois,Jersey County,8,1253,625,628
Illinois,Jersey County,9,1173,582,591
Illinois,Jersey County,10,1377,709,668
Illinois,Jersey County,11,1509,748,761
Illinois,Jersey County,12,1777,853,924
Illinois,Jersey County,13,1659,802,857
Illinois,Jersey County,14,1326,637,689
Illinois,Jersey County,15,1000,468,532
Illinois,Jersey County,16,808,376,432
Illinois,Jersey County,17,576,246,330
Illinois,Jersey County,18,550,188,362
Illinois,Jo Daviess County,0,21366,10692,10674
Illinois,Jo Daviess County,1,895,462,433
Illinois,Jo Daviess County,2,1110,580,530
Illinois,Jo Daviess County,3,1253,660,593
Illinois,Jo Daviess County,4,1150,625,525
Illinois,Jo Daviess County,5,965,521,444
Illinois,Jo Daviess County,6,894,452,442
Illinois,Jo Daviess County,7,971,510,461
Illinois,Jo Daviess County,8,1066,519,547
Illinois,Jo Daviess County,9,1085,564,521
Illinois,Jo Daviess County,10,1189,590,599
Illinois,Jo Daviess County,11,1308,654,654
Illinois,Jo Daviess County,12,1687,854,833
Illinois,Jo Daviess County,13,1789,837,952
Illinois,Jo Daviess County,14,1881,940,941
Illinois,Jo Daviess County,15,1618,798,820
Illinois,Jo Daviess County,16,1115,537,578
Illinois,Jo Daviess County,17,698,336,362
Illinois,Jo Daviess County,18,692,253,439
Illinois,Johnson County,0,12456,6797,5659
Illinois,Johnson County,1,600,302,298
Illinois,Johnson County,2,616,329,287
Illinois,Johnson County,3,655,315,340
Illinois,Johnson County,4,724,424,300
Illinois,Johnson County,5,733,476,257
Illinois,Johnson County,6,836,542,294
Illinois,Johnson County,7,752,463,289
Illinois,Johnson County,8,721,413,308
Illinois,Johnson County,9,746,450,296
Illinois,Johnson County,10,806,469,337
Illinois,Johnson County,11,826,431,395
Illinois,Johnson County,12,909,469,440
Illinois,Johnson County,13,856,413,443
Illinois,Johnson County,14,819,414,405
Illinois,Johnson County,15,702,346,356
Illinois,Johnson County,16,542,267,275
Illinois,Johnson County,17,330,161,169
Illinois,Johnson County,18,283,113,170
Illinois,Kane County,0,534216,266050,268166
Illinois,Kane County,1,33904,17393,16511
Illinois,Kane County,2,36332,18471,17861
Illinois,Kane County,3,40609,20724,19885
Illinois,Kane County,4,39261,20223,19038
Illinois,Kane County,5,33890,17214,16676
Illinois,Kane County,6,31905,16333,15572
Illinois,Kane County,7,32132,16323,15809
Illinois,Kane County,8,35884,18254,17630
Illinois,Kane County,9,35450,17739,17711
Illinois,Kane County,10,38207,19038,19169
Illinois,Kane County,11,36507,18329,18178
Illinois,Kane County,12,36280,18057,18223
Illinois,Kane County,13,30846,15140,15706
Illinois,Kane County,14,25214,11983,13231
Illinois,Kane County,15,18896,8774,10122
Illinois,Kane County,16,12848,5758,7090
Illinois,Kane County,17,7853,3425,4428
Illinois,Kane County,18,8198,2872,5326
Illinois,Kankakee County,0,110024,54154,55870
Illinois,Kankakee County,1,6542,3356,3186
Illinois,Kankakee County,2,6553,3330,3223
Illinois,Kankakee County,3,7305,3726,3579
Illinois,Kankakee County,4,8384,4208,4176
Illinois,Kankakee County,5,8331,4185,4146
Illinois,Kankakee County,6,7092,3595,3497
Illinois,Kankakee County,7,6292,3144,3148
Illinois,Kankakee County,8,6625,3253,3372
Illinois,Kankakee County,9,6257,3075,3182
Illinois,Kankakee County,10,6611,3293,3318
Illinois,Kankakee County,11,6982,3425,3557
Illinois,Kankakee County,12,7540,3733,3807
Illinois,Kankakee County,13,6960,3412,3548
Illinois,Kankakee County,14,5920,2816,3104
Illinois,Kankakee County,15,4556,2120,2436
Illinois,Kankakee County,16,3184,1426,1758
Illinois,Kankakee County,17,2235,961,1274
Illinois,Kankakee County,18,2655,1096,1559
Illinois,Kendall County,0,127915,63410,64505
Illinois,Kendall County,1,8626,4500,4126
Illinois,Kendall County,2,10231,5234,4997
Illinois,Kendall County,3,11160,5688,5472
Illinois,Kendall County,4,9676,4975,4701
Illinois,Kendall County,5,7169,3738,3431
Illinois,Kendall County,6,7004,3425,3579
Illinois,Kendall County,7,8969,4343,4626
Illinois,Kendall County,8,10665,5216,5449
Illinois,Kendall County,9,10197,5019,5178
Illinois,Kendall County,10,10098,5060,5038
Illinois,Kendall County,11,8099,4143,3956
Illinois,Kendall County,12,7139,3583,3556
Illinois,Kendall County,13,5760,2692,3068
Illinois,Kendall County,14,4688,2155,2533
Illinois,Kendall County,15,3579,1656,1923
Illinois,Kendall County,16,2286,1023,1263
Illinois,Kendall County,17,1265,510,755
Illinois,Kendall County,18,1304,450,854
Illinois,Knox County,0,50112,25273,24839
Illinois,Knox County,1,2804,1461,1343
Illinois,Knox County,2,2592,1318,1274
Illinois,Knox County,3,2723,1403,1320
Illinois,Knox County,4,3134,1576,1558
Illinois,Knox County,5,3463,1799,1664
Illinois,Knox County,6,3081,1723,1358
Illinois,Knox County,7,2892,1664,1228
Illinois,Knox County,8,2850,1547,1303
Illinois,Knox County,9,2822,1525,1297
Illinois,Knox County,10,2800,1443,1357
Illinois,Knox County,11,3110,1561,1549
Illinois,Knox County,12,3486,1702,1784
Illinois,Knox County,13,3535,1728,1807
Illinois,Knox County,14,3327,1610,1717
Illinois,Knox County,15,2645,1206,1439
Illinois,Knox County,16,1934,918,1016
Illinois,Knox County,17,1363,555,808
Illinois,Knox County,18,1551,534,1017
Illinois,Lake County,0,700832,350273,350559
Illinois,Lake County,1,40191,20475,19716
Illinois,Lake County,2,45449,23196,22253
Illinois,Lake County,3,50999,25992,25007
Illinois,Lake County,4,53900,28617,25283
Illinois,Lake County,5,50167,27199,22968
Illinois,Lake County,6,39816,21152,18664
Illinois,Lake County,7,38736,19594,19142
Illinois,Lake County,8,43517,21558,21959
Illinois,Lake County,9,44185,21864,22321
Illinois,Lake County,10,48406,23890,24516
Illinois,Lake County,11,50005,24579,25426
Illinois,Lake County,12,51379,25265,26114
Illinois,Lake County,13,44272,21596,22676
Illinois,Lake County,14,34183,16516,17667
Illinois,Lake County,15,25214,11949,13265
Illinois,Lake County,16,16875,7581,9294
Illinois,Lake County,17,10887,4697,6190
Illinois,Lake County,18,12651,4553,8098
Illinois,LaSalle County,0,109430,55226,54204
Illinois,LaSalle County,1,6187,3191,2996
Illinois,LaSalle County,2,6225,3218,3007
Illinois,LaSalle County,3,6787,3409,3378
Illinois,LaSalle County,4,6765,3518,3247
Illinois,LaSalle County,5,6229,3380,2849
Illinois,LaSalle County,6,6740,3525,3215
Illinois,LaSalle County,7,6484,3467,3017
Illinois,LaSalle County,8,6729,3550,3179
Illinois,LaSalle County,9,6149,3244,2905
Illinois,LaSalle County,10,6548,3326,3222
Illinois,LaSalle County,11,7431,3742,3689
Illinois,LaSalle County,12,8515,4282,4233
Illinois,LaSalle County,13,7924,4015,3909
Illinois,LaSalle County,14,6610,3307,3303
Illinois,LaSalle County,15,4718,2225,2493
Illinois,LaSalle County,16,3728,1651,2077
Illinois,LaSalle County,17,2609,1138,1471
Illinois,LaSalle County,18,3052,1038,2014
Illinois,Lawrence County,0,15765,8836,6929
Illinois,Lawrence County,1,805,435,370
Illinois,Lawrence County,2,822,401,421
Illinois,Lawrence County,3,829,436,393
Illinois,Lawrence County,4,785,445,340
Illinois,Lawrence County,5,1103,768,335
Illinois,Lawrence County,6,1299,889,410
Illinois,Lawrence County,7,1095,708,387
Illinois,Lawrence County,8,1132,738,394
Illinois,Lawrence County,9,1060,647,413
Illinois,Lawrence County,10,1051,630,421
Illinois,Lawrence County,11,940,531,409
Illinois,Lawrence County,12,1081,533,548
Illinois,Lawrence County,13,1015,485,530
Illinois,Lawrence County,14,817,400,417
Illinois,Lawrence County,15,661,306,355
Illinois,Lawrence County,16,514,210,304
Illinois,Lawrence County,17,369,144,225
Illinois,Lawrence County,18,387,130,257
Illinois,Lee County,0,34223,18173,16050
Illinois,Lee County,1,1707,840,867
Illinois,Lee County,2,1895,966,929
Illinois,Lee County,3,1994,1013,981
Illinois,Lee County,4,1833,967,866
Illinois,Lee County,5,1851,1019,832
Illinois,Lee County,6,2213,1289,924
Illinois,Lee County,7,2116,1287,829
Illinois,Lee County,8,2167,1255,912
Illinois,Lee County,9,2003,1171,832
Illinois,Lee County,10,2193,1246,947
Illinois,Lee County,11,2366,1216,1150
Illinois,Lee County,12,2667,1463,1204
Illinois,Lee County,13,2510,1294,1216
Illinois,Lee County,14,2094,1063,1031
Illinois,Lee County,15,1680,833,847
Illinois,Lee County,16,1135,530,605
Illinois,Lee County,17,858,391,467
Illinois,Lee County,18,941,330,611
Illinois,Livingston County,0,35761,17935,17826
Illinois,Livingston County,1,1934,976,958
Illinois,Livingston County,2,2082,1089,993
Illinois,Livingston County,3,2224,1183,1041
Illinois,Livingston County,4,2193,1194,999
Illinois,Livingston County,5,2142,1111,1031
Illinois,Livingston County,6,2299,1218,1081
Illinois,Livingston County,7,2203,1130,1073
Illinois,Livingston County,8,2137,1105,1032
Illinois,Livingston County,9,2032,1033,999
Illinois,Livingston County,10,2090,1073,1017
Illinois,Livingston County,11,2331,1174,1157
Illinois,Livingston County,12,2691,1349,1342
Illinois,Livingston County,13,2535,1258,1277
Illinois,Livingston County,14,2111,1057,1054
Illinois,Livingston County,15,1536,690,846
Illinois,Livingston County,16,1229,558,671
Illinois,Livingston County,17,841,358,483
Illinois,Livingston County,18,1151,379,772
Illinois,Logan County,0,28925,14685,14240
Illinois,Logan County,1,1529,809,720
Illinois,Logan County,2,1469,748,721
Illinois,Logan County,3,1591,791,800
Illinois,Logan County,4,1888,995,893
Illinois,Logan County,5,2080,1165,915
Illinois,Logan County,6,2026,1150,876
Illinois,Logan County,7,1964,1100,864
Illinois,Logan County,8,2021,1095,926
Illinois,Logan County,9,1766,876,890
Illinois,Logan County,10,1717,887,830
Illinois,Logan County,11,1738,887,851
Illinois,Logan County,12,1977,973,1004
Illinois,Logan County,13,1874,937,937
Illinois,Logan County,14,1611,781,830
Illinois,Logan County,15,1188,541,647
Illinois,Logan County,16,940,406,534
Illinois,Logan County,17,714,271,443
Illinois,Logan County,18,832,273,559
Illinois,McDonough County,0,29955,14674,15281
Illinois,McDonough County,1,1329,658,671
Illinois,McDonough County,2,1409,710,699
Illinois,McDonough County,3,1465,755,710
Illinois,McDonough County,4,2834,1300,1534
Illinois,McDonough County,5,4666,2403,2263
Illinois,McDonough County,6,1888,1049,839
Illinois,McDonough County,7,1633,843,790
Illinois,McDonough County,8,1544,744,800
Illinois,McDonough County,9,1359,675,684
Illinois,McDonough County,10,1467,734,733
Illinois,McDonough County,11,1458,720,738
Illinois,McDonough County,12,1783,858,925
Illinois,McDonough County,13,1836,907,929
Illinois,McDonough County,14,1664,800,864
Illinois,McDonough County,15,1263,616,647
Illinois,McDonough County,16,894,410,484
Illinois,McDonough County,17,608,244,364
Illinois,McDonough County,18,855,248,607
Illinois,McHenry County,0,308570,153614,154956
Illinois,McHenry County,1,16842,8570,8272
Illinois,McHenry County,2,19303,9908,9395
Illinois,McHenry County,3,22153,11425,10728
Illinois,McHenry County,4,21724,11161,10563
Illinois,McHenry County,5,18154,9321,8833
Illinois,McHenry County,6,17581,9074,8507
Illinois,McHenry County,7,17548,8937,8611
Illinois,McHenry County,8,19537,9844,9693
Illinois,McHenry County,9,19230,9572,9658
Illinois,McHenry County,10,22467,11090,11377
Illinois,McHenry County,11,24060,11881,12179
Illinois,McHenry County,12,24515,12197,12318
Illinois,McHenry County,13,20432,10168,10264
Illinois,McHenry County,14,15741,7623,8118
Illinois,McHenry County,15,11721,5457,6264
Illinois,McHenry County,16,8141,3707,4434
Illinois,McHenry County,17,4745,2042,2703
Illinois,McHenry County,18,4676,1637,3039
Illinois,McLean County,0,172828,83968,88860
Illinois,McLean County,1,10095,5070,5025
Illinois,McLean County,2,10135,5087,5048
Illinois,McLean County,3,10514,5349,5165
Illinois,McLean County,4,14796,6927,7869
Illinois,McLean County,5,21759,10555,11204
Illinois,McLean County,6,11703,5902,5801
Illinois,McLean County,7,10753,5390,5363
Illinois,McLean County,8,10968,5471,5497
Illinois,McLean County,9,9718,4848,4870
Illinois,McLean County,10,9854,4950,4904
Illinois,McLean County,11,9746,4707,5039
Illinois,McLean County,12,10481,5094,5387
Illinois,McLean County,13,9446,4493,4953
Illinois,McLean County,14,7763,3598,4165
Illinois,McLean County,15,5576,2716,2860
Illinois,McLean County,16,3844,1678,2166
Illinois,McLean County,17,2623,1103,1520
Illinois,McLean County,18,3054,1030,2024
Illinois,Macon County,0,104712,50158,54554
Illinois,Macon County,1,6425,3334,3091
Illinois,Macon County,2,6415,3271,3144
Illinois,Macon County,3,6463,3275,3188
Illinois,Macon County,4,6586,3325,3261
Illinois,Macon County,5,6449,3107,3342
Illinois,Macon County,6,6601,3196,3405
Illinois,Macon County,7,5867,2767,3100
Illinois,Macon County,8,6089,2902,3187
Illinois,Macon County,9,5909,2787,3122
Illinois,Macon County,10,5888,2857,3031
Illinois,Macon County,11,6222,3003,3219
Illinois,Macon County,12,7292,3578,3714
Illinois,Macon County,13,7546,3583,3963
Illinois,Macon County,14,6533,3048,3485
Illinois,Macon County,15,5011,2334,2677
Illinois,Macon County,16,3733,1682,2051
Illinois,Macon County,17,2517,1059,1458
Illinois,Macon County,18,3166,1050,2116
Illinois,Macoupin County,0,45313,22409,22904
Illinois,Macoupin County,1,2410,1267,1143
Illinois,Macoupin County,2,2505,1268,1237
Illinois,Macoupin County,3,2928,1552,1376
Illinois,Macoupin County,4,2811,1479,1332
Illinois,Macoupin County,5,2443,1262,1181
Illinois,Macoupin County,6,2479,1235,1244
Illinois,Macoupin County,7,2509,1250,1259
Illinois,Macoupin County,8,2790,1384,1406
Illinois,Macoupin County,9,2634,1326,1308
Illinois,Macoupin County,10,2766,1428,1338
Illinois,Macoupin County,11,3018,1447,1571
Illinois,Macoupin County,12,3530,1742,1788
Illinois,Macoupin County,13,3484,1733,1751
Illinois,Macoupin County,14,2891,1420,1471
Illinois,Macoupin County,15,2194,1020,1174
Illinois,Macoupin County,16,1535,700,835
Illinois,Macoupin County,17,1139,463,676
Illinois,Macoupin County,18,1247,433,814
Illinois,Madison County,0,264461,128768,135693
Illinois,Madison County,1,15202,7827,7375
Illinois,Madison County,2,16015,8206,7809
Illinois,Madison County,3,16582,8498,8084
Illinois,Madison County,4,16019,8301,7718
Illinois,Madison County,5,15414,7641,7773
Illinois,Madison County,6,17868,8919,8949
Illinois,Madison County,7,17544,8675,8869
Illinois,Madison County,8,16973,8329,8644
Illinois,Madison County,9,15211,7369,7842
Illinois,Madison County,10,16711,8148,8563
Illinois,Madison County,11,17327,8574,8753
Illinois,Madison County,12,19580,9649,9931
Illinois,Madison County,13,18530,9022,9508
Illinois,Madison County,14,14543,6748,7795
Illinois,Madison County,15,11081,5071,6010
Illinois,Madison County,16,8160,3521,4639
Illinois,Madison County,17,5544,2269,3275
Illinois,Madison County,18,6157,2001,4156
Illinois,Marion County,0,37620,18393,19227
Illinois,Marion County,1,2424,1229,1195
Illinois,Marion County,2,2428,1232,1196
Illinois,Marion County,3,2464,1279,1185
Illinois,Marion County,4,2147,1076,1071
Illinois,Marion County,5,1994,1029,965
Illinois,Marion County,6,2435,1214,1221
Illinois,Marion County,7,2071,1046,1025
Illinois,Marion County,8,2187,1085,1102
Illinois,Marion County,9,2051,1029,1022
Illinois,Marion County,10,2190,1098,1092
Illinois,Marion County,11,2354,1171,1183
Illinois,Marion County,12,2761,1317,1444
Illinois,Marion County,13,2706,1299,1407
Illinois,Marion County,14,2241,1083,1158
Illinois,Marion County,15,1789,823,966
Illinois,Marion County,16,1349,593,756
Illinois,Marion County,17,963,411,552
Illinois,Marion County,18,1066,379,687
Illinois,Marshall County,0,11534,5725,5809
Illinois,Marshall County,1,597,304,293
Illinois,Marshall County,2,626,310,316
Illinois,Marshall County,3,653,346,307
Illinois,Marshall County,4,639,344,295
Illinois,Marshall County,5,582,289,293
Illinois,Marshall County,6,654,355,299
Illinois,Marshall County,7,562,276,286
Illinois,Marshall County,8,626,324,302
Illinois,Marshall County,9,621,326,295
Illinois,Marshall County,10,678,341,337
Illinois,Marshall County,11,775,375,400
Illinois,Marshall County,12,908,451,457
Illinois,Marshall County,13,907,453,454
Illinois,Marshall County,14,790,390,400
Illinois,Marshall County,15,659,317,342
Illinois,Marshall County,16,523,241,282
Illinois,Marshall County,17,329,135,194
Illinois,Marshall County,18,405,148,257
Illinois,Mason County,0,13565,6689,6876
Illinois,Mason County,1,688,331,357
Illinois,Mason County,2,772,408,364
Illinois,Mason County,3,841,401,440
Illinois,Mason County,4,802,398,404
Illinois,Mason County,5,684,358,326
Illinois,Mason County,6,744,392,352
Illinois,Mason County,7,655,334,321
Illinois,Mason County,8,801,389,412
Illinois,Mason County,9,763,383,380
Illinois,Mason County,10,848,438,410
Illinois,Mason County,11,904,471,433
Illinois,Mason County,12,1052,511,541
Illinois,Mason County,13,1000,486,514
Illinois,Mason County,14,900,462,438
Illinois,Mason County,15,751,359,392
Illinois,Mason County,16,569,284,285
Illinois,Mason County,17,366,160,206
Illinois,Mason County,18,425,124,301
Illinois,Massac County,0,14080,6743,7337
Illinois,Massac County,1,768,405,363
Illinois,Massac County,2,835,425,410
Illinois,Massac County,3,940,446,494
Illinois,Massac County,4,835,407,428
Illinois,Massac County,5,687,347,340
Illinois,Massac County,6,735,368,367
Illinois,Massac County,7,641,312,329
Illinois,Massac County,8,856,376,480
Illinois,Massac County,9,852,423,429
Illinois,Massac County,10,932,479,453
Illinois,Massac County,11,944,467,477
Illinois,Massac County,12,1075,523,552
Illinois,Massac County,13,1023,477,546
Illinois,Massac County,14,809,383,426
Illinois,Massac County,15,707,319,388
Illinois,Massac County,16,530,235,295
Illinois,Massac County,17,412,177,235
Illinois,Massac County,18,499,174,325
Illinois,Menard County,0,12288,5989,6299
Illinois,Menard County,1,676,336,340
Illinois,Menard County,2,710,380,330
Illinois,Menard County,3,814,387,427
Illinois,Menard County,4,749,383,366
Illinois,Menard County,5,626,333,293
Illinois,Menard County,6,662,315,347
Illinois,Menard County,7,683,329,354
Illinois,Menard County,8,788,390,398
Illinois,Menard County,9,731,363,368
Illinois,Menard County,10,700,338,362
Illinois,Menard County,11,882,432,450
Illinois,Menard County,12,965,471,494
Illinois,Menard County,13,924,464,460
Illinois,Menard County,14,757,347,410
Illinois,Menard County,15,625,304,321
Illinois,Menard County,16,400,188,212
Illinois,Menard County,17,285,120,165
Illinois,Menard County,18,311,109,202
Illinois,Mercer County,0,15601,7792,7809
Illinois,Mercer County,1,800,416,384
Illinois,Mercer County,2,873,412,461
Illinois,Mercer County,3,1007,503,504
Illinois,Mercer County,4,974,503,471
Illinois,Mercer County,5,776,422,354
Illinois,Mercer County,6,803,421,382
Illinois,Mercer County,7,808,436,372
Illinois,Mercer County,8,907,433,474
Illinois,Mercer County,9,899,464,435
Illinois,Mercer County,10,945,474,471
Illinois,Mercer County,11,1082,518,564
Illinois,Mercer County,12,1228,619,609
Illinois,Mercer County,13,1119,573,546
Illinois,Mercer County,14,1031,520,511
Illinois,Mercer County,15,817,392,425
Illinois,Mercer County,16,660,322,338
Illinois,Mercer County,17,389,167,222
Illinois,Mercer County,18,483,197,286
Illinois,Monroe County,0,34335,17058,17277
Illinois,Monroe County,1,1919,994,925
Illinois,Monroe County,2,2068,1042,1026
Illinois,Monroe County,3,2203,1100,1103
Illinois,Monroe County,4,2122,1164,958
Illinois,Monroe County,5,1704,908,796
Illinois,Monroe County,6,1792,916,876
Illinois,Monroe County,7,1920,927,993
Illinois,Monroe County,8,2340,1155,1185
Illinois,Monroe County,9,2058,1089,969
Illinois,Monroe County,10,2208,1078,1130
Illinois,Monroe County,11,2486,1175,1311
Illinois,Monroe County,12,2738,1368,1370
Illinois,Monroe County,13,2677,1342,1335
Illinois,Monroe County,14,1980,984,996
Illinois,Monroe County,15,1400,711,689
Illinois,Monroe County,16,994,467,527
Illinois,Monroe County,17,814,317,497
Illinois,Monroe County,18,912,321,591
Illinois,Montgomery County,0,28601,14983,13618
Illinois,Montgomery County,1,1451,698,753
Illinois,Montgomery County,2,1598,805,793
Illinois,Montgomery County,3,1676,871,805
Illinois,Montgomery County,4,1564,840,724
Illinois,Montgomery County,5,1624,988,636
Illinois,Montgomery County,6,1856,1135,721
Illinois,Montgomery County,7,1689,977,712
Illinois,Montgomery County,8,1886,1074,812
Illinois,Montgomery County,9,1623,928,695
Illinois,Montgomery County,10,1780,1001,779
Illinois,Montgomery County,11,1920,1000,920
Illinois,Montgomery County,12,2111,1053,1058
Illinois,Montgomery County,13,2059,1036,1023
Illinois,Montgomery County,14,1748,886,862
Illinois,Montgomery County,15,1273,616,657
Illinois,Montgomery County,16,1039,451,588
Illinois,Montgomery County,17,763,320,443
Illinois,Montgomery County,18,941,304,637
Illinois,Morgan County,0,33976,17247,16729
Illinois,Morgan County,1,1632,849,783
Illinois,Morgan County,2,1741,885,856
Illinois,Morgan County,3,1831,979,852
Illinois,Morgan County,4,2259,1198,1061
Illinois,Morgan County,5,2393,1257,1136
Illinois,Morgan County,6,2139,1163,976
Illinois,Morgan County,7,2117,1168,949
Illinois,Morgan County,8,2141,1212,929
Illinois,Morgan County,9,1939,1046,893
Illinois,Morgan County,10,1976,1027,949
Illinois,Morgan County,11,2194,1117,1077
Illinois,Morgan County,12,2523,1258,1265
Illinois,Morgan County,13,2292,1123,1169
Illinois,Morgan County,14,2080,1001,1079
Illinois,Morgan County,15,1633,765,868
Illinois,Morgan County,16,1239,528,711
Illinois,Morgan County,17,846,370,476
Illinois,Morgan County,18,1001,301,700
Illinois,Moultrie County,0,14717,7204,7513
Illinois,Moultrie County,1,983,502,481
Illinois,Moultrie County,2,990,510,480
Illinois,Moultrie County,3,1099,561,538
Illinois,Moultrie County,4,973,520,453
Illinois,Moultrie County,5,788,407,381
Illinois,Moultrie County,6,858,437,421
Illinois,Moultrie County,7,828,410,418
Illinois,Moultrie County,8,957,464,493
Illinois,Moultrie County,9,796,389,407
Illinois,Moultrie County,10,828,405,423
Illinois,Moultrie County,11,878,445,433
Illinois,Moultrie County,12,1020,483,537
Illinois,Moultrie County,13,937,458,479
Illinois,Moultrie County,14,871,421,450
Illinois,Moultrie County,15,639,297,342
Illinois,Moultrie County,16,443,202,241
Illinois,Moultrie County,17,357,151,206
Illinois,Moultrie County,18,472,142,330
Illinois,Ogle County,0,50923,25292,25631
Illinois,Ogle County,1,2810,1453,1357
Illinois,Ogle County,2,3046,1553,1493
Illinois,Ogle County,3,3382,1695,1687
Illinois,Ogle County,4,3375,1700,1675
Illinois,Ogle County,5,2744,1418,1326
Illinois,Ogle County,6,2993,1526,1467
Illinois,Ogle County,7,2812,1389,1423
Illinois,Ogle County,8,3015,1549,1466
Illinois,Ogle County,9,2857,1416,1441
Illinois,Ogle County,10,3266,1644,1622
Illinois,Ogle County,11,3544,1788,1756
Illinois,Ogle County,12,4037,2010,2027
Illinois,Ogle County,13,3495,1757,1738
Illinois,Ogle County,14,2910,1440,1470
Illinois,Ogle County,15,2447,1169,1278
Illinois,Ogle County,16,1798,819,979
Illinois,Ogle County,17,1222,560,662
Illinois,Ogle County,18,1170,406,764
Illinois,Peoria County,0,180621,87517,93104
Illinois,Peoria County,1,12295,6275,6020
Illinois,Peoria County,2,11802,6124,5678
Illinois,Peoria County,3,11630,5996,5634
Illinois,Peoria County,4,11694,5855,5839
Illinois,Peoria County,5,11365,5609,5756
Illinois,Peoria County,6,12726,6258,6468
Illinois,Peoria County,7,11848,5802,6046
Illinois,Peoria County,8,11528,5831,5697
Illinois,Peoria County,9,10325,5016,5309
Illinois,Peoria County,10,10766,5254,5512
Illinois,Peoria County,11,10749,5259,5490
Illinois,Peoria County,12,11572,5441,6131
Illinois,Peoria County,13,11505,5364,6141
Illinois,Peoria County,14,9891,4651,5240
Illinois,Peoria County,15,7677,3516,4161
Illinois,Peoria County,16,5315,2361,2954
Illinois,Peoria County,17,3659,1519,2140
Illinois,Peoria County,18,4274,1386,2888
Illinois,Perry County,0,21174,11659,9515
Illinois,Perry County,1,1061,515,546
Illinois,Perry County,2,1047,527,520
Illinois,Perry County,3,1260,656,604
Illinois,Perry County,4,1244,742,502
Illinois,Perry County,5,1441,988,453
Illinois,Perry County,6,1538,1009,529
Illinois,Perry County,7,1373,880,493
Illinois,Perry County,8,1367,821,546
Illinois,Perry County,9,1363,778,585
Illinois,Perry County,10,1359,788,571
Illinois,Perry County,11,1338,721,617
Illinois,Perry County,12,1473,765,708
Illinois,Perry County,13,1365,693,672
Illinois,Perry County,14,1195,599,596
Illinois,Perry County,15,1023,445,578
Illinois,Perry County,16,724,339,385
Illinois,Perry County,17,493,230,263
Illinois,Perry County,18,510,163,347
Illinois,Piatt County,0,16396,8125,8271
Illinois,Piatt County,1,961,484,477
Illinois,Piatt County,2,999,505,494
Illinois,Piatt County,3,1035,539,496
Illinois,Piatt County,4,1032,534,498
Illinois,Piatt County,5,843,445,398
Illinois,Piatt County,6,826,414,412
Illinois,Piatt County,7,967,473,494
Illinois,Piatt County,8,1001,529,472
Illinois,Piatt County,9,967,474,493
Illinois,Piatt County,10,987,493,494
Illinois,Piatt County,11,1026,497,529
Illinois,Piatt County,12,1346,659,687
Illinois,Piatt County,13,1232,605,627
Illinois,Piatt County,14,974,491,483
Illinois,Piatt County,15,810,397,413
Illinois,Piatt County,16,576,259,317
Illinois,Piatt County,17,427,166,261
Illinois,Piatt County,18,387,161,226
Illinois,Pike County,0,15611,7829,7782
Illinois,Pike County,1,949,495,454
Illinois,Pike County,2,925,484,441
Illinois,Pike County,3,1008,524,484
Illinois,Pike County,4,934,494,440
Illinois,Pike County,5,828,448,380
Illinois,Pike County,6,884,454,430
Illinois,Pike County,7,902,467,435
Illinois,Pike County,8,912,478,434
Illinois,Pike County,9,828,420,408
Illinois,Pike County,10,949,496,453
Illinois,Pike County,11,971,502,469
Illinois,Pike County,12,1127,522,605
Illinois,Pike County,13,1123,578,545
Illinois,Pike County,14,990,497,493
Illinois,Pike County,15,732,362,370
Illinois,Pike County,16,630,285,345
Illinois,Pike County,17,433,181,252
Illinois,Pike County,18,486,142,344
Illinois,Pope County,0,4212,2178,2034
Illinois,Pope County,1,111,70,41
Illinois,Pope County,2,124,69,55
Illinois,Pope County,3,160,89,71
Illinois,Pope County,4,253,162,91
Illinois,Pope County,5,251,156,95
Illinois,Pope County,6,173,84,89
Illinois,Pope County,7,157,65,92
Illinois,Pope County,8,222,118,104
Illinois,Pope County,9,211,104,107
Illinois,Pope County,10,251,115,136
Illinois,Pope County,11,292,156,136
Illinois,Pope County,12,424,211,213
Illinois,Pope County,13,405,192,213
Illinois,Pope County,14,379,199,180
Illinois,Pope County,15,286,145,141
Illinois,Pope County,16,221,105,116
Illinois,Pope County,17,146,82,64
Illinois,Pope County,18,146,56,90
Illinois,Pulaski County,0,5463,2655,2808
Illinois,Pulaski County,1,341,166,175
Illinois,Pulaski County,2,280,141,139
Illinois,Pulaski County,3,352,170,182
Illinois,Pulaski County,4,319,159,160
Illinois,Pulaski County,5,251,136,115
Illinois,Pulaski County,6,327,163,164
Illinois,Pulaski County,7,297,147,150
Illinois,Pulaski County,8,271,136,135
Illinois,Pulaski County,9,307,148,159
Illinois,Pulaski County,10,308,150,158
Illinois,Pulaski County,11,317,161,156
Illinois,Pulaski County,12,424,210,214
Illinois,Pulaski County,13,445,207,238
Illinois,Pulaski County,14,412,188,224
Illinois,Pulaski County,15,289,139,150
Illinois,Pulaski County,16,217,89,128
Illinois,Pulaski County,17,158,79,79
Illinois,Pulaski County,18,148,66,82
Illinois,Putnam County,0,5740,2923,2817
Illinois,Putnam County,1,279,145,134
Illinois,Putnam County,2,313,169,144
Illinois,Putnam County,3,337,175,162
Illinois,Putnam County,4,332,172,160
Illinois,Putnam County,5,293,164,129
Illinois,Putnam County,6,300,168,132
Illinois,Putnam County,7,273,126,147
Illinois,Putnam County,8,358,191,167
Illinois,Putnam County,9,290,146,144
Illinois,Putnam County,10,326,168,158
Illinois,Putnam County,11,385,180,205
Illinois,Putnam County,12,492,246,246
Illinois,Putnam County,13,464,250,214
Illinois,Putnam County,14,428,225,203
Illinois,Putnam County,15,353,166,187
Illinois,Putnam County,16,227,113,114
Illinois,Putnam County,17,167,78,89
Illinois,Putnam County,18,123,41,82
Illinois,Randolph County,0,32106,17656,14450
Illinois,Randolph County,1,1683,817,866
Illinois,Randolph County,2,1683,846,837
Illinois,Randolph County,3,1763,937,826
Illinois,Randolph County,4,1683,890,793
Illinois,Randolph County,5,1861,1148,713
Illinois,Randolph County,6,2243,1434,809
Illinois,Randolph County,7,2214,1450,764
Illinois,Randolph County,8,2170,1344,826
Illinois,Randolph County,9,2048,1246,802
Illinois,Randolph County,10,2069,1254,815
Illinois,Randolph County,11,2103,1201,902
Illinois,Randolph County,12,2382,1319,1063
Illinois,Randolph County,13,2232,1153,1079
Illinois,Randolph County,14,1795,889,906
Illinois,Randolph County,15,1419,665,754
Illinois,Randolph County,16,1074,465,609
Illinois,Randolph County,17,748,298,450
Illinois,Randolph County,18,936,300,636
Illinois,Richland County,0,15763,7799,7964
Illinois,Richland County,1,1060,531,529
Illinois,Richland County,2,1000,532,468
Illinois,Richland County,3,1016,525,491
Illinois,Richland County,4,881,465,416
Illinois,Richland County,5,737,391,346
Illinois,Richland County,6,982,510,472
Illinois,Richland County,7,897,445,452
Illinois,Richland County,8,920,465,455
Illinois,Richland County,9,879,452,427
Illinois,Richland County,10,894,441,453
Illinois,Richland County,11,980,482,498
Illinois,Richland County,12,1148,564,584
Illinois,Richland County,13,1141,565,576
Illinois,Richland County,14,904,438,466
Illinois,Richland County,15,675,323,352
Illinois,Richland County,16,619,291,328
Illinois,Richland County,17,469,195,274
Illinois,Richland County,18,561,184,377
Illinois,Rock Island County,0,143477,70680,72797
Illinois,Rock Island County,1,8943,4652,4291
Illinois,Rock Island County,2,8932,4496,4436
Illinois,Rock Island County,3,8888,4561,4327
Illinois,Rock Island County,4,8859,4560,4299
Illinois,Rock Island County,5,8697,4383,4314
Illinois,Rock Island County,6,9145,4569,4576
Illinois,Rock Island County,7,8599,4529,4070
Illinois,Rock Island County,8,9050,4644,4406
Illinois,Rock Island County,9,8112,4060,4052
Illinois,Rock Island County,10,8316,4287,4029
Illinois,Rock Island County,11,8442,4175,4267
Illinois,Rock Island County,12,9756,4756,5000
Illinois,Rock Island County,13,10066,4851,5215
Illinois,Rock Island County,14,8634,4037,4597
Illinois,Rock Island County,15,6781,3158,3623
Illinois,Rock Island County,16,5046,2291,2755
Illinois,Rock Island County,17,3420,1398,2022
Illinois,Rock Island County,18,3791,1273,2518
Illinois,St. Clair County,0,261059,125939,135120
Illinois,St. Clair County,1,16419,8437,7982
Illinois,St. Clair County,2,16796,8677,8119
Illinois,St. Clair County,3,17472,8926,8546
Illinois,St. Clair County,4,16247,8380,7867
Illinois,St. Clair County,5,15822,8051,7771
Illinois,St. Clair County,6,17407,8623,8784
Illinois,St. Clair County,7,16752,8005,8747
Illinois,St. Clair County,8,17517,8521,8996
Illinois,St. Clair County,9,15580,7386,8194
Illinois,St. Clair County,10,16158,7573,8585
Illinois,St. Clair County,11,17173,8216,8957
Illinois,St. Clair County,12,18857,9102,9755
Illinois,St. Clair County,13,17598,8274,9324
Illinois,St. Clair County,14,13766,6417,7349
Illinois,St. Clair County,15,10044,4628,5416
Illinois,St. Clair County,16,6959,3016,3943
Illinois,St. Clair County,17,4899,1869,3030
Illinois,St. Clair County,18,5593,1838,3755
Illinois,Saline County,0,23906,11799,12107
Illinois,Saline County,1,1520,755,765
Illinois,Saline County,2,1319,702,617
Illinois,Saline County,3,1356,701,655
Illinois,Saline County,4,1490,915,575
Illinois,Saline County,5,1225,617,608
Illinois,Saline County,6,1535,753,782
Illinois,Saline County,7,1417,742,675
Illinois,Saline County,8,1380,680,700
Illinois,Saline County,9,1295,611,684
Illinois,Saline County,10,1532,778,754
Illinois,Saline County,11,1610,781,829
Illinois,Saline County,12,1705,814,891
Illinois,Saline County,13,1677,802,875
Illinois,Saline County,14,1482,720,762
Illinois,Saline County,15,1202,562,640
Illinois,Saline County,16,901,384,517
Illinois,Saline County,17,624,259,365
Illinois,Saline County,18,636,223,413
Illinois,Sangamon County,0,195348,93741,101607
Illinois,Sangamon County,1,11020,5657,5363
Illinois,Sangamon County,2,11872,6205,5667
Illinois,Sangamon County,3,12690,6349,6341
Illinois,Sangamon County,4,12161,6243,5918
Illinois,Sangamon County,5,11401,5617,5784
Illinois,Sangamon County,6,12239,5913,6326
Illinois,Sangamon County,7,12348,5959,6389
Illinois,Sangamon County,8,12593,6015,6578
Illinois,Sangamon County,9,11359,5584,5775
Illinois,Sangamon County,10,12178,5911,6267
Illinois,Sangamon County,11,12827,6259,6568
Illinois,Sangamon County,12,14282,6860,7422
Illinois,Sangamon County,13,13491,6313,7178
Illinois,Sangamon County,14,11793,5440,6353
Illinois,Sangamon County,15,8678,3880,4798
Illinois,Sangamon County,16,5874,2494,3380
Illinois,Sangamon County,17,3982,1621,2361
Illinois,Sangamon County,18,4560,1421,3139
Illinois,Schuyler County,0,6907,3624,3283
Illinois,Schuyler County,1,277,152,125
Illinois,Schuyler County,2,342,166,176
Illinois,Schuyler County,3,381,180,201
Illinois,Schuyler County,4,380,182,198
Illinois,Schuyler County,5,333,184,149
Illinois,Schuyler County,6,375,209,166
Illinois,Schuyler County,7,353,191,162
Illinois,Schuyler County,8,421,240,181
Illinois,Schuyler County,9,431,266,165
Illinois,Schuyler County,10,496,277,219
Illinois,Schuyler County,11,516,288,228
Illinois,Schuyler County,12,519,275,244
Illinois,Schuyler County,13,509,266,243
Illinois,Schuyler County,14,498,249,249
Illinois,Schuyler County,15,393,219,174
Illinois,Schuyler County,16,276,127,149
Illinois,Schuyler County,17,196,80,116
Illinois,Schuyler County,18,211,73,138
Illinois,Scott County,0,4926,2434,2492
Illinois,Scott County,1,246,134,112
Illinois,Scott County,2,283,147,136
Illinois,Scott County,3,348,176,172
Illinois,Scott County,4,280,152,128
Illinois,Scott County,5,243,125,118
Illinois,Scott County,6,241,118,123
Illinois,Scott County,7,249,109,140
Illinois,Scott County,8,283,139,144
Illinois,Scott County,9,307,158,149
Illinois,Scott County,10,322,160,162
Illinois,Scott County,11,347,170,177
Illinois,Scott County,12,430,219,211
Illinois,Scott County,13,368,195,173
Illinois,Scott County,14,301,141,160
Illinois,Scott County,15,201,88,113
Illinois,Scott County,16,201,91,110
Illinois,Scott County,17,142,70,72
Illinois,Scott County,18,134,42,92
Illinois,Shelby County,0,21741,10815,10926
Illinois,Shelby County,1,1265,646,619
Illinois,Shelby County,2,1210,620,590
Illinois,Shelby County,3,1380,745,635
Illinois,Shelby County,4,1212,610,602
Illinois,Shelby County,5,1073,526,547
Illinois,Shelby County,6,1206,625,581
Illinois,Shelby County,7,1176,588,588
Illinois,Shelby County,8,1193,608,585
Illinois,Shelby County,9,1159,602,557
Illinois,Shelby County,10,1289,649,640
Illinois,Shelby County,11,1416,708,708
Illinois,Shelby County,12,1619,802,817
Illinois,Shelby County,13,1646,815,831
Illinois,Shelby County,14,1495,712,783
Illinois,Shelby County,15,1232,592,640
Illinois,Shelby County,16,902,448,454
Illinois,Shelby County,17,567,262,305
Illinois,Shelby County,18,701,257,444
Illinois,Stark County,0,5427,2687,2740
Illinois,Stark County,1,293,134,159
Illinois,Stark County,2,317,140,177
Illinois,Stark County,3,340,182,158
Illinois,Stark County,4,340,165,175
Illinois,Stark County,5,281,148,133
Illinois,Stark County,6,295,150,145
Illinois,Stark County,7,254,133,121
Illinois,Stark County,8,290,146,144
Illinois,Stark County,9,317,175,142
Illinois,Stark County,10,314,147,167
Illinois,Stark County,11,354,183,171
Illinois,Stark County,12,376,201,175
Illinois,Stark County,13,446,216,230
Illinois,Stark County,14,357,178,179
Illinois,Stark County,15,294,148,146
Illinois,Stark County,16,240,119,121
Illinois,Stark County,17,158,76,82
Illinois,Stark County,18,161,46,115
Illinois,Stephenson County,0,44753,21756,22997
Illinois,Stephenson County,1,2421,1234,1187
Illinois,Stephenson County,2,2617,1298,1319
Illinois,Stephenson County,3,2777,1415,1362
Illinois,Stephenson County,4,2645,1377,1268
Illinois,Stephenson County,5,2397,1244,1153
Illinois,Stephenson County,6,2421,1212,1209
Illinois,Stephenson County,7,2239,1073,1166
Illinois,Stephenson County,8,2390,1160,1230
Illinois,Stephenson County,9,2208,1070,1138
Illinois,Stephenson County,10,2660,1353,1307
Illinois,Stephenson County,11,2951,1460,1491
Illinois,Stephenson County,12,3459,1690,1769
Illinois,Stephenson County,13,3396,1666,1730
Illinois,Stephenson County,14,3002,1463,1539
Illinois,Stephenson County,15,2393,1108,1285
Illinois,Stephenson County,16,1788,816,972
Illinois,Stephenson County,17,1383,596,787
Illinois,Stephenson County,18,1606,521,1085
Illinois,Tazewell County,0,132328,65040,67288
Illinois,Tazewell County,1,7670,3973,3697
Illinois,Tazewell County,2,8288,4143,4145
Illinois,Tazewell County,3,8855,4451,4404
Illinois,Tazewell County,4,7786,4001,3785
Illinois,Tazewell County,5,6721,3497,3224
Illinois,Tazewell County,6,7827,3962,3865
Illinois,Tazewell County,7,8204,4215,3989
Illinois,Tazewell County,8,8847,4480,4367
Illinois,Tazewell County,9,8284,4206,4078
Illinois,Tazewell County,10,8377,4159,4218
Illinois,Tazewell County,11,8322,4128,4194
Illinois,Tazewell County,12,9348,4554,4794
Illinois,Tazewell County,13,8968,4319,4649
Illinois,Tazewell County,14,7681,3663,4018
Illinois,Tazewell County,15,6109,2809,3300
Illinois,Tazewell County,16,4314,1920,2394
Illinois,Tazewell County,17,3136,1316,1820
Illinois,Tazewell County,18,3591,1244,2347
Illinois,Union County,0,16841,8439,8402
Illinois,Union County,1,899,436,463
Illinois,Union County,2,890,465,425
Illinois,Union County,3,1082,551,531
Illinois,Union County,4,1003,515,488
Illinois,Union County,5,791,423,368
Illinois,Union County,6,1050,553,497
Illinois,Union County,7,933,490,443
Illinois,Union County,8,974,514,460
Illinois,Union County,9,972,477,495
Illinois,Union County,10,1060,535,525
Illinois,Union County,11,1114,553,561
Illinois,Union County,12,1239,633,606
Illinois,Union County,13,1237,610,627
Illinois,Union County,14,1104,569,535
Illinois,Union County,15,884,406,478
Illinois,Union County,16,683,317,366
Illinois,Union County,17,496,236,260
Illinois,Union County,18,430,156,274
Illinois,Vermilion County,0,76806,38221,38585
Illinois,Vermilion County,1,4949,2526,2423
Illinois,Vermilion County,2,5013,2539,2474
Illinois,Vermilion County,3,5149,2694,2455
Illinois,Vermilion County,4,4663,2428,2235
Illinois,Vermilion County,5,4301,2252,2049
Illinois,Vermilion County,6,4761,2460,2301
Illinois,Vermilion County,7,4434,2305,2129
Illinois,Vermilion County,8,4490,2293,2197
Illinois,Vermilion County,9,4312,2258,2054
Illinois,Vermilion County,10,4435,2273,2162
Illinois,Vermilion County,11,4713,2259,2454
Illinois,Vermilion County,12,5431,2720,2711
Illinois,Vermilion County,13,5299,2568,2731
Illinois,Vermilion County,14,4627,2154,2473
Illinois,Vermilion County,15,3644,1726,1918
Illinois,Vermilion County,16,2814,1277,1537
Illinois,Vermilion County,17,1838,780,1058
Illinois,Vermilion County,18,1933,709,1224
Illinois,Wabash County,0,11549,5824,5725
Illinois,Wabash County,1,729,406,323
Illinois,Wabash County,2,721,374,347
Illinois,Wabash County,3,716,378,338
Illinois,Wabash County,4,679,372,307
Illinois,Wabash County,5,570,299,271
Illinois,Wabash County,6,761,398,363
Illinois,Wabash County,7,656,334,322
Illinois,Wabash County,8,681,370,311
Illinois,Wabash County,9,612,318,294
Illinois,Wabash County,10,637,288,349
Illinois,Wabash County,11,648,338,310
Illinois,Wabash County,12,866,425,441
Illinois,Wabash County,13,886,423,463
Illinois,Wabash County,14,767,400,367
Illinois,Wabash County,15,543,260,283
Illinois,Wabash County,16,412,202,210
Illinois,Wabash County,17,290,111,179
Illinois,Wabash County,18,375,128,247
Illinois,Warren County,0,17032,8397,8635
Illinois,Warren County,1,1037,539,498
Illinois,Warren County,2,1010,542,468
Illinois,Warren County,3,1030,505,525
Illinois,Warren County,4,1397,691,706
Illinois,Warren County,5,1344,682,662
Illinois,Warren County,6,849,428,421
Illinois,Warren County,7,914,460,454
Illinois,Warren County,8,987,508,479
Illinois,Warren County,9,890,455,435
Illinois,Warren County,10,945,465,480
Illinois,Warren County,11,962,490,472
Illinois,Warren County,12,1154,554,600
Illinois,Warren County,13,1186,589,597
Illinois,Warren County,14,1029,500,529
Illinois,Warren County,15,796,378,418
Illinois,Warren County,16,611,274,337
Illinois,Warren County,17,464,210,254
Illinois,Warren County,18,427,127,300
Illinois,Washington County,0,13995,6988,7007
Illinois,Washington County,1,799,391,408
Illinois,Washington County,2,778,379,399
Illinois,Washington County,3,879,455,424
Illinois,Washington County,4,806,402,404
Illinois,Washington County,5,666,331,335
Illinois,Washington County,6,837,422,415
Illinois,Washington County,7,786,397,389
Illinois,Washington County,8,848,429,419
Illinois,Washington County,9,796,419,377
Illinois,Washington County,10,862,427,435
Illinois,Washington County,11,931,477,454
Illinois,Washington County,12,1133,561,572
Illinois,Washington County,13,1059,566,493
Illinois,Washington County,14,835,439,396
Illinois,Washington County,15,666,328,338
Illinois,Washington County,16,520,224,296
Illinois,Washington County,17,377,172,205
Illinois,Washington County,18,417,169,248
Illinois,Wayne County,0,16332,8036,8296
Illinois,Wayne County,1,1047,513,534
Illinois,Wayne County,2,1006,503,503
Illinois,Wayne County,3,1033,532,501
Illinois,Wayne County,4,950,475,475
Illinois,Wayne County,5,780,397,383
Illinois,Wayne County,6,924,484,440
Illinois,Wayne County,7,882,463,419
Illinois,Wayne County,8,991,456,535
Illinois,Wayne County,9,872,435,437
Illinois,Wayne County,10,945,469,476
Illinois,Wayne County,11,1032,512,520
Illinois,Wayne County,12,1189,608,581
Illinois,Wayne County,13,1164,592,572
Illinois,Wayne County,14,1027,495,532
Illinois,Wayne County,15,840,399,441
Illinois,Wayne County,16,692,314,378
Illinois,Wayne County,17,506,231,275
Illinois,Wayne County,18,452,158,294
Illinois,White County,0,13665,6732,6933
Illinois,White County,1,785,419,366
Illinois,White County,2,870,426,444
Illinois,White County,3,854,433,421
Illinois,White County,4,713,370,343
Illinois,White County,5,637,335,302
Illinois,White County,6,725,368,357
Illinois,White County,7,819,416,403
Illinois,White County,8,808,406,402
Illinois,White County,9,742,360,382
Illinois,White County,10,775,387,388
Illinois,White County,11,867,448,419
Illinois,White County,12,1098,543,555
Illinois,White County,13,1019,504,515
Illinois,White County,14,813,386,427
Illinois,White County,15,694,325,369
Illinois,White County,16,564,263,301
Illinois,White County,17,430,179,251
Illinois,White County,18,452,164,288
Illinois,Whiteside County,0,55626,27568,28058
Illinois,Whiteside County,1,3096,1596,1500
Illinois,Whiteside County,2,3360,1760,1600
Illinois,Whiteside County,3,3556,1833,1723
Illinois,Whiteside County,4,3436,1805,1631
Illinois,Whiteside County,5,3013,1531,1482
Illinois,Whiteside County,6,3205,1671,1534
Illinois,Whiteside County,7,2933,1432,1501
Illinois,Whiteside County,8,3060,1562,1498
Illinois,Whiteside County,9,3019,1507,1512
Illinois,Whiteside County,10,3525,1790,1735
Illinois,Whiteside County,11,3565,1771,1794
Illinois,Whiteside County,12,4093,2015,2078
Illinois,Whiteside County,13,4165,2055,2110
Illinois,Whiteside County,14,3582,1745,1837
Illinois,Whiteside County,15,2803,1324,1479
Illinois,Whiteside County,16,2059,943,1116
Illinois,Whiteside County,17,1440,645,795
Illinois,Whiteside County,18,1716,583,1133
Illinois,Will County,0,692310,343551,348759
Illinois,Will County,1,40589,20567,20022
Illinois,Will County,2,45577,23379,22198
Illinois,Will County,3,52705,26866,25839
Illinois,Will County,4,52051,26973,25078
Illinois,Will County,5,44514,22990,21524
Illinois,Will County,6,41568,21254,20314
Illinois,Will County,7,40688,20500,20188
Illinois,Will County,8,46426,22890,23536
Illinois,Will County,9,47132,23222,23910
Illinois,Will County,10,52620,26029,26591
Illinois,Will County,11,50810,25395,25415
Illinois,Will County,12,47770,23680,24090
Illinois,Will County,13,39454,19469,19985
Illinois,Will County,14,30930,14588,16342
Illinois,Will County,15,23800,11158,12642
Illinois,Will County,16,16105,7185,8920
Illinois,Will County,17,9762,4055,5707
Illinois,Will County,18,9809,3351,6458
Illinois,Williamson County,0,67056,33319,33737
Illinois,Williamson County,1,3970,2046,1924
Illinois,Williamson County,2,4024,2081,1943
Illinois,Williamson County,3,4193,2185,2008
Illinois,Williamson County,4,3679,1859,1820
Illinois,Williamson County,5,3389,1754,1635
Illinois,Williamson County,6,4433,2262,2171
Illinois,Williamson County,7,4376,2266,2110
Illinois,Williamson County,8,4561,2324,2237
Illinois,Williamson County,9,4100,2170,1930
Illinois,Williamson County,10,4298,2172,2126
Illinois,Williamson County,11,4175,2089,2086
Illinois,Williamson County,12,4711,2296,2415
Illinois,Williamson County,13,4434,2177,2257
Illinois,Williamson County,14,3843,1828,2015
Illinois,Williamson County,15,3439,1579,1860
Illinois,Williamson County,16,2452,1085,1367
Illinois,Williamson County,17,1571,647,924
Illinois,Williamson County,18,1408,499,909
Illinois,Winnebago County,0,284081,138635,145446
Illinois,Winnebago County,1,18087,9250,8837
Illinois,Winnebago County,2,18092,9243,8849
Illinois,Winnebago County,3,18784,9621,9163
Illinois,Winnebago County,4,18112,9260,8852
Illinois,Winnebago County,5,16961,8410,8551
Illinois,Winnebago County,6,18628,9226,9402
Illinois,Winnebago County,7,17144,8493,8651
Illinois,Winnebago County,8,17219,8355,8864
Illinois,Winnebago County,9,16062,7877,8185
Illinois,Winnebago County,10,17999,8920,9079
Illinois,Winnebago County,11,18314,9008,9306
Illinois,Winnebago County,12,20080,9840,10240
Illinois,Winnebago County,13,18780,9057,9723
Illinois,Winnebago County,14,15938,7589,8349
Illinois,Winnebago County,15,12637,5873,6764
Illinois,Winnebago County,16,8802,3899,4903
Illinois,Winnebago County,17,5949,2512,3437
Illinois,Winnebago County,18,6493,2202,4291
Illinois,Woodford County,0,38463,19189,19274
Illinois,Woodford County,1,2209,1165,1044
Illinois,Woodford County,2,2598,1370,1228
Illinois,Woodford County,3,2740,1433,1307
Illinois,Woodford County,4,2697,1397,1300
Illinois,Woodford County,5,2207,1119,1088
Illinois,Woodford County,6,2027,1036,991
Illinois,Woodford County,7,2038,1007,1031
Illinois,Woodford County,8,2495,1240,1255
Illinois,Woodford County,9,2249,1139,1110
Illinois,Woodford County,10,2268,1114,1154
Illinois,Woodford County,11,2503,1271,1232
Illinois,Woodford County,12,2789,1394,1395
Illinois,Woodford County,13,2683,1344,1339
Illinois,Woodford County,14,2237,1129,1108
Illinois,Woodford County,15,1553,759,794
Illinois,Woodford County,16,1178,523,655
Illinois,Woodford County,17,852,367,485
Illinois,Woodford County,18,1140,382,758
Indiana,Adams County,0,35636,17804,17832
Indiana,Adams County,1,3327,1718,1609
Indiana,Adams County,2,3153,1690,1463
Indiana,Adams County,3,2943,1499,1444
Indiana,Adams County,4,2614,1318,1296
Indiana,Adams County,5,2126,1115,1011
Indiana,Adams County,6,2261,1197,1064
Indiana,Adams County,7,1885,945,940
Indiana,Adams County,8,1940,980,960
Indiana,Adams County,9,1879,987,892
Indiana,Adams County,10,1882,931,951
Indiana,Adams County,11,1974,977,997
Indiana,Adams County,12,2061,1020,1041
Indiana,Adams County,13,2067,993,1074
Indiana,Adams County,14,1635,790,845
Indiana,Adams County,15,1342,627,715
Indiana,Adams County,16,929,416,513
Indiana,Adams County,17,714,290,424
Indiana,Adams County,18,904,311,593
Indiana,Allen County,0,375351,183463,191888
Indiana,Allen County,1,26135,13549,12586
Indiana,Allen County,2,26597,13654,12943
Indiana,Allen County,3,27232,13793,13439
Indiana,Allen County,4,25806,13060,12746
Indiana,Allen County,5,24399,12254,12145
Indiana,Allen County,6,27523,13553,13970
Indiana,Allen County,7,24583,12078,12505
Indiana,Allen County,8,24289,11849,12440
Indiana,Allen County,9,22021,10921,11100
Indiana,Allen County,10,23290,11468,11822
Indiana,Allen County,11,22321,10975,11346
Indiana,Allen County,12,23865,11650,12215
Indiana,Allen County,13,22572,10728,11844
Indiana,Allen County,14,18553,8767,9786
Indiana,Allen County,15,13910,6302,7608
Indiana,Allen County,16,9214,4108,5106
Indiana,Allen County,17,6033,2475,3558
Indiana,Allen County,18,7008,2279,4729
Indiana,Bartholomew County,0,82753,41627,41126
Indiana,Bartholomew County,1,5448,2866,2582
Indiana,Bartholomew County,2,5489,2762,2727
Indiana,Bartholomew County,3,5534,2780,2754
Indiana,Bartholomew County,4,4931,2473,2458
Indiana,Bartholomew County,5,4976,2690,2286
Indiana,Bartholomew County,6,6495,3474,3021
Indiana,Bartholomew County,7,5496,2951,2545
Indiana,Bartholomew County,8,5247,2772,2475
Indiana,Bartholomew County,9,5014,2536,2478
Indiana,Bartholomew County,10,5310,2704,2606
Indiana,Bartholomew County,11,5097,2626,2471
Indiana,Bartholomew County,12,5260,2560,2700
Indiana,Bartholomew County,13,4969,2421,2548
Indiana,Bartholomew County,14,4340,2076,2264
Indiana,Bartholomew County,15,3423,1579,1844
Indiana,Bartholomew County,16,2530,1129,1401
Indiana,Bartholomew County,17,1568,669,899
Indiana,Bartholomew County,18,1626,559,1067
Indiana,Benton County,0,8653,4296,4357
Indiana,Benton County,1,555,284,271
Indiana,Benton County,2,542,324,218
Indiana,Benton County,3,660,310,350
Indiana,Benton County,4,584,306,278
Indiana,Benton County,5,450,244,206
Indiana,Benton County,6,509,262,247
Indiana,Benton County,7,442,223,219
Indiana,Benton County,8,514,258,256
Indiana,Benton County,9,531,266,265
Indiana,Benton County,10,512,242,270
Indiana,Benton County,11,587,304,283
Indiana,Benton County,12,635,301,334
Indiana,Benton County,13,589,289,300
Indiana,Benton County,14,472,243,229
Indiana,Benton County,15,376,165,211
Indiana,Benton County,16,325,150,175
Indiana,Benton County,17,164,63,101
Indiana,Benton County,18,206,62,144
Indiana,Blackford County,0,11930,5889,6041
Indiana,Blackford County,1,659,342,317
Indiana,Blackford County,2,723,349,374
Indiana,Blackford County,3,752,398,354
Indiana,Blackford County,4,713,400,313
Indiana,Blackford County,5,657,351,306
Indiana,Blackford County,6,681,338,343
Indiana,Blackford County,7,641,310,331
Indiana,Blackford County,8,639,315,324
Indiana,Blackford County,9,593,298,295
Indiana,Blackford County,10,802,410,392
Indiana,Blackford County,11,752,361,391
Indiana,Blackford County,12,905,473,432
Indiana,Blackford County,13,833,413,420
Indiana,Blackford County,14,791,372,419
Indiana,Blackford County,15,636,304,332
Indiana,Blackford County,16,505,220,285
Indiana,Blackford County,17,347,138,209
Indiana,Blackford County,18,301,97,204
Indiana,Boone County,0,66999,33331,33668
Indiana,Boone County,1,4531,2407,2124
Indiana,Boone County,2,4957,2537,2420
Indiana,Boone County,3,5249,2750,2499
Indiana,Boone County,4,4499,2369,2130
Indiana,Boone County,5,3696,1875,1821
Indiana,Boone County,6,3871,1985,1886
Indiana,Boone County,7,4120,2049,2071
Indiana,Boone County,8,4666,2285,2381
Indiana,Boone County,9,4595,2249,2346
Indiana,Boone County,10,4724,2338,2386
Indiana,Boone County,11,4543,2268,2275
Indiana,Boone County,12,4615,2212,2403
Indiana,Boone County,13,3979,2007,1972
Indiana,Boone County,14,3004,1438,1566
Indiana,Boone County,15,2323,1097,1226
Indiana,Boone County,16,1585,693,892
Indiana,Boone County,17,1085,446,639
Indiana,Boone County,18,957,326,631
Indiana,Brown County,0,15234,7507,7727
Indiana,Brown County,1,579,295,284
Indiana,Brown County,2,728,356,372
Indiana,Brown County,3,844,408,436
Indiana,Brown County,4,866,450,416
Indiana,Brown County,5,690,341,349
Indiana,Brown County,6,710,341,369
Indiana,Brown County,7,716,352,364
Indiana,Brown County,8,779,398,381
Indiana,Brown County,9,789,417,372
Indiana,Brown County,10,1010,516,494
Indiana,Brown County,11,1152,541,611
Indiana,Brown County,12,1285,641,644
Indiana,Brown County,13,1418,682,736
Indiana,Brown County,14,1273,635,638
Indiana,Brown County,15,1054,519,535
Indiana,Brown County,16,659,331,328
Indiana,Brown County,17,363,164,199
Indiana,Brown County,18,319,120,199
Indiana,Carroll County,0,20127,10117,10010
Indiana,Carroll County,1,1086,586,500
Indiana,Carroll County,2,1210,608,602
Indiana,Carroll County,3,1348,668,680
Indiana,Carroll County,4,1270,670,600
Indiana,Carroll County,5,1049,543,506
Indiana,Carroll County,6,1161,601,560
Indiana,Carroll County,7,1045,544,501
Indiana,Carroll County,8,1151,570,581
Indiana,Carroll County,9,1184,589,595
Indiana,Carroll County,10,1344,729,615
Indiana,Carroll County,11,1290,651,639
Indiana,Carroll County,12,1574,780,794
Indiana,Carroll County,13,1466,765,701
Indiana,Carroll County,14,1255,616,639
Indiana,Carroll County,15,1053,491,562
Indiana,Carroll County,16,723,335,388
Indiana,Carroll County,17,473,220,253
Indiana,Carroll County,18,445,151,294
Indiana,Cass County,0,37955,18958,18997
Indiana,Cass County,1,2380,1213,1167
Indiana,Cass County,2,2370,1188,1182
Indiana,Cass County,3,2380,1201,1179
Indiana,Cass County,4,2510,1380,1130
Indiana,Cass County,5,2232,1169,1063
Indiana,Cass County,6,2277,1219,1058
Indiana,Cass County,7,2062,1031,1031
Indiana,Cass County,8,2361,1169,1192
Indiana,Cass County,9,2316,1191,1125
Indiana,Cass County,10,2491,1276,1215
Indiana,Cass County,11,2512,1307,1205
Indiana,Cass County,12,2687,1361,1326
Indiana,Cass County,13,2624,1326,1298
Indiana,Cass County,14,2132,1007,1125
Indiana,Cass County,15,1617,753,864
Indiana,Cass County,16,1229,506,723
Indiana,Cass County,17,865,352,513
Indiana,Cass County,18,910,309,601
Indiana,Clark County,0,117360,57274,60086
Indiana,Clark County,1,7221,3730,3491
Indiana,Clark County,2,7337,3719,3618
Indiana,Clark County,3,7416,3759,3657
Indiana,Clark County,4,6786,3510,3276
Indiana,Clark County,5,6646,3390,3256
Indiana,Clark County,6,8346,4118,4228
Indiana,Clark County,7,7895,3940,3955
Indiana,Clark County,8,8190,4118,4072
Indiana,Clark County,9,7454,3738,3716
Indiana,Clark County,10,8119,4064,4055
Indiana,Clark County,11,7629,3728,3901
Indiana,Clark County,12,8189,3953,4236
Indiana,Clark County,13,7608,3597,4011
Indiana,Clark County,14,6320,2851,3469
Indiana,Clark County,15,5008,2267,2741
Indiana,Clark County,16,3173,1363,1810
Indiana,Clark County,17,2101,843,1258
Indiana,Clark County,18,1922,586,1336
Indiana,Clay County,0,26170,12930,13240
Indiana,Clay County,1,1624,784,840
Indiana,Clay County,2,1617,851,766
Indiana,Clay County,3,1708,880,828
Indiana,Clay County,4,1603,810,793
Indiana,Clay County,5,1419,722,697
Indiana,Clay County,6,1620,820,800
Indiana,Clay County,7,1568,788,780
Indiana,Clay County,8,1576,781,795
Indiana,Clay County,9,1575,794,781
Indiana,Clay County,10,1688,838,850
Indiana,Clay County,11,1670,840,830
Indiana,Clay County,12,1947,990,957
Indiana,Clay County,13,1880,915,965
Indiana,Clay County,14,1568,763,805
Indiana,Clay County,15,1123,542,581
Indiana,Clay County,16,824,369,455
Indiana,Clay County,17,590,232,358
Indiana,Clay County,18,570,211,359
Indiana,Clinton County,0,32250,16035,16215
Indiana,Clinton County,1,2270,1175,1095
Indiana,Clinton County,2,2228,1134,1094
Indiana,Clinton County,3,2459,1278,1181
Indiana,Clinton County,4,2237,1159,1078
Indiana,Clinton County,5,1798,908,890
Indiana,Clinton County,6,2028,1034,994
Indiana,Clinton County,7,1941,1006,935
Indiana,Clinton County,8,1899,956,943
Indiana,Clinton County,9,1852,923,929
Indiana,Clinton County,10,1967,1048,919
Indiana,Clinton County,11,1932,971,961
Indiana,Clinton County,12,2233,1072,1161
Indiana,Clinton County,13,2027,1005,1022
Indiana,Clinton County,14,1686,820,866
Indiana,Clinton County,15,1237,589,648
Indiana,Clinton County,16,917,392,525
Indiana,Clinton County,17,689,293,396
Indiana,Clinton County,18,850,272,578
Indiana,Crawford County,0,10558,5371,5187
Indiana,Crawford County,1,564,275,289
Indiana,Crawford County,2,600,299,301
Indiana,Crawford County,3,712,365,347
Indiana,Crawford County,4,614,322,292
Indiana,Crawford County,5,527,268,259
Indiana,Crawford County,6,617,325,292
Indiana,Crawford County,7,521,261,260
Indiana,Crawford County,8,576,312,264
Indiana,Crawford County,9,619,302,317
Indiana,Crawford County,10,650,330,320
Indiana,Crawford County,11,780,394,386
Indiana,Crawford County,12,887,460,427
Indiana,Crawford County,13,830,416,414
Indiana,Crawford County,14,714,384,330
Indiana,Crawford County,15,569,299,270
Indiana,Crawford County,16,386,196,190
Indiana,Crawford County,17,222,105,117
Indiana,Crawford County,18,170,58,112
Indiana,Daviess County,0,33147,16701,16446
Indiana,Daviess County,1,2693,1384,1309
Indiana,Daviess County,2,2715,1432,1283
Indiana,Daviess County,3,2729,1365,1364
Indiana,Daviess County,4,2357,1224,1133
Indiana,Daviess County,5,1972,1034,938
Indiana,Daviess County,6,2233,1168,1065
Indiana,Daviess County,7,1953,1033,920
Indiana,Daviess County,8,1974,1041,933
Indiana,Daviess County,9,1768,884,884
Indiana,Daviess County,10,1765,908,857
Indiana,Daviess County,11,1858,933,925
Indiana,Daviess County,12,2104,1071,1033
Indiana,Daviess County,13,1946,956,990
Indiana,Daviess County,14,1643,808,835
Indiana,Daviess County,15,1252,593,659
Indiana,Daviess County,16,925,414,511
Indiana,Daviess County,17,630,258,372
Indiana,Daviess County,18,630,195,435
Indiana,Dearborn County,0,49568,24649,24919
Indiana,Dearborn County,1,2618,1316,1302
Indiana,Dearborn County,2,2947,1528,1419
Indiana,Dearborn County,3,3376,1714,1662
Indiana,Dearborn County,4,3284,1663,1621
Indiana,Dearborn County,5,2675,1363,1312
Indiana,Dearborn County,6,2837,1453,1384
Indiana,Dearborn County,7,2672,1375,1297
Indiana,Dearborn County,8,2909,1453,1456
Indiana,Dearborn County,9,3013,1532,1481
Indiana,Dearborn County,10,3388,1697,1691
Indiana,Dearborn County,11,3634,1796,1838
Indiana,Dearborn County,12,3953,1943,2010
Indiana,Dearborn County,13,3483,1716,1767
Indiana,Dearborn County,14,3100,1532,1568
Indiana,Dearborn County,15,2230,1083,1147
Indiana,Dearborn County,16,1556,736,820
Indiana,Dearborn County,17,1003,439,564
Indiana,Dearborn County,18,890,310,580
Indiana,Decatur County,0,26794,13306,13488
Indiana,Decatur County,1,1785,927,858
Indiana,Decatur County,2,1757,896,861
Indiana,Decatur County,3,1833,924,909
Indiana,Decatur County,4,1773,921,852
Indiana,Decatur County,5,1542,794,748
Indiana,Decatur County,6,1747,898,849
Indiana,Decatur County,7,1549,777,772
Indiana,Decatur County,8,1592,783,809
Indiana,Decatur County,9,1591,787,804
Indiana,Decatur County,10,1639,853,786
Indiana,Decatur County,11,1789,892,897
Indiana,Decatur County,12,1937,985,952
Indiana,Decatur County,13,1775,873,902
Indiana,Decatur County,14,1455,714,741
Indiana,Decatur County,15,1120,521,599
Indiana,Decatur County,16,786,332,454
Indiana,Decatur County,17,558,234,324
Indiana,Decatur County,18,566,195,371
Indiana,DeKalb County,0,43226,21453,21773
Indiana,DeKalb County,1,2803,1406,1397
Indiana,DeKalb County,2,2763,1390,1373
Indiana,DeKalb County,3,3032,1520,1512
Indiana,DeKalb County,4,2836,1491,1345
Indiana,DeKalb County,5,2620,1331,1289
Indiana,DeKalb County,6,2899,1483,1416
Indiana,DeKalb County,7,2542,1275,1267
Indiana,DeKalb County,8,2563,1271,1292
Indiana,DeKalb County,9,2602,1335,1267
Indiana,DeKalb County,10,2722,1372,1350
Indiana,DeKalb County,11,2902,1493,1409
Indiana,DeKalb County,12,3104,1566,1538
Indiana,DeKalb County,13,2819,1395,1424
Indiana,DeKalb County,14,2364,1150,1214
Indiana,DeKalb County,15,1798,833,965
Indiana,DeKalb County,16,1232,536,696
Indiana,DeKalb County,17,807,342,465
Indiana,DeKalb County,18,818,264,554
Indiana,Delaware County,0,114772,55383,59389
Indiana,Delaware County,1,5680,2859,2821
Indiana,Delaware County,2,5735,2960,2775
Indiana,Delaware County,3,5822,2962,2860
Indiana,Delaware County,4,10270,4895,5375
Indiana,Delaware County,5,16022,7791,8231
Indiana,Delaware County,6,7371,3757,3614
Indiana,Delaware County,7,5802,2958,2844
Indiana,Delaware County,8,5861,2863,2998
Indiana,Delaware County,9,5644,2747,2897
Indiana,Delaware County,10,6436,3182,3254
Indiana,Delaware County,11,6665,3261,3404
Indiana,Delaware County,12,7038,3420,3618
Indiana,Delaware County,13,6754,3216,3538
Indiana,Delaware County,14,5882,2677,3205
Indiana,Delaware County,15,5023,2234,2789
Indiana,Delaware County,16,3618,1603,2015
Indiana,Delaware County,17,2494,1063,1431
Indiana,Delaware County,18,2655,935,1720
Indiana,Dubois County,0,42565,21273,21292
Indiana,Dubois County,1,2848,1473,1375
Indiana,Dubois County,2,2678,1344,1334
Indiana,Dubois County,3,2919,1544,1375
Indiana,Dubois County,4,2782,1430,1352
Indiana,Dubois County,5,2478,1228,1250
Indiana,Dubois County,6,2356,1199,1157
Indiana,Dubois County,7,2392,1269,1123
Indiana,Dubois County,8,2509,1298,1211
Indiana,Dubois County,9,2429,1277,1152
Indiana,Dubois County,10,2540,1299,1241
Indiana,Dubois County,11,2932,1514,1418
Indiana,Dubois County,12,3304,1649,1655
Indiana,Dubois County,13,2968,1493,1475
Indiana,Dubois County,14,2403,1197,1206
Indiana,Dubois County,15,1720,791,929
Indiana,Dubois County,16,1329,560,769
Indiana,Dubois County,17,949,385,564
Indiana,Dubois County,18,1029,323,706
Indiana,Elkhart County,0,205560,101597,103963
Indiana,Elkhart County,1,15441,7849,7592
Indiana,Elkhart County,2,15293,7789,7504
Indiana,Elkhart County,3,16421,8295,8126
Indiana,Elkhart County,4,14674,7591,7083
Indiana,Elkhart County,5,13023,6663,6360
Indiana,Elkhart County,6,13787,6984,6803
Indiana,Elkhart County,7,12482,6321,6161
Indiana,Elkhart County,8,12754,6387,6367
Indiana,Elkhart County,9,12096,5974,6122
Indiana,Elkhart County,10,12664,6325,6339
Indiana,Elkhart County,11,12436,6227,6209
Indiana,Elkhart County,12,12630,6296,6334
Indiana,Elkhart County,13,11577,5589,5988
Indiana,Elkhart County,14,9869,4658,5211
Indiana,Elkhart County,15,7398,3417,3981
Indiana,Elkhart County,16,5333,2392,2941
Indiana,Elkhart County,17,3641,1527,2114
Indiana,Elkhart County,18,4041,1313,2728
Indiana,Fayette County,0,23047,11381,11666
Indiana,Fayette County,1,1180,608,572
Indiana,Fayette County,2,1319,697,622
Indiana,Fayette County,3,1514,756,758
Indiana,Fayette County,4,1473,769,704
Indiana,Fayette County,5,1215,620,595
Indiana,Fayette County,6,1391,710,681
Indiana,Fayette County,7,1157,553,604
Indiana,Fayette County,8,1303,630,673
Indiana,Fayette County,9,1529,761,768
Indiana,Fayette County,10,1480,778,702
Indiana,Fayette County,11,1581,817,764
Indiana,Fayette County,12,1572,758,814
Indiana,Fayette County,13,1633,768,865
Indiana,Fayette County,14,1545,760,785
Indiana,Fayette County,15,1174,535,639
Indiana,Fayette County,16,828,376,452
Indiana,Fayette County,17,551,251,300
Indiana,Fayette County,18,602,234,368
Indiana,Floyd County,0,77781,37782,39999
Indiana,Floyd County,1,4646,2392,2254
Indiana,Floyd County,2,4767,2458,2309
Indiana,Floyd County,3,5078,2527,2551
Indiana,Floyd County,4,4880,2531,2349
Indiana,Floyd County,5,4683,2309,2374
Indiana,Floyd County,6,5188,2593,2595
Indiana,Floyd County,7,4762,2297,2465
Indiana,Floyd County,8,5069,2461,2608
Indiana,Floyd County,9,4630,2283,2347
Indiana,Floyd County,10,5237,2568,2669
Indiana,Floyd County,11,5173,2535,2638
Indiana,Floyd County,12,5876,2832,3044
Indiana,Floyd County,13,5243,2546,2697
Indiana,Floyd County,14,4458,2070,2388
Indiana,Floyd County,15,3135,1409,1726
Indiana,Floyd County,16,2202,981,1221
Indiana,Floyd County,17,1335,536,799
Indiana,Floyd County,18,1419,454,965
Indiana,Fountain County,0,16351,8162,8189
Indiana,Fountain County,1,896,502,394
Indiana,Fountain County,2,1000,540,460
Indiana,Fountain County,3,1016,528,488
Indiana,Fountain County,4,1024,547,477
Indiana,Fountain County,5,919,488,431
Indiana,Fountain County,6,967,479,488
Indiana,Fountain County,7,857,445,412
Indiana,Fountain County,8,943,471,472
Indiana,Fountain County,9,888,425,463
Indiana,Fountain County,10,1076,529,547
Indiana,Fountain County,11,1114,558,556
Indiana,Fountain County,12,1253,633,620
Indiana,Fountain County,13,1116,543,573
Indiana,Fountain County,14,955,487,468
Indiana,Fountain County,15,842,385,457
Indiana,Fountain County,16,613,273,340
Indiana,Fountain County,17,441,191,250
Indiana,Fountain County,18,431,138,293
Indiana,Franklin County,0,22736,11357,11379
Indiana,Franklin County,1,1344,677,667
Indiana,Franklin County,2,1322,661,661
Indiana,Franklin County,3,1563,796,767
Indiana,Franklin County,4,1532,826,706
Indiana,Franklin County,5,1254,639,615
Indiana,Franklin County,6,1204,631,573
Indiana,Franklin County,7,1181,581,600
Indiana,Franklin County,8,1314,654,660
Indiana,Franklin County,9,1345,655,690
Indiana,Franklin County,10,1507,786,721
Indiana,Franklin County,11,1625,814,811
Indiana,Franklin County,12,1721,891,830
Indiana,Franklin County,13,1637,821,816
Indiana,Franklin County,14,1449,730,719
Indiana,Franklin County,15,1011,487,524
Indiana,Franklin County,16,759,367,392
Indiana,Franklin County,17,494,191,303
Indiana,Franklin County,18,474,150,324
Indiana,Fulton County,0,20092,10048,10044
Indiana,Fulton County,1,1238,663,575
Indiana,Fulton County,2,1247,615,632
Indiana,Fulton County,3,1426,734,692
Indiana,Fulton County,4,1247,643,604
Indiana,Fulton County,5,1106,593,513
Indiana,Fulton County,6,1161,577,584
Indiana,Fulton County,7,1090,571,519
Indiana,Fulton County,8,1183,605,578
Indiana,Fulton County,9,1166,572,594
Indiana,Fulton County,10,1236,637,599
Indiana,Fulton County,11,1198,607,591
Indiana,Fulton County,12,1478,727,751
Indiana,Fulton County,13,1396,710,686
Indiana,Fulton County,14,1252,622,630
Indiana,Fulton County,15,984,476,508
Indiana,Fulton County,16,734,332,402
Indiana,Fulton County,17,501,206,295
Indiana,Fulton County,18,449,158,291
Indiana,Gibson County,0,33452,16739,16713
Indiana,Gibson County,1,2099,1090,1009
Indiana,Gibson County,2,2192,1145,1047
Indiana,Gibson County,3,2258,1162,1096
Indiana,Gibson County,4,2038,1078,960
Indiana,Gibson County,5,1913,976,937
Indiana,Gibson County,6,2074,1030,1044
Indiana,Gibson County,7,1923,957,966
Indiana,Gibson County,8,2088,1095,993
Indiana,Gibson County,9,1893,957,936
Indiana,Gibson County,10,2135,1099,1036
Indiana,Gibson County,11,2209,1120,1089
Indiana,Gibson County,12,2457,1256,1201
Indiana,Gibson County,13,2297,1126,1171
Indiana,Gibson County,14,1872,917,955
Indiana,Gibson County,15,1423,664,759
Indiana,Gibson County,16,1053,476,577
Indiana,Gibson County,17,709,316,393
Indiana,Gibson County,18,819,275,544
Indiana,Grant County,0,65936,31558,34378
Indiana,Grant County,1,3542,1785,1757
Indiana,Grant County,2,3741,1920,1821
Indiana,Grant County,3,3940,2002,1938
Indiana,Grant County,4,5023,2407,2616
Indiana,Grant County,5,5771,2775,2996
Indiana,Grant County,6,3945,1936,2009
Indiana,Grant County,7,3264,1518,1746
Indiana,Grant County,8,3416,1639,1777
Indiana,Grant County,9,3459,1723,1736
Indiana,Grant County,10,3880,1911,1969
Indiana,Grant County,11,4058,1990,2068
Indiana,Grant County,12,4650,2234,2416
Indiana,Grant County,13,4573,2189,2384
Indiana,Grant County,14,3857,1833,2024
Indiana,Grant County,15,3126,1448,1678
Indiana,Grant County,16,2402,1022,1380
Indiana,Grant County,17,1683,705,978
Indiana,Grant County,18,1606,521,1085
Indiana,Greene County,0,32006,16020,15986
Indiana,Greene County,1,1659,845,814
Indiana,Greene County,2,1888,933,955
Indiana,Greene County,3,2083,1053,1030
Indiana,Greene County,4,2038,1106,932
Indiana,Greene County,5,1650,869,781
Indiana,Greene County,6,1842,941,901
Indiana,Greene County,7,1696,839,857
Indiana,Greene County,8,1829,925,904
Indiana,Greene County,9,1848,950,898
Indiana,Greene County,10,2145,1067,1078
Indiana,Greene County,11,2340,1207,1133
Indiana,Greene County,12,2437,1246,1191
Indiana,Greene County,13,2303,1159,1144
Indiana,Greene County,14,1970,968,1002
Indiana,Greene County,15,1597,759,838
Indiana,Greene County,16,1198,553,645
Indiana,Greene County,17,738,317,421
Indiana,Greene County,18,745,283,462
Indiana,Hamilton County,0,330086,161345,168741
Indiana,Hamilton County,1,21690,10998,10692
Indiana,Hamilton County,2,24787,12744,12043
Indiana,Hamilton County,3,26733,13576,13157
Indiana,Hamilton County,4,23557,12104,11453
Indiana,Hamilton County,5,17691,8914,8777
Indiana,Hamilton County,6,17680,8667,9013
Indiana,Hamilton County,7,21548,10240,11308
Indiana,Hamilton County,8,25340,12210,13130
Indiana,Hamilton County,9,23648,11490,12158
Indiana,Hamilton County,10,25003,12352,12651
Indiana,Hamilton County,11,23053,11356,11697
Indiana,Hamilton County,12,20950,10155,10795
Indiana,Hamilton County,13,17544,8388,9156
Indiana,Hamilton County,14,14421,6735,7686
Indiana,Hamilton County,15,10606,4939,5667
Indiana,Hamilton County,16,6953,3055,3898
Indiana,Hamilton County,17,4317,1812,2505
Indiana,Hamilton County,18,4565,1610,2955
Indiana,Hancock County,0,76351,37563,38788
Indiana,Hancock County,1,4425,2281,2144
Indiana,Hancock County,2,4799,2418,2381
Indiana,Hancock County,3,5365,2761,2604
Indiana,Hancock County,4,4965,2538,2427
Indiana,Hancock County,5,4179,2163,2016
Indiana,Hancock County,6,4329,2178,2151
Indiana,Hancock County,7,4777,2326,2451
Indiana,Hancock County,8,5160,2558,2602
Indiana,Hancock County,9,4764,2386,2378
Indiana,Hancock County,10,5260,2612,2648
Indiana,Hancock County,11,5450,2637,2813
Indiana,Hancock County,12,5648,2728,2920
Indiana,Hancock County,13,4825,2361,2464
Indiana,Hancock County,14,4133,1930,2203
Indiana,Hancock County,15,3334,1560,1774
Indiana,Hancock County,16,2286,1048,1238
Indiana,Hancock County,17,1358,601,757
Indiana,Hancock County,18,1294,477,817
Indiana,Harrison County,0,40350,20163,20187
Indiana,Harrison County,1,2398,1267,1131
Indiana,Harrison County,2,2403,1279,1124
Indiana,Harrison County,3,2696,1361,1335
Indiana,Harrison County,4,2451,1242,1209
Indiana,Harrison County,5,2001,1046,955
Indiana,Harrison County,6,2379,1201,1178
Indiana,Harrison County,7,2314,1142,1172
Indiana,Harrison County,8,2658,1353,1305
Indiana,Harrison County,9,2380,1210,1170
Indiana,Harrison County,10,2637,1325,1312
Indiana,Harrison County,11,2858,1458,1400
Indiana,Harrison County,12,3160,1570,1590
Indiana,Harrison County,13,2873,1403,1470
Indiana,Harrison County,14,2484,1190,1294
Indiana,Harrison County,15,1829,897,932
Indiana,Harrison County,16,1297,624,673
Indiana,Harrison County,17,738,304,434
Indiana,Harrison County,18,794,291,503
Indiana,Hendricks County,0,167009,83558,83451
Indiana,Hendricks County,1,9794,5014,4780
Indiana,Hendricks County,2,11613,5993,5620
Indiana,Hendricks County,3,12760,6605,6155
Indiana,Hendricks County,4,11518,5979,5539
Indiana,Hendricks County,5,9536,5037,4499
Indiana,Hendricks County,6,9886,5209,4677
Indiana,Hendricks County,7,10959,5578,5381
Indiana,Hendricks County,8,12404,6160,6244
Indiana,Hendricks County,9,11668,5921,5747
Indiana,Hendricks County,10,11981,6148,5833
Indiana,Hendricks County,11,11037,5466,5571
Indiana,Hendricks County,12,11062,5524,5538
Indiana,Hendricks County,13,9650,4631,5019
Indiana,Hendricks County,14,7953,3737,4216
Indiana,Hendricks County,15,6021,2809,3212
Indiana,Hendricks County,16,4074,1814,2260
Indiana,Hendricks County,17,2657,1066,1591
Indiana,Hendricks County,18,2436,867,1569
Indiana,Henry County,0,48271,25099,23172
Indiana,Henry County,1,2416,1253,1163
Indiana,Henry County,2,2655,1388,1267
Indiana,Henry County,3,2940,1482,1458
Indiana,Henry County,4,2929,1574,1355
Indiana,Henry County,5,2851,1621,1230
Indiana,Henry County,6,3254,1876,1378
Indiana,Henry County,7,2690,1532,1158
Indiana,Henry County,8,2854,1583,1271
Indiana,Henry County,9,3009,1637,1372
Indiana,Henry County,10,3246,1861,1385
Indiana,Henry County,11,3438,1764,1674
Indiana,Henry County,12,3514,1805,1709
Indiana,Henry County,13,3341,1650,1691
Indiana,Henry County,14,2852,1409,1443
Indiana,Henry County,15,2321,1064,1257
Indiana,Henry County,16,1742,755,987
Indiana,Henry County,17,1129,481,648
Indiana,Henry County,18,1090,364,726
Indiana,Howard County,0,82366,39983,42383
Indiana,Howard County,1,4967,2614,2353
Indiana,Howard County,2,5113,2635,2478
Indiana,Howard County,3,5323,2752,2571
Indiana,Howard County,4,5008,2578,2430
Indiana,Howard County,5,4831,2462,2369
Indiana,Howard County,6,5255,2608,2647
Indiana,Howard County,7,4643,2302,2341
Indiana,Howard County,8,4621,2182,2439
Indiana,Howard County,9,4679,2224,2455
Indiana,Howard County,10,5048,2487,2561
Indiana,Howard County,11,5315,2666,2649
Indiana,Howard County,12,5940,2816,3124
Indiana,Howard County,13,5567,2646,2921
Indiana,Howard County,14,4904,2220,2684
Indiana,Howard County,15,4116,1881,2235
Indiana,Howard County,16,3072,1386,1686
Indiana,Howard County,17,1979,835,1144
Indiana,Howard County,18,1985,689,1296
Indiana,Huntington County,0,36240,17873,18367
Indiana,Huntington County,1,2066,1045,1021
Indiana,Huntington County,2,2134,1085,1049
Indiana,Huntington County,3,2246,1142,1104
Indiana,Huntington County,4,2430,1245,1185
Indiana,Huntington County,5,2476,1251,1225
Indiana,Huntington County,6,2252,1144,1108
Indiana,Huntington County,7,2147,1085,1062
Indiana,Huntington County,8,2119,1104,1015
Indiana,Huntington County,9,2109,1056,1053
Indiana,Huntington County,10,2196,1124,1072
Indiana,Huntington County,11,2377,1174,1203
Indiana,Huntington County,12,2797,1371,1426
Indiana,Huntington County,13,2661,1320,1341
Indiana,Huntington County,14,1960,964,996
Indiana,Huntington County,15,1517,683,834
Indiana,Huntington County,16,1121,484,637
Indiana,Huntington County,17,797,340,457
Indiana,Huntington County,18,835,256,579
Indiana,Jackson County,0,44111,21987,22124
Indiana,Jackson County,1,3029,1552,1477
Indiana,Jackson County,2,2882,1531,1351
Indiana,Jackson County,3,3021,1546,1475
Indiana,Jackson County,4,2839,1471,1368
Indiana,Jackson County,5,2428,1232,1196
Indiana,Jackson County,6,2735,1360,1375
Indiana,Jackson County,7,2636,1363,1273
Indiana,Jackson County,8,2996,1553,1443
Indiana,Jackson County,9,2713,1374,1339
Indiana,Jackson County,10,2905,1529,1376
Indiana,Jackson County,11,2902,1469,1433
Indiana,Jackson County,12,2965,1454,1511
Indiana,Jackson County,13,2842,1362,1480
Indiana,Jackson County,14,2270,1089,1181
Indiana,Jackson County,15,1862,845,1017
Indiana,Jackson County,16,1303,596,707
Indiana,Jackson County,17,924,377,547
Indiana,Jackson County,18,859,284,575
Indiana,Jasper County,0,33370,16601,16769
Indiana,Jasper County,1,1918,990,928
Indiana,Jasper County,2,2066,1054,1012
Indiana,Jasper County,3,2338,1182,1156
Indiana,Jasper County,4,2433,1266,1167
Indiana,Jasper County,5,2180,1132,1048
Indiana,Jasper County,6,1919,962,957
Indiana,Jasper County,7,1711,858,853
Indiana,Jasper County,8,1999,1015,984
Indiana,Jasper County,9,2057,1046,1011
Indiana,Jasper County,10,2056,1012,1044
Indiana,Jasper County,11,2104,1045,1059
Indiana,Jasper County,12,2496,1260,1236
Indiana,Jasper County,13,2221,1087,1134
Indiana,Jasper County,14,1904,938,966
Indiana,Jasper County,15,1540,731,809
Indiana,Jasper County,16,1091,501,590
Indiana,Jasper County,17,723,300,423
Indiana,Jasper County,18,614,222,392
Indiana,Jay County,0,20764,10348,10416
Indiana,Jay County,1,1496,778,718
Indiana,Jay County,2,1421,751,670
Indiana,Jay County,3,1461,762,699
Indiana,Jay County,4,1412,710,702
Indiana,Jay County,5,1193,603,590
Indiana,Jay County,6,1277,659,618
Indiana,Jay County,7,992,519,473
Indiana,Jay County,8,1200,599,601
Indiana,Jay County,9,1088,573,515
Indiana,Jay County,10,1344,647,697
Indiana,Jay County,11,1397,695,702
Indiana,Jay County,12,1398,695,703
Indiana,Jay County,13,1374,706,668
Indiana,Jay County,14,1174,574,600
Indiana,Jay County,15,980,451,529
Indiana,Jay County,16,640,283,357
Indiana,Jay County,17,479,203,276
Indiana,Jay County,18,438,140,298
Indiana,Jefferson County,0,32208,15497,16711
Indiana,Jefferson County,1,1841,962,879
Indiana,Jefferson County,2,1718,859,859
Indiana,Jefferson County,3,1803,940,863
Indiana,Jefferson County,4,2149,1026,1123
Indiana,Jefferson County,5,2329,1096,1233
Indiana,Jefferson County,6,2010,939,1071
Indiana,Jefferson County,7,1778,851,927
Indiana,Jefferson County,8,1955,924,1031
Indiana,Jefferson County,9,1888,891,997
Indiana,Jefferson County,10,2058,1002,1056
Indiana,Jefferson County,11,2182,1047,1135
Indiana,Jefferson County,12,2438,1231,1207
Indiana,Jefferson County,13,2263,1097,1166
Indiana,Jefferson County,14,1945,980,965
Indiana,Jefferson County,15,1525,698,827
Indiana,Jefferson County,16,1082,492,590
Indiana,Jefferson County,17,603,253,350
Indiana,Jefferson County,18,641,209,432
Indiana,Jennings County,0,27611,13837,13774
Indiana,Jennings County,1,1644,866,778
Indiana,Jennings County,2,1742,859,883
Indiana,Jennings County,3,1869,970,899
Indiana,Jennings County,4,1703,869,834
Indiana,Jennings County,5,1676,898,778
Indiana,Jennings County,6,1850,917,933
Indiana,Jennings County,7,1475,770,705
Indiana,Jennings County,8,1494,746,748
Indiana,Jennings County,9,1698,856,842
Indiana,Jennings County,10,2002,1022,980
Indiana,Jennings County,11,2026,1026,1000
Indiana,Jennings County,12,2117,1082,1035
Indiana,Jennings County,13,1776,901,875
Indiana,Jennings County,14,1457,671,786
Indiana,Jennings County,15,1294,608,686
Indiana,Jennings County,16,902,429,473
Indiana,Jennings County,17,494,210,284
Indiana,Jennings County,18,392,137,255
Indiana,Johnson County,0,156225,77105,79120
Indiana,Johnson County,1,10209,5348,4861
Indiana,Johnson County,2,10672,5414,5258
Indiana,Johnson County,3,11129,5703,5426
Indiana,Johnson County,4,10312,5381,4931
Indiana,Johnson County,5,9575,4849,4726
Indiana,Johnson County,6,10683,5391,5292
Indiana,Johnson County,7,10379,5053,5326
Indiana,Johnson County,8,10988,5449,5539
Indiana,Johnson County,9,10135,5059,5076
Indiana,Johnson County,10,10397,5258,5139
Indiana,Johnson County,11,9993,4904,5089
Indiana,Johnson County,12,10053,4993,5060
Indiana,Johnson County,13,8931,4304,4627
Indiana,Johnson County,14,7518,3471,4047
Indiana,Johnson County,15,5771,2672,3099
Indiana,Johnson County,16,4272,1878,2394
Indiana,Johnson County,17,2690,1116,1574
Indiana,Johnson County,18,2518,862,1656
Indiana,Knox County,0,36895,18682,18213
Indiana,Knox County,1,2207,1129,1078
Indiana,Knox County,2,2193,1122,1071
Indiana,Knox County,3,2197,1135,1062
Indiana,Knox County,4,2964,1635,1329
Indiana,Knox County,5,3061,1748,1313
Indiana,Knox County,6,2159,1189,970
Indiana,Knox County,7,2131,1144,987
Indiana,Knox County,8,2186,1101,1085
Indiana,Knox County,9,1839,946,893
Indiana,Knox County,10,2074,1041,1033
Indiana,Knox County,11,2204,1134,1070
Indiana,Knox County,12,2624,1322,1302
Indiana,Knox County,13,2474,1199,1275
Indiana,Knox County,14,2056,994,1062
Indiana,Knox County,15,1634,754,880
Indiana,Knox County,16,1210,498,712
Indiana,Knox County,17,841,342,499
Indiana,Knox County,18,841,249,592
Indiana,Kosciusko County,0,79344,39656,39688
Indiana,Kosciusko County,1,5179,2669,2510
Indiana,Kosciusko County,2,5125,2603,2522
Indiana,Kosciusko County,3,5359,2746,2613
Indiana,Kosciusko County,4,5248,2630,2618
Indiana,Kosciusko County,5,5185,2630,2555
Indiana,Kosciusko County,6,5404,2824,2580
Indiana,Kosciusko County,7,4868,2487,2381
Indiana,Kosciusko County,8,4831,2511,2320
Indiana,Kosciusko County,9,4329,2221,2108
Indiana,Kosciusko County,10,4718,2354,2364
Indiana,Kosciusko County,11,4947,2467,2480
Indiana,Kosciusko County,12,5572,2761,2811
Indiana,Kosciusko County,13,5305,2650,2655
Indiana,Kosciusko County,14,4376,2143,2233
Indiana,Kosciusko County,15,3395,1639,1756
Indiana,Kosciusko County,16,2424,1114,1310
Indiana,Kosciusko County,17,1560,681,879
Indiana,Kosciusko County,18,1519,526,993
Indiana,LaGrange County,0,39330,19980,19350
Indiana,LaGrange County,1,3504,1834,1670
Indiana,LaGrange County,2,3485,1804,1681
Indiana,LaGrange County,3,3622,1901,1721
Indiana,LaGrange County,4,3276,1710,1566
Indiana,LaGrange County,5,2497,1334,1163
Indiana,LaGrange County,6,2463,1275,1188
Indiana,LaGrange County,7,2219,1128,1091
Indiana,LaGrange County,8,2204,1137,1067
Indiana,LaGrange County,9,2100,1020,1080
Indiana,LaGrange County,10,2183,1140,1043
Indiana,LaGrange County,11,2100,1052,1048
Indiana,LaGrange County,12,2199,1068,1131
Indiana,LaGrange County,13,2115,1044,1071
Indiana,LaGrange County,14,1768,880,888
Indiana,LaGrange County,15,1394,685,709
Indiana,LaGrange County,16,1036,506,530
Indiana,LaGrange County,17,609,239,370
Indiana,LaGrange County,18,556,223,333
Indiana,Lake County,0,484411,234475,249936
Indiana,Lake County,1,28751,14768,13983
Indiana,Lake County,2,30868,15641,15227
Indiana,Lake County,3,33135,16952,16183
Indiana,Lake County,4,32432,16513,15919
Indiana,Lake County,5,29963,15201,14762
Indiana,Lake County,6,30699,15305,15394
Indiana,Lake County,7,28666,14023,14643
Indiana,Lake County,8,31660,15218,16442
Indiana,Lake County,9,29766,14447,15319
Indiana,Lake County,10,30384,14744,15640
Indiana,Lake County,11,30966,15036,15930
Indiana,Lake County,12,34022,16218,17804
Indiana,Lake County,13,32995,15771,17224
Indiana,Lake County,14,26425,12439,13986
Indiana,Lake County,15,19571,8818,10753
Indiana,Lake County,16,14005,5932,8073
Indiana,Lake County,17,9436,3767,5669
Indiana,Lake County,18,10667,3682,6985
Indiana,LaPorte County,0,110007,56694,53313
Indiana,LaPorte County,1,6547,3341,3206
Indiana,LaPorte County,2,6494,3248,3246
Indiana,LaPorte County,3,6550,3407,3143
Indiana,LaPorte County,4,6306,3236,3070
Indiana,LaPorte County,5,6681,3766,2915
Indiana,LaPorte County,6,7817,4453,3364
Indiana,LaPorte County,7,6774,3861,2913
Indiana,LaPorte County,8,7015,3921,3094
Indiana,LaPorte County,9,6329,3441,2888
Indiana,LaPorte County,10,7129,3797,3332
Indiana,LaPorte County,11,7286,3744,3542
Indiana,LaPorte County,12,7798,3960,3838
Indiana,LaPorte County,13,7589,3720,3869
Indiana,LaPorte County,14,6646,3212,3434
Indiana,LaPorte County,15,5176,2446,2730
Indiana,LaPorte County,16,3502,1534,1968
Indiana,LaPorte County,17,2122,872,1250
Indiana,LaPorte County,18,2246,735,1511
Indiana,Lawrence County,0,45668,22625,23043
Indiana,Lawrence County,1,2538,1303,1235
Indiana,Lawrence County,2,2609,1352,1257
Indiana,Lawrence County,3,2955,1571,1384
Indiana,Lawrence County,4,2798,1415,1383
Indiana,Lawrence County,5,2481,1324,1157
Indiana,Lawrence County,6,2599,1366,1233
Indiana,Lawrence County,7,2461,1231,1230
Indiana,Lawrence County,8,2662,1287,1375
Indiana,Lawrence County,9,2677,1350,1327
Indiana,Lawrence County,10,2980,1566,1414
Indiana,Lawrence County,11,3183,1563,1620
Indiana,Lawrence County,12,3365,1650,1715
Indiana,Lawrence County,13,3218,1569,1649
Indiana,Lawrence County,14,2875,1408,1467
Indiana,Lawrence County,15,2373,1100,1273
Indiana,Lawrence County,16,1709,764,945
Indiana,Lawrence County,17,1071,453,618
Indiana,Lawrence County,18,1114,353,761
Indiana,Madison County,0,129641,64792,64849
Indiana,Madison County,1,7305,3808,3497
Indiana,Madison County,2,7749,3967,3782
Indiana,Madison County,3,8021,4140,3881
Indiana,Madison County,4,8163,4279,3884
Indiana,Madison County,5,7742,4032,3710
Indiana,Madison County,6,8548,4378,4170
Indiana,Madison County,7,7904,4124,3780
Indiana,Madison County,8,8104,4261,3843
Indiana,Madison County,9,7752,3996,3756
Indiana,Madison County,10,8678,4458,4220
Indiana,Madison County,11,8644,4379,4265
Indiana,Madison County,12,8796,4323,4473
Indiana,Madison County,13,8521,4151,4370
Indiana,Madison County,14,7471,3451,4020
Indiana,Madison County,15,6293,2933,3360
Indiana,Madison County,16,4218,1910,2308
Indiana,Madison County,17,2899,1211,1688
Indiana,Madison County,18,2833,991,1842
Indiana,Marion County,0,954670,460093,494577
Indiana,Marion County,1,68903,35580,33323
Indiana,Marion County,2,66207,33683,32524
Indiana,Marion County,3,63731,32694,31037
Indiana,Marion County,4,58795,29445,29350
Indiana,Marion County,5,65698,31962,33736
Indiana,Marion County,6,86721,41962,44759
Indiana,Marion County,7,74630,35976,38654
Indiana,Marion County,8,66657,32427,34230
Indiana,Marion County,9,56558,27654,28904
Indiana,Marion County,10,55982,27139,28843
Indiana,Marion County,11,55815,26896,28919
Indiana,Marion County,12,60187,28461,31726
Indiana,Marion County,13,54428,25525,28903
Indiana,Marion County,14,42341,19327,23014
Indiana,Marion County,15,29249,12969,16280
Indiana,Marion County,16,19873,8291,11582
Indiana,Marion County,17,13344,5100,8244
Indiana,Marion County,18,15551,5002,10549
Indiana,Marshall County,0,46248,23052,23196
Indiana,Marshall County,1,2926,1463,1463
Indiana,Marshall County,2,3040,1623,1417
Indiana,Marshall County,3,3503,1766,1737
Indiana,Marshall County,4,3229,1646,1583
Indiana,Marshall County,5,2710,1430,1280
Indiana,Marshall County,6,2636,1384,1252
Indiana,Marshall County,7,2406,1221,1185
Indiana,Marshall County,8,2677,1378,1299
Indiana,Marshall County,9,2694,1330,1364
Indiana,Marshall County,10,2800,1395,1405
Indiana,Marshall County,11,3038,1558,1480
Indiana,Marshall County,12,3197,1611,1586
Indiana,Marshall County,13,3131,1575,1556
Indiana,Marshall County,14,2642,1264,1378
Indiana,Marshall County,15,1955,940,1015
Indiana,Marshall County,16,1492,684,808
Indiana,Marshall County,17,1014,409,605
Indiana,Marshall County,18,1158,375,783
Indiana,Martin County,0,10217,5177,5040
Indiana,Martin County,1,617,323,294
Indiana,Martin County,2,633,329,304
Indiana,Martin County,3,659,362,297
Indiana,Martin County,4,574,307,267
Indiana,Martin County,5,548,283,265
Indiana,Martin County,6,566,278,288
Indiana,Martin County,7,557,290,267
Indiana,Martin County,8,568,311,257
Indiana,Martin County,9,585,313,272
Indiana,Martin County,10,609,303,306
Indiana,Martin County,11,711,350,361
Indiana,Martin County,12,770,409,361
Indiana,Martin County,13,792,395,397
Indiana,Martin County,14,680,326,354
Indiana,Martin County,15,502,226,276
Indiana,Martin County,16,383,175,208
Indiana,Martin County,17,248,108,140
Indiana,Martin County,18,215,89,126
Indiana,Miami County,0,35567,19133,16434
Indiana,Miami County,1,1844,972,872
Indiana,Miami County,2,1953,968,985
Indiana,Miami County,3,2291,1195,1096
Indiana,Miami County,4,2190,1176,1014
Indiana,Miami County,5,2147,1305,842
Indiana,Miami County,6,2447,1451,996
Indiana,Miami County,7,2238,1385,853
Indiana,Miami County,8,2296,1347,949
Indiana,Miami County,9,2349,1349,1000
Indiana,Miami County,10,2371,1323,1048
Indiana,Miami County,11,2383,1308,1075
Indiana,Miami County,12,2515,1317,1198
Indiana,Miami County,13,2254,1111,1143
Indiana,Miami County,14,2043,1037,1006
Indiana,Miami County,15,1651,800,851
Indiana,Miami County,16,1167,533,634
Indiana,Miami County,17,665,279,386
Indiana,Miami County,18,763,277,486
Indiana,Monroe County,0,146917,73034,73883
Indiana,Monroe County,1,6468,3361,3107
Indiana,Monroe County,2,6264,3273,2991
Indiana,Monroe County,3,6264,3290,2974
Indiana,Monroe County,4,15209,7460,7749
Indiana,Monroe County,5,27455,13886,13569
Indiana,Monroe County,6,12071,6395,5676
Indiana,Monroe County,7,8978,4707,4271
Indiana,Monroe County,8,8448,4284,4164
Indiana,Monroe County,9,7212,3626,3586
Indiana,Monroe County,10,7015,3479,3536
Indiana,Monroe County,11,7044,3495,3549
Indiana,Monroe County,12,7496,3592,3904
Indiana,Monroe County,13,7744,3670,4074
Indiana,Monroe County,14,6418,3036,3382
Indiana,Monroe County,15,4842,2229,2613
Indiana,Monroe County,16,3363,1500,1863
Indiana,Monroe County,17,2143,866,1277
Indiana,Monroe County,18,2483,885,1598
Indiana,Montgomery County,0,38346,19448,18898
Indiana,Montgomery County,1,2250,1185,1065
Indiana,Montgomery County,2,2518,1297,1221
Indiana,Montgomery County,3,2507,1234,1273
Indiana,Montgomery County,4,2601,1498,1103
Indiana,Montgomery County,5,2436,1422,1014
Indiana,Montgomery County,6,2382,1235,1147
Indiana,Montgomery County,7,2149,1103,1046
Indiana,Montgomery County,8,2144,1119,1025
Indiana,Montgomery County,9,2117,1046,1071
Indiana,Montgomery County,10,2365,1207,1158
Indiana,Montgomery County,11,2569,1282,1287
Indiana,Montgomery County,12,2846,1434,1412
Indiana,Montgomery County,13,2588,1310,1278
Indiana,Montgomery County,14,2071,1004,1067
Indiana,Montgomery County,15,1666,734,932
Indiana,Montgomery County,16,1342,600,742
Indiana,Montgomery County,17,913,420,493
Indiana,Montgomery County,18,882,318,564
Indiana,Morgan County,0,70116,34819,35297
Indiana,Morgan County,1,4001,2074,1927
Indiana,Morgan County,2,4045,2108,1937
Indiana,Morgan County,3,4781,2481,2300
Indiana,Morgan County,4,4640,2393,2247
Indiana,Morgan County,5,3868,2006,1862
Indiana,Morgan County,6,4125,2058,2067
Indiana,Morgan County,7,3808,1917,1891
Indiana,Morgan County,8,4101,1989,2112
Indiana,Morgan County,9,4075,2072,2003
Indiana,Morgan County,10,4959,2435,2524
Indiana,Morgan County,11,5218,2560,2658
Indiana,Morgan County,12,5613,2848,2765
Indiana,Morgan County,13,5008,2528,2480
Indiana,Morgan County,14,4082,1871,2211
Indiana,Morgan County,15,3163,1518,1645
Indiana,Morgan County,16,2186,990,1196
Indiana,Morgan County,17,1340,572,768
Indiana,Morgan County,18,1103,399,704
Indiana,Newton County,0,14011,7073,6938
Indiana,Newton County,1,749,342,407
Indiana,Newton County,2,803,413,390
Indiana,Newton County,3,873,436,437
Indiana,Newton County,4,842,458,384
Indiana,Newton County,5,697,365,332
Indiana,Newton County,6,844,459,385
Indiana,Newton County,7,769,397,372
Indiana,Newton County,8,830,433,397
Indiana,Newton County,9,831,429,402
Indiana,Newton County,10,868,449,419
Indiana,Newton County,11,941,499,442
Indiana,Newton County,12,1164,567,597
Indiana,Newton County,13,1072,577,495
Indiana,Newton County,14,887,437,450
Indiana,Newton County,15,634,302,332
Indiana,Newton County,16,573,266,307
Indiana,Newton County,17,323,146,177
Indiana,Newton County,18,311,98,213
Indiana,Noble County,0,47532,23825,23707
Indiana,Noble County,1,3069,1529,1540
Indiana,Noble County,2,3121,1607,1514
Indiana,Noble County,3,3366,1722,1644
Indiana,Noble County,4,3195,1662,1533
Indiana,Noble County,5,2944,1496,1448
Indiana,Noble County,6,2974,1509,1465
Indiana,Noble County,7,2811,1445,1366
Indiana,Noble County,8,2770,1404,1366
Indiana,Noble County,9,2923,1498,1425
Indiana,Noble County,10,3003,1517,1486
Indiana,Noble County,11,3140,1613,1527
Indiana,Noble County,12,3383,1729,1654
Indiana,Noble County,13,3208,1624,1584
Indiana,Noble County,14,2732,1383,1349
Indiana,Noble County,15,1979,936,1043
Indiana,Noble County,16,1226,526,700
Indiana,Noble County,17,737,319,418
Indiana,Noble County,18,951,306,645
Indiana,Ohio County,0,5844,2894,2950
Indiana,Ohio County,1,267,134,133
Indiana,Ohio County,2,299,161,138
Indiana,Ohio County,3,331,154,177
Indiana,Ohio County,4,317,169,148
Indiana,Ohio County,5,260,118,142
Indiana,Ohio County,6,312,157,155
Indiana,Ohio County,7,325,158,167
Indiana,Ohio County,8,308,160,148
Indiana,Ohio County,9,310,155,155
Indiana,Ohio County,10,378,188,190
Indiana,Ohio County,11,418,231,187
Indiana,Ohio County,12,563,272,291
Indiana,Ohio County,13,465,236,229
Indiana,Ohio County,14,408,211,197
Indiana,Ohio County,15,337,149,188
Indiana,Ohio County,16,268,124,144
Indiana,Ohio County,17,160,77,83
Indiana,Ohio County,18,118,40,78
Indiana,Orange County,0,19489,9719,9770
Indiana,Orange County,1,1155,606,549
Indiana,Orange County,2,1178,612,566
Indiana,Orange County,3,1263,672,591
Indiana,Orange County,4,1275,679,596
Indiana,Orange County,5,1078,559,519
Indiana,Orange County,6,1092,555,537
Indiana,Orange County,7,1039,525,514
Indiana,Orange County,8,1101,552,549
Indiana,Orange County,9,1104,540,564
Indiana,Orange County,10,1163,600,563
Indiana,Orange County,11,1314,658,656
Indiana,Orange County,12,1485,736,749
Indiana,Orange County,13,1434,708,726
Indiana,Orange County,14,1218,578,640
Indiana,Orange County,15,1029,477,552
Indiana,Orange County,16,692,313,379
Indiana,Orange County,17,450,202,248
Indiana,Orange County,18,419,147,272
Indiana,Owen County,0,20845,10423,10422
Indiana,Owen County,1,1088,548,540
Indiana,Owen County,2,1159,592,567
Indiana,Owen County,3,1299,662,637
Indiana,Owen County,4,1299,659,640
Indiana,Owen County,5,1104,558,546
Indiana,Owen County,6,1105,553,552
Indiana,Owen County,7,1144,579,565
Indiana,Owen County,8,1108,568,540
Indiana,Owen County,9,1177,589,588
Indiana,Owen County,10,1356,692,664
Indiana,Owen County,11,1568,782,786
Indiana,Owen County,12,1780,902,878
Indiana,Owen County,13,1639,837,802
Indiana,Owen County,14,1407,679,728
Indiana,Owen County,15,1082,533,549
Indiana,Owen County,16,739,375,364
Indiana,Owen County,17,430,180,250
Indiana,Owen County,18,361,135,226
Indiana,Parke County,0,16927,8000,8927
Indiana,Parke County,1,1020,545,475
Indiana,Parke County,2,977,510,467
Indiana,Parke County,3,1059,562,497
Indiana,Parke County,4,918,479,439
Indiana,Parke County,5,975,419,556
Indiana,Parke County,6,1134,483,651
Indiana,Parke County,7,1049,431,618
Indiana,Parke County,8,970,403,567
Indiana,Parke County,9,947,409,538
Indiana,Parke County,10,1042,474,568
Indiana,Parke County,11,1109,544,565
Indiana,Parke County,12,1280,604,676
Indiana,Parke County,13,1166,574,592
Indiana,Parke County,14,1089,508,581
Indiana,Parke County,15,885,464,421
Indiana,Parke County,16,590,288,302
Indiana,Parke County,17,380,178,202
Indiana,Parke County,18,337,125,212
Indiana,Perry County,0,19102,10232,8870
Indiana,Perry County,1,1032,504,528
Indiana,Perry County,2,1082,575,507
Indiana,Perry County,3,1218,621,597
Indiana,Perry County,4,1048,567,481
Indiana,Perry County,5,1121,692,429
Indiana,Perry County,6,1319,829,490
Indiana,Perry County,7,1184,698,486
Indiana,Perry County,8,1237,723,514
Indiana,Perry County,9,1121,615,506
Indiana,Perry County,10,1177,665,512
Indiana,Perry County,11,1214,672,542
Indiana,Perry County,12,1411,713,698
Indiana,Perry County,13,1348,677,671
Indiana,Perry County,14,1222,627,595
Indiana,Perry County,15,874,414,460
Indiana,Perry County,16,581,282,299
Indiana,Perry County,17,424,182,242
Indiana,Perry County,18,489,176,313
Indiana,Pike County,0,12410,6187,6223
Indiana,Pike County,1,720,350,370
Indiana,Pike County,2,722,363,359
Indiana,Pike County,3,801,393,408
Indiana,Pike County,4,733,378,355
Indiana,Pike County,5,589,299,290
Indiana,Pike County,6,718,375,343
Indiana,Pike County,7,644,333,311
Indiana,Pike County,8,716,354,362
Indiana,Pike County,9,717,363,354
Indiana,Pike County,10,814,412,402
Indiana,Pike County,11,823,427,396
Indiana,Pike County,12,962,471,491
Indiana,Pike County,13,964,497,467
Indiana,Pike County,14,803,426,377
Indiana,Pike County,15,625,295,330
Indiana,Pike County,16,461,212,249
Indiana,Pike County,17,321,149,172
Indiana,Pike County,18,277,90,187
Indiana,Porter County,0,169594,83930,85664
Indiana,Porter County,1,9232,4713,4519
Indiana,Porter County,2,10018,5184,4834
Indiana,Porter County,3,11013,5686,5327
Indiana,Porter County,4,11699,6049,5650
Indiana,Porter County,5,10742,5552,5190
Indiana,Porter County,6,10282,5280,5002
Indiana,Porter County,7,10471,5258,5213
Indiana,Porter County,8,11464,5700,5764
Indiana,Porter County,9,10800,5360,5440
Indiana,Porter County,10,11131,5553,5578
Indiana,Porter County,11,10909,5390,5519
Indiana,Porter County,12,12101,5792,6309
Indiana,Porter County,13,11929,5775,6154
Indiana,Porter County,14,9735,4732,5003
Indiana,Porter County,15,7162,3429,3733
Indiana,Porter County,16,4714,2198,2516
Indiana,Porter County,17,3068,1245,1823
Indiana,Porter County,18,3124,1034,2090
Indiana,Posey County,0,25540,12755,12785
Indiana,Posey County,1,1391,729,662
Indiana,Posey County,2,1628,795,833
Indiana,Posey County,3,1630,859,771
Indiana,Posey County,4,1497,780,717
Indiana,Posey County,5,1397,698,699
Indiana,Posey County,6,1399,727,672
Indiana,Posey County,7,1441,706,735
Indiana,Posey County,8,1545,807,738
Indiana,Posey County,9,1448,744,704
Indiana,Posey County,10,1582,779,803
Indiana,Posey County,11,1735,868,867
Indiana,Posey County,12,2024,1021,1003
Indiana,Posey County,13,2024,1046,978
Indiana,Posey County,14,1662,817,845
Indiana,Posey County,15,1174,568,606
Indiana,Posey County,16,838,385,453
Indiana,Posey County,17,549,233,316
Indiana,Posey County,18,576,193,383
Indiana,Pulaski County,0,12469,6357,6112
Indiana,Pulaski County,1,658,315,343
Indiana,Pulaski County,2,754,408,346
Indiana,Pulaski County,3,862,467,395
Indiana,Pulaski County,4,774,411,363
Indiana,Pulaski County,5,665,356,309
Indiana,Pulaski County,6,713,371,342
Indiana,Pulaski County,7,665,343,322
Indiana,Pulaski County,8,728,390,338
Indiana,Pulaski County,9,732,376,356
Indiana,Pulaski County,10,755,387,368
Indiana,Pulaski County,11,880,407,473
Indiana,Pulaski County,12,903,469,434
Indiana,Pulaski County,13,937,486,451
Indiana,Pulaski County,14,786,397,389
Indiana,Pulaski County,15,577,276,301
Indiana,Pulaski County,16,487,255,232
Indiana,Pulaski County,17,292,131,161
Indiana,Pulaski County,18,301,112,189
Indiana,Putnam County,0,37779,19840,17939
Indiana,Putnam County,1,1942,1012,930
Indiana,Putnam County,2,1973,1025,948
Indiana,Putnam County,3,2142,1086,1056
Indiana,Putnam County,4,2976,1482,1494
Indiana,Putnam County,5,3662,1971,1691
Indiana,Putnam County,6,2540,1543,997
Indiana,Putnam County,7,2239,1306,933
Indiana,Putnam County,8,2124,1223,901
Indiana,Putnam County,9,2109,1169,940
Indiana,Putnam County,10,2342,1248,1094
Indiana,Putnam County,11,2480,1337,1143
Indiana,Putnam County,12,2627,1357,1270
Indiana,Putnam County,13,2360,1223,1137
Indiana,Putnam County,14,1989,1007,982
Indiana,Putnam County,15,1539,686,853
Indiana,Putnam County,16,1174,532,642
Indiana,Putnam County,17,790,333,457
Indiana,Putnam County,18,771,300,471
Indiana,Randolph County,0,24851,12202,12649
Indiana,Randolph County,1,1464,752,712
Indiana,Randolph County,2,1503,736,767
Indiana,Randolph County,3,1637,829,808
Indiana,Randolph County,4,1662,847,815
Indiana,Randolph County,5,1369,706,663
Indiana,Randolph County,6,1363,680,683
Indiana,Randolph County,7,1240,656,584
Indiana,Randolph County,8,1354,647,707
Indiana,Randolph County,9,1438,701,737
Indiana,Randolph County,10,1626,851,775
Indiana,Randolph County,11,1609,804,805
Indiana,Randolph County,12,1790,890,900
Indiana,Randolph County,13,1751,874,877
Indiana,Randolph County,14,1481,674,807
Indiana,Randolph County,15,1251,608,643
Indiana,Randolph County,16,952,437,515
Indiana,Randolph County,17,650,272,378
Indiana,Randolph County,18,711,238,473
Indiana,Ripley County,0,28523,14128,14395
Indiana,Ripley County,1,1686,877,809
Indiana,Ripley County,2,1789,917,872
Indiana,Ripley County,3,1983,1011,972
Indiana,Ripley County,4,1972,1040,932
Indiana,Ripley County,5,1730,893,837
Indiana,Ripley County,6,1656,849,807
Indiana,Ripley County,7,1482,704,778
Indiana,Ripley County,8,1703,833,870
Indiana,Ripley County,9,1648,829,819
Indiana,Ripley County,10,1869,903,966
Indiana,Ripley County,11,1946,973,973
Indiana,Ripley County,12,2069,1008,1061
Indiana,Ripley County,13,1905,951,954
Indiana,Ripley County,14,1587,771,816
Indiana,Ripley County,15,1330,665,665
Indiana,Ripley County,16,900,417,483
Indiana,Ripley County,17,611,271,340
Indiana,Ripley County,18,657,216,441
Indiana,Rush County,0,16663,8223,8440
Indiana,Rush County,1,972,505,467
Indiana,Rush County,2,970,486,484
Indiana,Rush County,3,1144,579,565
Indiana,Rush County,4,1081,551,530
Indiana,Rush County,5,980,501,479
Indiana,Rush County,6,966,475,491
Indiana,Rush County,7,884,436,448
Indiana,Rush County,8,924,456,468
Indiana,Rush County,9,942,475,467
Indiana,Rush County,10,1104,548,556
Indiana,Rush County,11,1173,611,562
Indiana,Rush County,12,1251,620,631
Indiana,Rush County,13,1216,624,592
Indiana,Rush County,14,924,432,492
Indiana,Rush County,15,767,359,408
Indiana,Rush County,16,577,261,316
Indiana,Rush County,17,409,179,230
Indiana,Rush County,18,379,125,254
Indiana,St. Joseph County,0,270771,131836,138935
Indiana,St. Joseph County,1,17363,8836,8527
Indiana,St. Joseph County,2,17721,8955,8766
Indiana,St. Joseph County,3,17982,9322,8660
Indiana,St. Joseph County,4,20110,10140,9970
Indiana,St. Joseph County,5,20368,9795,10573
Indiana,St. Joseph County,6,19012,9460,9552
Indiana,St. Joseph County,7,17102,8599,8503
Indiana,St. Joseph County,8,16725,8203,8522
Indiana,St. Joseph County,9,15161,7443,7718
Indiana,St. Joseph County,10,16018,7811,8207
Indiana,St. Joseph County,11,16011,7829,8182
Indiana,St. Joseph County,12,17279,8351,8928
Indiana,St. Joseph County,13,17136,8275,8861
Indiana,St. Joseph County,14,14501,6942,7559
Indiana,St. Joseph County,15,10134,4722,5412
Indiana,St. Joseph County,16,7045,3066,3979
Indiana,St. Joseph County,17,4805,1956,2849
Indiana,St. Joseph County,18,6298,2131,4167
Indiana,Scott County,0,23878,11731,12147
Indiana,Scott County,1,1411,730,681
Indiana,Scott County,2,1472,720,752
Indiana,Scott County,3,1562,737,825
Indiana,Scott County,4,1462,779,683
Indiana,Scott County,5,1366,693,673
Indiana,Scott County,6,1555,796,759
Indiana,Scott County,7,1369,688,681
Indiana,Scott County,8,1416,680,736
Indiana,Scott County,9,1514,721,793
Indiana,Scott County,10,1715,875,840
Indiana,Scott County,11,1642,849,793
Indiana,Scott County,12,1833,906,927
Indiana,Scott County,13,1586,772,814
Indiana,Scott County,14,1300,623,677
Indiana,Scott County,15,1091,502,589
Indiana,Scott County,16,764,337,427
Indiana,Scott County,17,474,186,288
Indiana,Scott County,18,346,137,209
Indiana,Shelby County,0,44593,22146,22447
Indiana,Shelby County,1,2567,1337,1230
Indiana,Shelby County,2,2746,1390,1356
Indiana,Shelby County,3,2990,1553,1437
Indiana,Shelby County,4,2805,1457,1348
Indiana,Shelby County,5,2493,1279,1214
Indiana,Shelby County,6,2753,1385,1368
Indiana,Shelby County,7,2583,1310,1273
Indiana,Shelby County,8,2622,1310,1312
Indiana,Shelby County,9,2722,1417,1305
Indiana,Shelby County,10,2879,1428,1451
Indiana,Shelby County,11,3164,1544,1620
Indiana,Shelby County,12,3405,1693,1712
Indiana,Shelby County,13,3220,1610,1610
Indiana,Shelby County,14,2518,1219,1299
Indiana,Shelby County,15,1893,919,974
Indiana,Shelby County,16,1406,634,772
Indiana,Shelby County,17,861,336,525
Indiana,Shelby County,18,966,325,641
Indiana,Spencer County,0,20327,10232,10095
Indiana,Spencer County,1,1057,530,527
Indiana,Spencer County,2,1173,605,568
Indiana,Spencer County,3,1363,701,662
Indiana,Spencer County,4,1279,649,630
Indiana,Spencer County,5,1098,561,537
Indiana,Spencer County,6,1067,567,500
Indiana,Spencer County,7,1093,562,531
Indiana,Spencer County,8,1155,597,558
Indiana,Spencer County,9,1165,575,590
Indiana,Spencer County,10,1294,654,640
Indiana,Spencer County,11,1456,747,709
Indiana,Spencer County,12,1662,851,811
Indiana,Spencer County,13,1533,762,771
Indiana,Spencer County,14,1261,632,629
Indiana,Spencer County,15,1042,509,533
Indiana,Spencer County,16,725,347,378
Indiana,Spencer County,17,442,211,231
Indiana,Spencer County,18,462,172,290
Indiana,Starke County,0,22935,11437,11498
Indiana,Starke County,1,1346,715,631
Indiana,Starke County,2,1404,717,687
Indiana,Starke County,3,1546,803,743
Indiana,Starke County,4,1426,684,742
Indiana,Starke County,5,1223,636,587
Indiana,Starke County,6,1399,705,694
Indiana,Starke County,7,1244,608,636
Indiana,Starke County,8,1340,680,660
Indiana,Starke County,9,1297,652,645
Indiana,Starke County,10,1509,758,751
Indiana,Starke County,11,1461,722,739
Indiana,Starke County,12,1736,852,884
Indiana,Starke County,13,1738,874,864
Indiana,Starke County,14,1488,757,731
Indiana,Starke County,15,1061,496,565
Indiana,Starke County,16,823,373,450
Indiana,Starke County,17,549,260,289
Indiana,Starke County,18,345,145,200
Indiana,Steuben County,0,34586,17560,17026
Indiana,Steuben County,1,1976,1015,961
Indiana,Steuben County,2,1842,936,906
Indiana,Steuben County,3,2012,1039,973
Indiana,Steuben County,4,2393,1270,1123
Indiana,Steuben County,5,2405,1389,1016
Indiana,Steuben County,6,1912,976,936
Indiana,Steuben County,7,1745,898,847
Indiana,Steuben County,8,1727,896,831
Indiana,Steuben County,9,1765,898,867
Indiana,Steuben County,10,2181,1098,1083
Indiana,Steuben County,11,2410,1212,1198
Indiana,Steuben County,12,2583,1300,1283
Indiana,Steuben County,13,2652,1346,1306
Indiana,Steuben County,14,2394,1165,1229
Indiana,Steuben County,15,1863,919,944
Indiana,Steuben County,16,1236,593,643
Indiana,Steuben County,17,802,383,419
Indiana,Steuben County,18,688,227,461
Indiana,Sullivan County,0,20690,11241,9449
Indiana,Sullivan County,1,1043,534,509
Indiana,Sullivan County,2,1073,592,481
Indiana,Sullivan County,3,1119,586,533
Indiana,Sullivan County,4,1204,677,527
Indiana,Sullivan County,5,1249,793,456
Indiana,Sullivan County,6,1530,927,603
Indiana,Sullivan County,7,1410,879,531
Indiana,Sullivan County,8,1362,812,550
Indiana,Sullivan County,9,1389,799,590
Indiana,Sullivan County,10,1434,841,593
Indiana,Sullivan County,11,1424,758,666
Indiana,Sullivan County,12,1393,713,680
Indiana,Sullivan County,13,1342,683,659
Indiana,Sullivan County,14,1196,580,616
Indiana,Sullivan County,15,997,461,536
Indiana,Sullivan County,16,642,276,366
Indiana,Sullivan County,17,415,174,241
Indiana,Sullivan County,18,468,156,312
Indiana,Switzerland County,0,10717,5524,5193
Indiana,Switzerland County,1,674,348,326
Indiana,Switzerland County,2,764,413,351
Indiana,Switzerland County,3,771,415,356
Indiana,Switzerland County,4,674,356,318
Indiana,Switzerland County,5,547,308,239
Indiana,Switzerland County,6,592,287,305
Indiana,Switzerland County,7,580,288,292
Indiana,Switzerland County,8,666,348,318
Indiana,Switzerland County,9,632,326,306
Indiana,Switzerland County,10,695,372,323
Indiana,Switzerland County,11,767,386,381
Indiana,Switzerland County,12,790,399,391
Indiana,Switzerland County,13,710,359,351
Indiana,Switzerland County,14,602,327,275
Indiana,Switzerland County,15,478,244,234
Indiana,Switzerland County,16,355,179,176
Indiana,Switzerland County,17,232,102,130
Indiana,Switzerland County,18,188,67,121
Indiana,Tippecanoe County,0,193048,98678,94370
Indiana,Tippecanoe County,1,11461,5852,5609
Indiana,Tippecanoe County,2,11159,5695,5464
Indiana,Tippecanoe County,3,10891,5523,5368
Indiana,Tippecanoe County,4,18404,9786,8618
Indiana,Tippecanoe County,5,33702,19089,14613
Indiana,Tippecanoe County,6,15572,8184,7388
Indiana,Tippecanoe County,7,11933,6219,5714
Indiana,Tippecanoe County,8,10676,5429,5247
Indiana,Tippecanoe County,9,9613,4807,4806
Indiana,Tippecanoe County,10,9675,4819,4856
Indiana,Tippecanoe County,11,9124,4545,4579
Indiana,Tippecanoe County,12,9459,4619,4840
Indiana,Tippecanoe County,13,8908,4218,4690
Indiana,Tippecanoe County,14,7593,3561,4032
Indiana,Tippecanoe County,15,5508,2499,3009
Indiana,Tippecanoe County,16,3799,1698,2101
Indiana,Tippecanoe County,17,2607,1077,1530
Indiana,Tippecanoe County,18,2964,1058,1906
Indiana,Tipton County,0,15128,7537,7591
Indiana,Tipton County,1,813,426,387
Indiana,Tipton County,2,774,394,380
Indiana,Tipton County,3,922,480,442
Indiana,Tipton County,4,976,516,460
Indiana,Tipton County,5,824,448,376
Indiana,Tipton County,6,878,466,412
Indiana,Tipton County,7,778,377,401
Indiana,Tipton County,8,785,394,391
Indiana,Tipton County,9,810,402,408
Indiana,Tipton County,10,1076,535,541
Indiana,Tipton County,11,1032,529,503
Indiana,Tipton County,12,1179,562,617
Indiana,Tipton County,13,1125,596,529
Indiana,Tipton County,14,943,452,491
Indiana,Tipton County,15,837,413,424
Indiana,Tipton County,16,600,264,336
Indiana,Tipton County,17,369,160,209
Indiana,Tipton County,18,407,123,284
Indiana,Union County,0,7037,3491,3546
Indiana,Union County,1,374,183,191
Indiana,Union County,2,357,200,157
Indiana,Union County,3,432,229,203
Indiana,Union County,4,421,223,198
Indiana,Union County,5,407,220,187
Indiana,Union County,6,451,244,207
Indiana,Union County,7,346,162,184
Indiana,Union County,8,412,205,207
Indiana,Union County,9,391,179,212
Indiana,Union County,10,475,238,237
Indiana,Union County,11,534,253,281
Indiana,Union County,12,585,286,299
Indiana,Union County,13,489,255,234
Indiana,Union County,14,458,220,238
Indiana,Union County,15,357,167,190
Indiana,Union County,16,251,114,137
Indiana,Union County,17,145,58,87
Indiana,Union County,18,152,55,97
Indiana,Vanderburgh County,0,180974,87699,93275
Indiana,Vanderburgh County,1,10921,5663,5258
Indiana,Vanderburgh County,2,10861,5453,5408
Indiana,Vanderburgh County,3,10898,5487,5411
Indiana,Vanderburgh County,4,11463,5680,5783
Indiana,Vanderburgh County,5,12453,6034,6419
Indiana,Vanderburgh County,6,13593,6810,6783
Indiana,Vanderburgh County,7,12274,6149,6125
Indiana,Vanderburgh County,8,11491,5765,5726
Indiana,Vanderburgh County,9,9897,4914,4983
Indiana,Vanderburgh County,10,10414,5170,5244
Indiana,Vanderburgh County,11,10787,5244,5543
Indiana,Vanderburgh County,12,12728,6161,6567
Indiana,Vanderburgh County,13,12621,6061,6560
Indiana,Vanderburgh County,14,10110,4822,5288
Indiana,Vanderburgh County,15,7127,3199,3928
Indiana,Vanderburgh County,16,5158,2180,2978
Indiana,Vanderburgh County,17,3865,1548,2317
Indiana,Vanderburgh County,18,4313,1359,2954
Indiana,Vermillion County,0,15479,7691,7788
Indiana,Vermillion County,1,845,433,412
Indiana,Vermillion County,2,918,481,437
Indiana,Vermillion County,3,975,533,442
Indiana,Vermillion County,4,1013,547,466
Indiana,Vermillion County,5,818,428,390
Indiana,Vermillion County,6,936,483,453
Indiana,Vermillion County,7,800,415,385
Indiana,Vermillion County,8,881,434,447
Indiana,Vermillion County,9,909,446,463
Indiana,Vermillion County,10,1066,531,535
Indiana,Vermillion County,11,991,504,487
Indiana,Vermillion County,12,1115,530,585
Indiana,Vermillion County,13,1110,529,581
Indiana,Vermillion County,14,1022,509,513
Indiana,Vermillion County,15,783,372,411
Indiana,Vermillion County,16,567,275,292
Indiana,Vermillion County,17,350,125,225
Indiana,Vermillion County,18,380,116,264
Indiana,Vigo County,0,107386,54405,52981
Indiana,Vigo County,1,6190,3237,2953
Indiana,Vigo County,2,6033,3135,2898
Indiana,Vigo County,3,6101,3117,2984
Indiana,Vigo County,4,7848,4159,3689
Indiana,Vigo County,5,11710,6122,5588
Indiana,Vigo County,6,7653,4168,3485
Indiana,Vigo County,7,6437,3623,2814
Indiana,Vigo County,8,6499,3542,2957
Indiana,Vigo County,9,5779,3090,2689
Indiana,Vigo County,10,6248,3253,2995
Indiana,Vigo County,11,6315,3296,3019
Indiana,Vigo County,12,6500,3201,3299
Indiana,Vigo County,13,6556,3193,3363
Indiana,Vigo County,14,5603,2597,3006
Indiana,Vigo County,15,4389,2012,2377
Indiana,Vigo County,16,3109,1230,1879
Indiana,Vigo County,17,2099,765,1334
Indiana,Vigo County,18,2317,665,1652
Indiana,Wabash County,0,31280,15158,16122
Indiana,Wabash County,1,1661,835,826
Indiana,Wabash County,2,1692,809,883
Indiana,Wabash County,3,1892,974,918
Indiana,Wabash County,4,2315,1166,1149
Indiana,Wabash County,5,2099,1058,1041
Indiana,Wabash County,6,1747,907,840
Indiana,Wabash County,7,1567,756,811
Indiana,Wabash County,8,1723,853,870
Indiana,Wabash County,9,1702,852,850
Indiana,Wabash County,10,1887,950,937
Indiana,Wabash County,11,1954,937,1017
Indiana,Wabash County,12,2291,1127,1164
Indiana,Wabash County,13,2224,1118,1106
Indiana,Wabash County,14,1858,880,978
Indiana,Wabash County,15,1561,728,833
Indiana,Wabash County,16,1146,517,629
Indiana,Wabash County,17,902,352,550
Indiana,Wabash County,18,1059,339,720
Indiana,Warren County,0,8263,4086,4177
Indiana,Warren County,1,442,214,228
Indiana,Warren County,2,532,267,265
Indiana,Warren County,3,543,261,282
Indiana,Warren County,4,503,251,252
Indiana,Warren County,5,377,198,179
Indiana,Warren County,6,456,226,230
Indiana,Warren County,7,442,222,220
Indiana,Warren County,8,464,222,242
Indiana,Warren County,9,457,231,226
Indiana,Warren County,10,557,281,276
Indiana,Warren County,11,581,301,280
Indiana,Warren County,12,645,347,298
Indiana,Warren County,13,593,301,292
Indiana,Warren County,14,510,238,272
Indiana,Warren County,15,409,200,209
Indiana,Warren County,16,338,155,183
Indiana,Warren County,17,216,102,114
Indiana,Warren County,18,198,69,129
Indiana,Warrick County,0,62567,30670,31897
Indiana,Warrick County,1,3416,1666,1750
Indiana,Warrick County,2,4113,2123,1990
Indiana,Warrick County,3,4584,2316,2268
Indiana,Warrick County,4,4185,2176,2009
Indiana,Warrick County,5,3256,1710,1546
Indiana,Warrick County,6,3381,1703,1678
Indiana,Warrick County,7,3428,1601,1827
Indiana,Warrick County,8,4169,2057,2112
Indiana,Warrick County,9,3938,1970,1968
Indiana,Warrick County,10,4339,2200,2139
Indiana,Warrick County,11,4095,2011,2084
Indiana,Warrick County,12,4538,2218,2320
Indiana,Warrick County,13,4178,1993,2185
Indiana,Warrick County,14,3665,1739,1926
Indiana,Warrick County,15,2853,1335,1518
Indiana,Warrick County,16,1960,912,1048
Indiana,Warrick County,17,1166,505,661
Indiana,Warrick County,18,1303,435,868
Indiana,Washington County,0,27943,13920,14023
Indiana,Washington County,1,1671,841,830
Indiana,Washington County,2,1678,840,838
Indiana,Washington County,3,1849,930,919
Indiana,Washington County,4,1788,930,858
Indiana,Washington County,5,1595,818,777
Indiana,Washington County,6,1720,891,829
Indiana,Washington County,7,1558,766,792
Indiana,Washington County,8,1652,844,808
Indiana,Washington County,9,1697,880,817
Indiana,Washington County,10,1858,944,914
Indiana,Washington County,11,2025,1034,991
Indiana,Washington County,12,2112,1023,1089
Indiana,Washington County,13,1974,982,992
Indiana,Washington County,14,1634,776,858
Indiana,Washington County,15,1275,598,677
Indiana,Washington County,16,855,408,447
Indiana,Washington County,17,507,229,278
Indiana,Washington County,18,495,186,309
Indiana,Wayne County,0,65936,31937,33999
Indiana,Wayne County,1,3711,1851,1860
Indiana,Wayne County,2,4051,2038,2013
Indiana,Wayne County,3,4195,2147,2048
Indiana,Wayne County,4,4249,2169,2080
Indiana,Wayne County,5,4214,2151,2063
Indiana,Wayne County,6,3948,2010,1938
Indiana,Wayne County,7,3706,1815,1891
Indiana,Wayne County,8,3814,1882,1932
Indiana,Wayne County,9,3748,1899,1849
Indiana,Wayne County,10,4161,2041,2120
Indiana,Wayne County,11,4302,2116,2186
Indiana,Wayne County,12,4660,2239,2421
Indiana,Wayne County,13,4546,2205,2341
Indiana,Wayne County,14,3957,1845,2112
Indiana,Wayne County,15,3025,1320,1705
Indiana,Wayne County,16,2310,993,1317
Indiana,Wayne County,17,1612,669,943
Indiana,Wayne County,18,1727,547,1180
Indiana,Wells County,0,28206,13912,14294
Indiana,Wells County,1,1839,959,880
Indiana,Wells County,2,1973,990,983
Indiana,Wells County,3,1986,985,1001
Indiana,Wells County,4,1754,943,811
Indiana,Wells County,5,1574,835,739
Indiana,Wells County,6,1655,814,841
Indiana,Wells County,7,1553,771,782
Indiana,Wells County,8,1719,883,836
Indiana,Wells County,9,1523,769,754
Indiana,Wells County,10,1660,823,837
Indiana,Wells County,11,1764,893,871
Indiana,Wells County,12,2063,1007,1056
Indiana,Wells County,13,1979,987,992
Indiana,Wells County,14,1636,779,857
Indiana,Wells County,15,1221,599,622
Indiana,Wells County,16,918,396,522
Indiana,Wells County,17,615,239,376
Indiana,Wells County,18,774,240,534
Indiana,White County,0,24133,12010,12123
Indiana,White County,1,1460,720,740
Indiana,White County,2,1594,822,772
Indiana,White County,3,1545,801,744
Indiana,White County,4,1593,840,753
Indiana,White County,5,1333,720,613
Indiana,White County,6,1349,687,662
Indiana,White County,7,1183,579,604
Indiana,White County,8,1275,658,617
Indiana,White County,9,1329,681,648
Indiana,White County,10,1558,806,752
Indiana,White County,11,1489,716,773
Indiana,White County,12,1747,869,878
Indiana,White County,13,1824,861,963
Indiana,White County,14,1568,781,787
Indiana,White County,15,1277,618,659
Indiana,White County,16,819,370,449
Indiana,White County,17,561,237,324
Indiana,White County,18,629,244,385
Indiana,Whitley County,0,34074,16983,17091
Indiana,Whitley County,1,2074,1052,1022
Indiana,Whitley County,2,2097,1055,1042
Indiana,Whitley County,3,2305,1208,1097
Indiana,Whitley County,4,2105,1140,965
Indiana,Whitley County,5,1864,921,943
Indiana,Whitley County,6,2036,1051,985
Indiana,Whitley County,7,1986,1038,948
Indiana,Whitley County,8,1988,966,1022
Indiana,Whitley County,9,2058,1071,987
Indiana,Whitley County,10,2158,1095,1063
Indiana,Whitley County,11,2158,1061,1097
Indiana,Whitley County,12,2631,1305,1326
Indiana,Whitley County,13,2490,1265,1225
Indiana,Whitley County,14,2092,1022,1070
Indiana,Whitley County,15,1546,760,786
Indiana,Whitley County,16,1003,444,559
Indiana,Whitley County,17,688,291,397
Indiana,Whitley County,18,795,238,557
Iowa,Adair County,0,7063,3509,3554
Iowa,Adair County,1,384,207,177
Iowa,Adair County,2,422,213,209
Iowa,Adair County,3,438,215,223
Iowa,Adair County,4,407,204,203
Iowa,Adair County,5,337,184,153
Iowa,Adair County,6,381,199,182
Iowa,Adair County,7,406,209,197
Iowa,Adair County,8,404,205,199
Iowa,Adair County,9,346,164,182
Iowa,Adair County,10,367,185,182
Iowa,Adair County,11,439,223,216
Iowa,Adair County,12,593,299,294
Iowa,Adair County,13,536,293,243
Iowa,Adair County,14,470,230,240
Iowa,Adair County,15,335,164,171
Iowa,Adair County,16,265,111,154
Iowa,Adair County,17,218,84,134
Iowa,Adair County,18,315,120,195
Iowa,Adams County,0,3645,1825,1820
Iowa,Adams County,1,212,115,97
Iowa,Adams County,2,215,112,103
Iowa,Adams County,3,222,97,125
Iowa,Adams County,4,195,112,83
Iowa,Adams County,5,152,73,79
Iowa,Adams County,6,203,104,99
Iowa,Adams County,7,195,105,90
Iowa,Adams County,8,200,104,96
Iowa,Adams County,9,169,78,91
Iowa,Adams County,10,192,106,86
Iowa,Adams County,11,219,93,126
Iowa,Adams County,12,344,182,162
Iowa,Adams County,13,286,143,143
Iowa,Adams County,14,246,131,115
Iowa,Adams County,15,201,103,98
Iowa,Adams County,16,171,84,87
Iowa,Adams County,17,108,40,68
Iowa,Adams County,18,115,43,72
Iowa,Allamakee County,0,13832,7019,6813
Iowa,Allamakee County,1,958,489,469
Iowa,Allamakee County,2,879,441,438
Iowa,Allamakee County,3,904,482,422
Iowa,Allamakee County,4,778,382,396
Iowa,Allamakee County,5,689,374,315
Iowa,Allamakee County,6,710,377,333
Iowa,Allamakee County,7,683,354,329
Iowa,Allamakee County,8,738,383,355
Iowa,Allamakee County,9,652,341,311
Iowa,Allamakee County,10,707,352,355
Iowa,Allamakee County,11,865,443,422
Iowa,Allamakee County,12,1050,524,526
Iowa,Allamakee County,13,1076,559,517
Iowa,Allamakee County,14,997,512,485
Iowa,Allamakee County,15,751,373,378
Iowa,Allamakee County,16,557,285,272
Iowa,Allamakee County,17,425,198,227
Iowa,Allamakee County,18,413,150,263
Iowa,Appanoose County,0,12437,6143,6294
Iowa,Appanoose County,1,709,373,336
Iowa,Appanoose County,2,773,390,383
Iowa,Appanoose County,3,813,422,391
Iowa,Appanoose County,4,720,370,350
Iowa,Appanoose County,5,612,332,280
Iowa,Appanoose County,6,648,312,336
Iowa,Appanoose County,7,611,294,317
Iowa,Appanoose County,8,702,347,355
Iowa,Appanoose County,9,628,310,318
Iowa,Appanoose County,10,699,338,361
Iowa,Appanoose County,11,793,433,360
Iowa,Appanoose County,12,903,432,471
Iowa,Appanoose County,13,1003,524,479
Iowa,Appanoose County,14,824,392,432
Iowa,Appanoose County,15,717,340,377
Iowa,Appanoose County,16,515,237,278
Iowa,Appanoose County,17,346,152,194
Iowa,Appanoose County,18,421,145,276
Iowa,Audubon County,0,5506,2673,2833
Iowa,Audubon County,1,333,169,164
Iowa,Audubon County,2,298,165,133
Iowa,Audubon County,3,310,147,163
Iowa,Audubon County,4,288,138,150
Iowa,Audubon County,5,280,138,142
Iowa,Audubon County,6,279,138,141
Iowa,Audubon County,7,249,115,134
Iowa,Audubon County,8,277,145,132
Iowa,Audubon County,9,259,137,122
Iowa,Audubon County,10,281,137,144
Iowa,Audubon County,11,347,173,174
Iowa,Audubon County,12,499,250,249
Iowa,Audubon County,13,444,229,215
Iowa,Audubon County,14,363,181,182
Iowa,Audubon County,15,295,140,155
Iowa,Audubon County,16,249,113,136
Iowa,Audubon County,17,188,86,102
Iowa,Audubon County,18,267,72,195
Iowa,Benton County,0,25642,12785,12857
Iowa,Benton County,1,1554,791,763
Iowa,Benton County,2,1607,795,812
Iowa,Benton County,3,1759,892,867
Iowa,Benton County,4,1590,791,799
Iowa,Benton County,5,1309,716,593
Iowa,Benton County,6,1288,667,621
Iowa,Benton County,7,1361,693,668
Iowa,Benton County,8,1538,774,764
Iowa,Benton County,9,1499,738,761
Iowa,Benton County,10,1550,763,787
Iowa,Benton County,11,1912,947,965
Iowa,Benton County,12,2081,1025,1056
Iowa,Benton County,13,1827,966,861
Iowa,Benton County,14,1410,720,690
Iowa,Benton County,15,1154,541,613
Iowa,Benton County,16,869,429,440
Iowa,Benton County,17,601,262,339
Iowa,Benton County,18,733,275,458
Iowa,Black Hawk County,0,132408,65095,67313
Iowa,Black Hawk County,1,8367,4288,4079
Iowa,Black Hawk County,2,8066,4162,3904
Iowa,Black Hawk County,3,7873,4037,3836
Iowa,Black Hawk County,4,9049,4236,4813
Iowa,Black Hawk County,5,15023,7332,7691
Iowa,Black Hawk County,6,9333,4911,4422
Iowa,Black Hawk County,7,8006,4095,3911
Iowa,Black Hawk County,8,8092,4089,4003
Iowa,Black Hawk County,9,6961,3551,3410
Iowa,Black Hawk County,10,6770,3408,3362
Iowa,Black Hawk County,11,7014,3506,3508
Iowa,Black Hawk County,12,7862,3794,4068
Iowa,Black Hawk County,13,8273,3968,4305
Iowa,Black Hawk County,14,7191,3478,3713
Iowa,Black Hawk County,15,5162,2437,2725
Iowa,Black Hawk County,16,3643,1674,1969
Iowa,Black Hawk County,17,2637,1046,1591
Iowa,Black Hawk County,18,3086,1083,2003
Iowa,Boone County,0,26346,13312,13034
Iowa,Boone County,1,1388,707,681
Iowa,Boone County,2,1479,734,745
Iowa,Boone County,3,1645,896,749
Iowa,Boone County,4,1634,955,679
Iowa,Boone County,5,1428,735,693
Iowa,Boone County,6,1596,814,782
Iowa,Boone County,7,1618,835,783
Iowa,Boone County,8,1737,906,831
Iowa,Boone County,9,1564,774,790
Iowa,Boone County,10,1594,819,775
Iowa,Boone County,11,1724,891,833
Iowa,Boone County,12,2063,1008,1055
Iowa,Boone County,13,2022,1004,1018
Iowa,Boone County,14,1659,855,804
Iowa,Boone County,15,1146,550,596
Iowa,Boone County,16,774,350,424
Iowa,Boone County,17,576,253,323
Iowa,Boone County,18,699,226,473
Iowa,Bremer County,0,24947,12348,12599
Iowa,Bremer County,1,1423,741,682
Iowa,Bremer County,2,1504,788,716
Iowa,Bremer County,3,1682,871,811
Iowa,Bremer County,4,1959,989,970
Iowa,Bremer County,5,1934,977,957
Iowa,Bremer County,6,1263,644,619
Iowa,Bremer County,7,1308,634,674
Iowa,Bremer County,8,1593,803,790
Iowa,Bremer County,9,1412,711,701
Iowa,Bremer County,10,1413,723,690
Iowa,Bremer County,11,1428,711,717
Iowa,Bremer County,12,1593,794,799
Iowa,Bremer County,13,1549,752,797
Iowa,Bremer County,14,1392,698,694
Iowa,Bremer County,15,1177,554,623
Iowa,Bremer County,16,917,406,511
Iowa,Bremer County,17,641,297,344
Iowa,Bremer County,18,759,255,504
Iowa,Buchanan County,0,21199,10542,10657
Iowa,Buchanan County,1,1386,702,684
Iowa,Buchanan County,2,1494,743,751
Iowa,Buchanan County,3,1647,818,829
Iowa,Buchanan County,4,1466,776,690
Iowa,Buchanan County,5,1013,532,481
Iowa,Buchanan County,6,1187,602,585
Iowa,Buchanan County,7,1236,619,617
Iowa,Buchanan County,8,1379,724,655
Iowa,Buchanan County,9,1186,614,572
Iowa,Buchanan County,10,1182,603,579
Iowa,Buchanan County,11,1317,624,693
Iowa,Buchanan County,12,1534,768,766
Iowa,Buchanan County,13,1386,667,719
Iowa,Buchanan County,14,1186,603,583
Iowa,Buchanan County,15,935,429,506
Iowa,Buchanan County,16,693,325,368
Iowa,Buchanan County,17,466,220,246
Iowa,Buchanan County,18,506,173,333
Iowa,Buena Vista County,0,19874,10095,9779
Iowa,Buena Vista County,1,1482,763,719
Iowa,Buena Vista County,2,1414,698,716
Iowa,Buena Vista County,3,1375,710,665
Iowa,Buena Vista County,4,1437,737,700
Iowa,Buena Vista County,5,1450,768,682
Iowa,Buena Vista County,6,1318,698,620
Iowa,Buena Vista County,7,1257,678,579
Iowa,Buena Vista County,8,1246,658,588
Iowa,Buena Vista County,9,1027,527,500
Iowa,Buena Vista County,10,1007,512,495
Iowa,Buena Vista County,11,1098,553,545
Iowa,Buena Vista County,12,1304,647,657
Iowa,Buena Vista County,13,1261,663,598
Iowa,Buena Vista County,14,1017,523,494
Iowa,Buena Vista County,15,702,346,356
Iowa,Buena Vista County,16,530,244,286
Iowa,Buena Vista County,17,396,175,221
Iowa,Buena Vista County,18,553,195,358
Iowa,Butler County,0,14539,7257,7282
Iowa,Butler County,1,737,377,360
Iowa,Butler County,2,915,479,436
Iowa,Butler County,3,1063,556,507
Iowa,Butler County,4,838,432,406
Iowa,Butler County,5,780,435,345
Iowa,Butler County,6,684,377,307
Iowa,Butler County,7,730,356,374
Iowa,Butler County,8,922,445,477
Iowa,Butler County,9,790,404,386
Iowa,Butler County,10,798,401,397
Iowa,Butler County,11,928,436,492
Iowa,Butler County,12,1007,499,508
Iowa,Butler County,13,1100,571,529
Iowa,Butler County,14,962,473,489
Iowa,Butler County,15,776,390,386
Iowa,Butler County,16,555,255,300
Iowa,Butler County,17,411,168,243
Iowa,Butler County,18,543,203,340
Iowa,Calhoun County,0,9699,5005,4694
Iowa,Calhoun County,1,556,269,287
Iowa,Calhoun County,2,615,323,292
Iowa,Calhoun County,3,574,291,283
Iowa,Calhoun County,4,523,289,234
Iowa,Calhoun County,5,525,323,202
Iowa,Calhoun County,6,561,317,244
Iowa,Calhoun County,7,552,305,247
Iowa,Calhoun County,8,561,303,258
Iowa,Calhoun County,9,515,305,210
Iowa,Calhoun County,10,473,238,235
Iowa,Calhoun County,11,553,294,259
Iowa,Calhoun County,12,690,352,338
Iowa,Calhoun County,13,776,399,377
Iowa,Calhoun County,14,629,319,310
Iowa,Calhoun County,15,500,226,274
Iowa,Calhoun County,16,366,171,195
Iowa,Calhoun County,17,335,148,187
Iowa,Calhoun County,18,395,133,262
Iowa,Carroll County,0,20154,9924,10230
Iowa,Carroll County,1,1327,674,653
Iowa,Carroll County,2,1406,711,695
Iowa,Carroll County,3,1415,742,673
Iowa,Carroll County,4,1204,608,596
Iowa,Carroll County,5,1104,565,539
Iowa,Carroll County,6,1044,513,531
Iowa,Carroll County,7,1102,558,544
Iowa,Carroll County,8,1114,582,532
Iowa,Carroll County,9,1079,536,543
Iowa,Carroll County,10,1067,524,543
Iowa,Carroll County,11,1269,662,607
Iowa,Carroll County,12,1489,748,741
Iowa,Carroll County,13,1439,708,731
Iowa,Carroll County,14,1221,610,611
Iowa,Carroll County,15,827,381,446
Iowa,Carroll County,16,703,307,396
Iowa,Carroll County,17,594,232,362
Iowa,Carroll County,18,750,263,487
Iowa,Cass County,0,12930,6368,6562
Iowa,Cass County,1,691,348,343
Iowa,Cass County,2,789,399,390
Iowa,Cass County,3,906,492,414
Iowa,Cass County,4,765,407,358
Iowa,Cass County,5,614,322,292
Iowa,Cass County,6,706,361,345
Iowa,Cass County,7,611,318,293
Iowa,Cass County,8,717,360,357
Iowa,Cass County,9,687,343,344
Iowa,Cass County,10,682,358,324
Iowa,Cass County,11,778,385,393
Iowa,Cass County,12,1005,477,528
Iowa,Cass County,13,982,496,486
Iowa,Cass County,14,842,394,448
Iowa,Cass County,15,695,332,363
Iowa,Cass County,16,560,244,316
Iowa,Cass County,17,430,187,243
Iowa,Cass County,18,470,145,325
Iowa,Cedar County,0,18627,9271,9356
Iowa,Cedar County,1,979,503,476
Iowa,Cedar County,2,1095,566,529
Iowa,Cedar County,3,1241,631,610
Iowa,Cedar County,4,1169,588,581
Iowa,Cedar County,5,903,471,432
Iowa,Cedar County,6,984,492,492
Iowa,Cedar County,7,993,505,488
Iowa,Cedar County,8,1178,597,581
Iowa,Cedar County,9,1147,579,568
Iowa,Cedar County,10,1123,589,534
Iowa,Cedar County,11,1256,611,645
Iowa,Cedar County,12,1522,754,768
Iowa,Cedar County,13,1367,700,667
Iowa,Cedar County,14,1163,595,568
Iowa,Cedar County,15,838,400,438
Iowa,Cedar County,16,607,287,320
Iowa,Cedar County,17,470,202,268
Iowa,Cedar County,18,592,201,391
Iowa,Cerro Gordo County,0,42647,20870,21777
Iowa,Cerro Gordo County,1,2344,1163,1181
Iowa,Cerro Gordo County,2,2447,1293,1154
Iowa,Cerro Gordo County,3,2571,1313,1258
Iowa,Cerro Gordo County,4,2469,1334,1135
Iowa,Cerro Gordo County,5,2367,1210,1157
Iowa,Cerro Gordo County,6,2488,1263,1225
Iowa,Cerro Gordo County,7,2294,1145,1149
Iowa,Cerro Gordo County,8,2481,1308,1173
Iowa,Cerro Gordo County,9,2205,1090,1115
Iowa,Cerro Gordo County,10,2310,1126,1184
Iowa,Cerro Gordo County,11,2666,1314,1352
Iowa,Cerro Gordo County,12,3399,1655,1744
Iowa,Cerro Gordo County,13,3320,1597,1723
Iowa,Cerro Gordo County,14,2909,1452,1457
Iowa,Cerro Gordo County,15,2108,944,1164
Iowa,Cerro Gordo County,16,1536,681,855
Iowa,Cerro Gordo County,17,1208,502,706
Iowa,Cerro Gordo County,18,1525,480,1045
Iowa,Cherokee County,0,11321,5692,5629
Iowa,Cherokee County,1,655,357,298
Iowa,Cherokee County,2,700,354,346
Iowa,Cherokee County,3,717,370,347
Iowa,Cherokee County,4,597,301,296
Iowa,Cherokee County,5,502,270,232
Iowa,Cherokee County,6,616,310,306
Iowa,Cherokee County,7,588,307,281
Iowa,Cherokee County,8,611,323,288
Iowa,Cherokee County,9,524,271,253
Iowa,Cherokee County,10,588,322,266
Iowa,Cherokee County,11,657,333,324
Iowa,Cherokee County,12,910,462,448
Iowa,Cherokee County,13,935,465,470
Iowa,Cherokee County,14,793,419,374
Iowa,Cherokee County,15,552,269,283
Iowa,Cherokee County,16,463,207,256
Iowa,Cherokee County,17,361,145,216
Iowa,Cherokee County,18,552,207,345
Iowa,Chickasaw County,0,11964,6055,5909
Iowa,Chickasaw County,1,720,378,342
Iowa,Chickasaw County,2,766,381,385
Iowa,Chickasaw County,3,832,422,410
Iowa,Chickasaw County,4,737,384,353
Iowa,Chickasaw County,5,644,357,287
Iowa,Chickasaw County,6,598,305,293
Iowa,Chickasaw County,7,551,279,272
Iowa,Chickasaw County,8,700,361,339
Iowa,Chickasaw County,9,615,305,310
Iowa,Chickasaw County,10,645,343,302
Iowa,Chickasaw County,11,788,399,389
Iowa,Chickasaw County,12,937,487,450
Iowa,Chickasaw County,13,946,508,438
Iowa,Chickasaw County,14,753,371,382
Iowa,Chickasaw County,15,582,268,314
Iowa,Chickasaw County,16,442,208,234
Iowa,Chickasaw County,17,344,163,181
Iowa,Chickasaw County,18,364,136,228
Iowa,Clarke County,0,9423,4772,4651
Iowa,Clarke County,1,665,339,326
Iowa,Clarke County,2,681,369,312
Iowa,Clarke County,3,715,382,333
Iowa,Clarke County,4,577,291,286
Iowa,Clarke County,5,476,243,233
Iowa,Clarke County,6,518,277,241
Iowa,Clarke County,7,552,286,266
Iowa,Clarke County,8,565,312,253
Iowa,Clarke County,9,522,258,264
Iowa,Clarke County,10,515,255,260
Iowa,Clarke County,11,565,307,258
Iowa,Clarke County,12,679,335,344
Iowa,Clarke County,13,650,342,308
Iowa,Clarke County,14,561,277,284
Iowa,Clarke County,15,401,194,207
Iowa,Clarke County,16,295,125,170
Iowa,Clarke County,17,214,89,125
Iowa,Clarke County,18,272,91,181
Iowa,Clay County,0,16134,7936,8198
Iowa,Clay County,1,983,504,479
Iowa,Clay County,2,1000,503,497
Iowa,Clay County,3,1071,534,537
Iowa,Clay County,4,933,462,471
Iowa,Clay County,5,804,405,399
Iowa,Clay County,6,927,499,428
Iowa,Clay County,7,932,457,475
Iowa,Clay County,8,1033,526,507
Iowa,Clay County,9,892,424,468
Iowa,Clay County,10,874,454,420
Iowa,Clay County,11,936,472,464
Iowa,Clay County,12,1173,573,600
Iowa,Clay County,13,1232,612,620
Iowa,Clay County,14,978,486,492
Iowa,Clay County,15,726,337,389
Iowa,Clay County,16,597,287,310
Iowa,Clay County,17,424,198,226
Iowa,Clay County,18,619,203,416
Iowa,Clayton County,0,17556,8885,8671
Iowa,Clayton County,1,964,496,468
Iowa,Clayton County,2,1002,530,472
Iowa,Clayton County,3,1116,576,540
Iowa,Clayton County,4,980,510,470
Iowa,Clayton County,5,824,408,416
Iowa,Clayton County,6,881,452,429
Iowa,Clayton County,7,858,444,414
Iowa,Clayton County,8,910,484,426
Iowa,Clayton County,9,842,438,404
Iowa,Clayton County,10,960,514,446
Iowa,Clayton County,11,1069,556,513
Iowa,Clayton County,12,1469,726,743
Iowa,Clayton County,13,1508,780,728
Iowa,Clayton County,14,1296,671,625
Iowa,Clayton County,15,950,488,462
Iowa,Clayton County,16,731,348,383
Iowa,Clayton County,17,541,241,300
Iowa,Clayton County,18,655,223,432
Iowa,Clinton County,0,46518,22844,23674
Iowa,Clinton County,1,2773,1388,1385
Iowa,Clinton County,2,2954,1528,1426
Iowa,Clinton County,3,3026,1571,1455
Iowa,Clinton County,4,2841,1436,1405
Iowa,Clinton County,5,2528,1243,1285
Iowa,Clinton County,6,2656,1316,1340
Iowa,Clinton County,7,2509,1255,1254
Iowa,Clinton County,8,2683,1312,1371
Iowa,Clinton County,9,2560,1285,1275
Iowa,Clinton County,10,2713,1338,1375
Iowa,Clinton County,11,3096,1569,1527
Iowa,Clinton County,12,3655,1797,1858
Iowa,Clinton County,13,3364,1662,1702
Iowa,Clinton County,14,2771,1357,1414
Iowa,Clinton County,15,2219,1053,1166
Iowa,Clinton County,16,1660,779,881
Iowa,Clinton County,17,1214,525,689
Iowa,Clinton County,18,1296,430,866
Iowa,Crawford County,0,17158,8767,8391
Iowa,Crawford County,1,1195,591,604
Iowa,Crawford County,2,1209,618,591
Iowa,Crawford County,3,1187,607,580
Iowa,Crawford County,4,1230,649,581
Iowa,Crawford County,5,1062,542,520
Iowa,Crawford County,6,1006,518,488
Iowa,Crawford County,7,1050,567,483
Iowa,Crawford County,8,1013,578,435
Iowa,Crawford County,9,956,497,459
Iowa,Crawford County,10,995,508,487
Iowa,Crawford County,11,970,489,481
Iowa,Crawford County,12,1189,638,551
Iowa,Crawford County,13,1090,569,521
Iowa,Crawford County,14,892,466,426
Iowa,Crawford County,15,721,354,367
Iowa,Crawford County,16,552,273,279
Iowa,Crawford County,17,364,146,218
Iowa,Crawford County,18,477,157,320
Iowa,Dallas County,0,90180,44496,45684
Iowa,Dallas County,1,6945,3552,3393
Iowa,Dallas County,2,7373,3783,3590
Iowa,Dallas County,3,6915,3520,3395
Iowa,Dallas County,4,5686,2864,2822
Iowa,Dallas County,5,4642,2323,2319
Iowa,Dallas County,6,6030,2986,3044
Iowa,Dallas County,7,6998,3425,3573
Iowa,Dallas County,8,7947,3984,3963
Iowa,Dallas County,9,6440,3300,3140
Iowa,Dallas County,10,6074,3041,3033
Iowa,Dallas County,11,5339,2714,2625
Iowa,Dallas County,12,4821,2387,2434
Iowa,Dallas County,13,4157,1944,2213
Iowa,Dallas County,14,3649,1688,1961
Iowa,Dallas County,15,2637,1216,1421
Iowa,Dallas County,16,1774,794,980
Iowa,Dallas County,17,1286,507,779
Iowa,Dallas County,18,1467,468,999
Iowa,Davis County,0,9017,4462,4555
Iowa,Davis County,1,809,400,409
Iowa,Davis County,2,688,322,366
Iowa,Davis County,3,745,376,369
Iowa,Davis County,4,601,291,310
Iowa,Davis County,5,486,268,218
Iowa,Davis County,6,511,267,244
Iowa,Davis County,7,463,227,236
Iowa,Davis County,8,504,254,250
Iowa,Davis County,9,472,240,232
Iowa,Davis County,10,487,252,235
Iowa,Davis County,11,480,235,245
Iowa,Davis County,12,594,303,291
Iowa,Davis County,13,564,292,272
Iowa,Davis County,14,501,244,257
Iowa,Davis County,15,351,174,177
Iowa,Davis County,16,295,133,162
Iowa,Davis County,17,223,100,123
Iowa,Davis County,18,243,84,159
Iowa,Decatur County,0,7890,3940,3950
Iowa,Decatur County,1,508,263,245
Iowa,Decatur County,2,444,218,226
Iowa,Decatur County,3,487,246,241
Iowa,Decatur County,4,709,365,344
Iowa,Decatur County,5,933,508,425
Iowa,Decatur County,6,389,198,191
Iowa,Decatur County,7,353,174,179
Iowa,Decatur County,8,387,207,180
Iowa,Decatur County,9,353,175,178
Iowa,Decatur County,10,381,195,186
Iowa,Decatur County,11,358,176,182
Iowa,Decatur County,12,492,244,248
Iowa,Decatur County,13,512,248,264
Iowa,Decatur County,14,458,243,215
Iowa,Decatur County,15,376,183,193
Iowa,Decatur County,16,277,120,157
Iowa,Decatur County,17,207,84,123
Iowa,Decatur County,18,266,93,173
Iowa,Delaware County,0,17069,8611,8458
Iowa,Delaware County,1,1075,552,523
Iowa,Delaware County,2,1057,537,520
Iowa,Delaware County,3,1188,604,584
Iowa,Delaware County,4,1080,560,520
Iowa,Delaware County,5,927,475,452
Iowa,Delaware County,6,819,441,378
Iowa,Delaware County,7,841,432,409
Iowa,Delaware County,8,996,513,483
Iowa,Delaware County,9,876,434,442
Iowa,Delaware County,10,993,503,490
Iowa,Delaware County,11,1141,590,551
Iowa,Delaware County,12,1447,702,745
Iowa,Delaware County,13,1337,697,640
Iowa,Delaware County,14,1017,529,488
Iowa,Delaware County,15,717,355,362
Iowa,Delaware County,16,588,280,308
Iowa,Delaware County,17,491,233,258
Iowa,Delaware County,18,479,174,305
Iowa,Des Moines County,0,39138,19041,20097
Iowa,Des Moines County,1,2309,1147,1162
Iowa,Des Moines County,2,2466,1261,1205
Iowa,Des Moines County,3,2556,1291,1265
Iowa,Des Moines County,4,2268,1137,1131
Iowa,Des Moines County,5,2100,1085,1015
Iowa,Des Moines County,6,2271,1150,1121
Iowa,Des Moines County,7,2118,998,1120
Iowa,Des Moines County,8,2461,1207,1254
Iowa,Des Moines County,9,2106,1070,1036
Iowa,Des Moines County,10,2305,1133,1172
Iowa,Des Moines County,11,2429,1198,1231
Iowa,Des Moines County,12,2837,1378,1459
Iowa,Des Moines County,13,2762,1366,1396
Iowa,Des Moines County,14,2538,1245,1293
Iowa,Des Moines County,15,1918,879,1039
Iowa,Des Moines County,16,1483,689,794
Iowa,Des Moines County,17,1005,396,609
Iowa,Des Moines County,18,1206,411,795
Iowa,Dickinson County,0,17153,8521,8632
Iowa,Dickinson County,1,826,418,408
Iowa,Dickinson County,2,913,483,430
Iowa,Dickinson County,3,978,507,471
Iowa,Dickinson County,4,876,458,418
Iowa,Dickinson County,5,777,403,374
Iowa,Dickinson County,6,889,461,428
Iowa,Dickinson County,7,841,443,398
Iowa,Dickinson County,8,920,469,451
Iowa,Dickinson County,9,897,485,412
Iowa,Dickinson County,10,994,495,499
Iowa,Dickinson County,11,959,465,494
Iowa,Dickinson County,12,1333,670,663
Iowa,Dickinson County,13,1465,719,746
Iowa,Dickinson County,14,1467,716,751
Iowa,Dickinson County,15,1085,527,558
Iowa,Dickinson County,16,742,340,402
Iowa,Dickinson County,17,549,228,321
Iowa,Dickinson County,18,642,234,408
Iowa,Dubuque County,0,96854,47863,48991
Iowa,Dubuque County,1,6079,3142,2937
Iowa,Dubuque County,2,5971,3030,2941
Iowa,Dubuque County,3,6158,3114,3044
Iowa,Dubuque County,4,6805,3489,3316
Iowa,Dubuque County,5,6762,3486,3276
Iowa,Dubuque County,6,6334,3264,3070
Iowa,Dubuque County,7,5966,3061,2905
Iowa,Dubuque County,8,5801,2981,2820
Iowa,Dubuque County,9,4942,2433,2509
Iowa,Dubuque County,10,5326,2707,2619
Iowa,Dubuque County,11,6087,3029,3058
Iowa,Dubuque County,12,6764,3360,3404
Iowa,Dubuque County,13,6450,3165,3285
Iowa,Dubuque County,14,5567,2739,2828
Iowa,Dubuque County,15,3813,1785,2028
Iowa,Dubuque County,16,3107,1309,1798
Iowa,Dubuque County,17,2305,959,1346
Iowa,Dubuque County,18,2617,810,1807
Iowa,Emmet County,0,9253,4646,4607
Iowa,Emmet County,1,507,261,246
Iowa,Emmet County,2,471,254,217
Iowa,Emmet County,3,543,273,270
Iowa,Emmet County,4,662,316,346
Iowa,Emmet County,5,514,266,248
Iowa,Emmet County,6,571,334,237
Iowa,Emmet County,7,474,239,235
Iowa,Emmet County,8,571,306,265
Iowa,Emmet County,9,509,255,254
Iowa,Emmet County,10,483,245,238
Iowa,Emmet County,11,527,271,256
Iowa,Emmet County,12,691,349,342
Iowa,Emmet County,13,751,393,358
Iowa,Emmet County,14,623,309,314
Iowa,Emmet County,15,420,197,223
Iowa,Emmet County,16,336,162,174
Iowa,Emmet County,17,266,113,153
Iowa,Emmet County,18,334,103,231
Iowa,Fayette County,0,19660,9910,9750
Iowa,Fayette County,1,1076,533,543
Iowa,Fayette County,2,1110,592,518
Iowa,Fayette County,3,1217,648,569
Iowa,Fayette County,4,1283,661,622
Iowa,Fayette County,5,1250,701,549
Iowa,Fayette County,6,1155,598,557
Iowa,Fayette County,7,1027,517,510
Iowa,Fayette County,8,1021,510,511
Iowa,Fayette County,9,934,506,428
Iowa,Fayette County,10,1009,505,504
Iowa,Fayette County,11,1291,682,609
Iowa,Fayette County,12,1549,803,746
Iowa,Fayette County,13,1511,766,745
Iowa,Fayette County,14,1245,611,634
Iowa,Fayette County,15,947,470,477
Iowa,Fayette County,16,776,329,447
Iowa,Fayette County,17,594,256,338
Iowa,Fayette County,18,665,222,443
Iowa,Floyd County,0,15761,7793,7968
Iowa,Floyd County,1,979,531,448
Iowa,Floyd County,2,929,449,480
Iowa,Floyd County,3,1061,551,510
Iowa,Floyd County,4,983,500,483
Iowa,Floyd County,5,873,437,436
Iowa,Floyd County,6,871,448,423
Iowa,Floyd County,7,829,423,406
Iowa,Floyd County,8,861,439,422
Iowa,Floyd County,9,774,382,392
Iowa,Floyd County,10,896,438,458
Iowa,Floyd County,11,1037,516,521
Iowa,Floyd County,12,1173,583,590
Iowa,Floyd County,13,1058,523,535
Iowa,Floyd County,14,1020,469,551
Iowa,Floyd County,15,805,390,415
Iowa,Floyd County,16,662,326,336
Iowa,Floyd County,17,465,208,257
Iowa,Floyd County,18,485,180,305
Iowa,Franklin County,0,10124,5099,5025
Iowa,Franklin County,1,634,296,338
Iowa,Franklin County,2,600,340,260
Iowa,Franklin County,3,725,413,312
Iowa,Franklin County,4,595,279,316
Iowa,Franklin County,5,512,270,242
Iowa,Franklin County,6,525,265,260
Iowa,Franklin County,7,515,262,253
Iowa,Franklin County,8,599,333,266
Iowa,Franklin County,9,515,253,262
Iowa,Franklin County,10,563,287,276
Iowa,Franklin County,11,614,303,311
Iowa,Franklin County,12,761,372,389
Iowa,Franklin County,13,841,436,405
Iowa,Franklin County,14,619,308,311
Iowa,Franklin County,15,487,250,237
Iowa,Franklin County,16,407,197,210
Iowa,Franklin County,17,257,116,141
Iowa,Franklin County,18,355,119,236
Iowa,Fremont County,0,6993,3488,3505
Iowa,Fremont County,1,422,238,184
Iowa,Fremont County,2,420,211,209
Iowa,Fremont County,3,460,227,233
Iowa,Fremont County,4,395,214,181
Iowa,Fremont County,5,330,175,155
Iowa,Fremont County,6,334,173,161
Iowa,Fremont County,7,357,182,175
Iowa,Fremont County,8,389,206,183
Iowa,Fremont County,9,354,170,184
Iowa,Fremont County,10,403,202,201
Iowa,Fremont County,11,415,200,215
Iowa,Fremont County,12,542,267,275
Iowa,Fremont County,13,588,296,292
Iowa,Fremont County,14,507,250,257
Iowa,Fremont County,15,367,178,189
Iowa,Fremont County,16,253,118,135
Iowa,Fremont County,17,211,100,111
Iowa,Fremont County,18,246,81,165
Iowa,Greene County,0,8981,4430,4551
Iowa,Greene County,1,565,295,270
Iowa,Greene County,2,577,286,291
Iowa,Greene County,3,569,305,264
Iowa,Greene County,4,578,299,279
Iowa,Greene County,5,431,215,216
Iowa,Greene County,6,474,237,237
Iowa,Greene County,7,463,244,219
Iowa,Greene County,8,474,231,243
Iowa,Greene County,9,456,240,216
Iowa,Greene County,10,509,269,240
Iowa,Greene County,11,540,279,261
Iowa,Greene County,12,670,319,351
Iowa,Greene County,13,692,329,363
Iowa,Greene County,14,593,304,289
Iowa,Greene County,15,447,211,236
Iowa,Greene County,16,356,166,190
Iowa,Greene County,17,258,101,157
Iowa,Greene County,18,329,100,229
Iowa,Grundy County,0,12304,6072,6232
Iowa,Grundy County,1,681,336,345
Iowa,Grundy County,2,787,384,403
Iowa,Grundy County,3,841,413,428
Iowa,Grundy County,4,774,403,371
Iowa,Grundy County,5,623,324,299
Iowa,Grundy County,6,686,356,330
Iowa,Grundy County,7,647,314,333
Iowa,Grundy County,8,769,410,359
Iowa,Grundy County,9,684,353,331
Iowa,Grundy County,10,696,362,334
Iowa,Grundy County,11,769,382,387
Iowa,Grundy County,12,895,435,460
Iowa,Grundy County,13,883,455,428
Iowa,Grundy County,14,710,344,366
Iowa,Grundy County,15,601,274,327
Iowa,Grundy County,16,495,241,254
Iowa,Grundy County,17,366,164,202
Iowa,Grundy County,18,397,122,275
Iowa,Guthrie County,0,10720,5350,5370
Iowa,Guthrie County,1,586,301,285
Iowa,Guthrie County,2,621,303,318
Iowa,Guthrie County,3,704,364,340
Iowa,Guthrie County,4,728,399,329
Iowa,Guthrie County,5,496,244,252
Iowa,Guthrie County,6,504,260,244
Iowa,Guthrie County,7,526,274,252
Iowa,Guthrie County,8,586,299,287
Iowa,Guthrie County,9,592,309,283
Iowa,Guthrie County,10,617,313,304
Iowa,Guthrie County,11,700,343,357
Iowa,Guthrie County,12,833,432,401
Iowa,Guthrie County,13,820,402,418
Iowa,Guthrie County,14,741,390,351
Iowa,Guthrie County,15,580,272,308
Iowa,Guthrie County,16,396,181,215
Iowa,Guthrie County,17,322,151,171
Iowa,Guthrie County,18,368,113,255
Iowa,Hamilton County,0,14952,7451,7501
Iowa,Hamilton County,1,957,492,465
Iowa,Hamilton County,2,873,434,439
Iowa,Hamilton County,3,1002,527,475
Iowa,Hamilton County,4,879,458,421
Iowa,Hamilton County,5,787,422,365
Iowa,Hamilton County,6,775,386,389
Iowa,Hamilton County,7,831,441,390
Iowa,Hamilton County,8,899,448,451
Iowa,Hamilton County,9,835,416,419
Iowa,Hamilton County,10,849,434,415
Iowa,Hamilton County,11,958,509,449
Iowa,Hamilton County,12,1158,596,562
Iowa,Hamilton County,13,1084,534,550
Iowa,Hamilton County,14,931,453,478
Iowa,Hamilton County,15,692,335,357
Iowa,Hamilton County,16,496,228,268
Iowa,Hamilton County,17,404,162,242
Iowa,Hamilton County,18,542,176,366
Iowa,Hancock County,0,10712,5365,5347
Iowa,Hancock County,1,606,318,288
Iowa,Hancock County,2,579,274,305
Iowa,Hancock County,3,714,374,340
Iowa,Hancock County,4,661,358,303
Iowa,Hancock County,5,551,296,255
Iowa,Hancock County,6,538,279,259
Iowa,Hancock County,7,555,283,272
Iowa,Hancock County,8,605,313,292
Iowa,Hancock County,9,602,304,298
Iowa,Hancock County,10,567,284,283
Iowa,Hancock County,11,614,305,309
Iowa,Hancock County,12,869,431,438
Iowa,Hancock County,13,844,423,421
Iowa,Hancock County,14,742,401,341
Iowa,Hancock County,15,537,260,277
Iowa,Hancock County,16,387,189,198
Iowa,Hancock County,17,340,156,184
Iowa,Hancock County,18,401,117,284
Iowa,Hardin County,0,16868,8467,8401
Iowa,Hardin County,1,844,429,415
Iowa,Hardin County,2,895,459,436
Iowa,Hardin County,3,915,462,453
Iowa,Hardin County,4,1208,699,509
Iowa,Hardin County,5,941,525,416
Iowa,Hardin County,6,891,462,429
Iowa,Hardin County,7,893,461,432
Iowa,Hardin County,8,1008,506,502
Iowa,Hardin County,9,900,457,443
Iowa,Hardin County,10,937,491,446
Iowa,Hardin County,11,1028,501,527
Iowa,Hardin County,12,1295,622,673
Iowa,Hardin County,13,1397,749,648
Iowa,Hardin County,14,1078,551,527
Iowa,Hardin County,15,786,363,423
Iowa,Hardin County,16,678,297,381
Iowa,Hardin County,17,506,198,308
Iowa,Hardin County,18,668,235,433
Iowa,Harrison County,0,14134,7065,7069
Iowa,Harrison County,1,874,430,444
Iowa,Harrison County,2,857,470,387
Iowa,Harrison County,3,942,474,468
Iowa,Harrison County,4,906,445,461
Iowa,Harrison County,5,686,364,322
Iowa,Harrison County,6,741,399,342
Iowa,Harrison County,7,766,383,383
Iowa,Harrison County,8,769,391,378
Iowa,Harrison County,9,790,402,388
Iowa,Harrison County,10,888,450,438
Iowa,Harrison County,11,884,431,453
Iowa,Harrison County,12,1196,608,588
Iowa,Harrison County,13,1050,542,508
Iowa,Harrison County,14,848,426,422
Iowa,Harrison County,15,648,313,335
Iowa,Harrison County,16,535,255,280
Iowa,Harrison County,17,319,139,180
Iowa,Harrison County,18,435,143,292
Iowa,Henry County,0,20067,10349,9718
Iowa,Henry County,1,1144,580,564
Iowa,Henry County,2,1197,620,577
Iowa,Henry County,3,1225,622,603
Iowa,Henry County,4,1346,723,623
Iowa,Henry County,5,1450,797,653
Iowa,Henry County,6,1186,698,488
Iowa,Henry County,7,1207,668,539
Iowa,Henry County,8,1176,654,522
Iowa,Henry County,9,1138,603,535
Iowa,Henry County,10,1234,633,601
Iowa,Henry County,11,1269,653,616
Iowa,Henry County,12,1402,732,670
Iowa,Henry County,13,1287,653,634
Iowa,Henry County,14,1177,587,590
Iowa,Henry County,15,949,444,505
Iowa,Henry County,16,673,300,373
Iowa,Henry County,17,479,211,268
Iowa,Henry County,18,528,171,357
Iowa,Howard County,0,9187,4582,4605
Iowa,Howard County,1,594,299,295
Iowa,Howard County,2,621,308,313
Iowa,Howard County,3,698,373,325
Iowa,Howard County,4,549,273,276
Iowa,Howard County,5,449,243,206
Iowa,Howard County,6,478,226,252
Iowa,Howard County,7,470,233,237
Iowa,Howard County,8,528,276,252
Iowa,Howard County,9,491,256,235
Iowa,Howard County,10,461,234,227
Iowa,Howard County,11,589,297,292
Iowa,Howard County,12,690,345,345
Iowa,Howard County,13,651,336,315
Iowa,Howard County,14,548,291,257
Iowa,Howard County,15,455,216,239
Iowa,Howard County,16,335,153,182
Iowa,Howard County,17,247,101,146
Iowa,Howard County,18,333,122,211
Iowa,Humboldt County,0,9547,4703,4844
Iowa,Humboldt County,1,579,291,288
Iowa,Humboldt County,2,592,299,293
Iowa,Humboldt County,3,696,361,335
Iowa,Humboldt County,4,538,253,285
Iowa,Humboldt County,5,474,256,218
Iowa,Humboldt County,6,466,251,215
Iowa,Humboldt County,7,562,259,303
Iowa,Humboldt County,8,594,320,274
Iowa,Humboldt County,9,449,235,214
Iowa,Humboldt County,10,525,278,247
Iowa,Humboldt County,11,526,253,273
Iowa,Humboldt County,12,769,376,393
Iowa,Humboldt County,13,722,347,375
Iowa,Humboldt County,14,588,296,292
Iowa,Humboldt County,15,433,205,228
Iowa,Humboldt County,16,374,172,202
Iowa,Humboldt County,17,306,130,176
Iowa,Humboldt County,18,354,121,233
Iowa,Ida County,0,6841,3415,3426
Iowa,Ida County,1,411,214,197
Iowa,Ida County,2,486,244,242
Iowa,Ida County,3,487,262,225
Iowa,Ida County,4,402,223,179
Iowa,Ida County,5,368,192,176
Iowa,Ida County,6,314,149,165
Iowa,Ida County,7,381,198,183
Iowa,Ida County,8,383,205,178
Iowa,Ida County,9,351,172,179
Iowa,Ida County,10,320,159,161
Iowa,Ida County,11,385,173,212
Iowa,Ida County,12,524,272,252
Iowa,Ida County,13,510,258,252
Iowa,Ida County,14,450,237,213
Iowa,Ida County,15,337,165,172
Iowa,Ida County,16,256,119,137
Iowa,Ida County,17,210,89,121
Iowa,Ida County,18,266,84,182
Iowa,Iowa County,0,16141,8046,8095
Iowa,Iowa County,1,955,503,452
Iowa,Iowa County,2,1078,559,519
Iowa,Iowa County,3,1094,557,537
Iowa,Iowa County,4,951,485,466
Iowa,Iowa County,5,870,442,428
Iowa,Iowa County,6,858,447,411
Iowa,Iowa County,7,863,435,428
Iowa,Iowa County,8,1001,494,507
Iowa,Iowa County,9,875,468,407
Iowa,Iowa County,10,953,467,486
Iowa,Iowa County,11,1063,555,508
Iowa,Iowa County,12,1305,655,650
Iowa,Iowa County,13,1214,601,613
Iowa,Iowa County,14,908,478,430
Iowa,Iowa County,15,640,306,334
Iowa,Iowa County,16,556,251,305
Iowa,Iowa County,17,429,172,257
Iowa,Iowa County,18,528,171,357
Iowa,Jackson County,0,19432,9698,9734
Iowa,Jackson County,1,1133,586,547
Iowa,Jackson County,2,1117,569,548
Iowa,Jackson County,3,1287,655,632
Iowa,Jackson County,4,1203,627,576
Iowa,Jackson County,5,1013,545,468
Iowa,Jackson County,6,1007,504,503
Iowa,Jackson County,7,962,499,463
Iowa,Jackson County,8,1098,573,525
Iowa,Jackson County,9,986,512,474
Iowa,Jackson County,10,1111,534,577
Iowa,Jackson County,11,1372,677,695
Iowa,Jackson County,12,1581,806,775
Iowa,Jackson County,13,1501,754,747
Iowa,Jackson County,14,1220,601,619
Iowa,Jackson County,15,1021,507,514
Iowa,Jackson County,16,686,306,380
Iowa,Jackson County,17,502,211,291
Iowa,Jackson County,18,632,232,400
Iowa,Jasper County,0,37147,18996,18151
Iowa,Jasper County,1,2093,1078,1015
Iowa,Jasper County,2,2291,1167,1124
Iowa,Jasper County,3,2436,1242,1194
Iowa,Jasper County,4,2276,1184,1092
Iowa,Jasper County,5,1942,1057,885
Iowa,Jasper County,6,2177,1254,923
Iowa,Jasper County,7,2244,1228,1016
Iowa,Jasper County,8,2416,1300,1116
Iowa,Jasper County,9,2166,1193,973
Iowa,Jasper County,10,2347,1295,1052
Iowa,Jasper County,11,2370,1200,1170
Iowa,Jasper County,12,2761,1361,1400
Iowa,Jasper County,13,2519,1301,1218
Iowa,Jasper County,14,2117,996,1121
Iowa,Jasper County,15,1711,828,883
Iowa,Jasper County,16,1249,558,691
Iowa,Jasper County,17,926,380,546
Iowa,Jasper County,18,1106,374,732
Iowa,Jefferson County,0,18381,10127,8254
Iowa,Jefferson County,1,799,394,405
Iowa,Jefferson County,2,740,385,355
Iowa,Jefferson County,3,806,410,396
Iowa,Jefferson County,4,832,432,400
Iowa,Jefferson County,5,1950,1545,405
Iowa,Jefferson County,6,1621,1109,512
Iowa,Jefferson County,7,1103,643,460
Iowa,Jefferson County,8,1048,573,475
Iowa,Jefferson County,9,844,428,416
Iowa,Jefferson County,10,927,473,454
Iowa,Jefferson County,11,918,430,488
Iowa,Jefferson County,12,1148,561,587
Iowa,Jefferson County,13,1526,791,735
Iowa,Jefferson County,14,1649,833,816
Iowa,Jefferson County,15,1064,517,547
Iowa,Jefferson County,16,575,281,294
Iowa,Jefferson County,17,353,149,204
Iowa,Jefferson County,18,478,173,305
Iowa,Johnson County,0,151260,75011,76249
Iowa,Johnson County,1,8834,4508,4326
Iowa,Johnson County,2,8500,4324,4176
Iowa,Johnson County,3,8053,4040,4013
Iowa,Johnson County,4,13078,6225,6853
Iowa,Johnson County,5,23719,11718,12001
Iowa,Johnson County,6,12932,6690,6242
Iowa,Johnson County,7,10289,5403,4886
Iowa,Johnson County,8,9906,5056,4850
Iowa,Johnson County,9,8197,4299,3898
Iowa,Johnson County,10,7740,3916,3824
Iowa,Johnson County,11,7440,3686,3754
Iowa,Johnson County,12,7480,3617,3863
Iowa,Johnson County,13,7356,3551,3805
Iowa,Johnson County,14,6426,3066,3360
Iowa,Johnson County,15,4465,2121,2344
Iowa,Johnson County,16,2817,1266,1551
Iowa,Johnson County,17,1816,764,1052
Iowa,Johnson County,18,2212,761,1451
Iowa,Jones County,0,20744,10715,10029
Iowa,Jones County,1,1073,590,483
Iowa,Jones County,2,1184,611,573
Iowa,Jones County,3,1369,687,682
Iowa,Jones County,4,1221,620,601
Iowa,Jones County,5,1048,587,461
Iowa,Jones County,6,1131,631,500
Iowa,Jones County,7,1241,652,589
Iowa,Jones County,8,1292,706,586
Iowa,Jones County,9,1203,673,530
Iowa,Jones County,10,1249,664,585
Iowa,Jones County,11,1384,734,650
Iowa,Jones County,12,1645,843,802
Iowa,Jones County,13,1431,714,717
Iowa,Jones County,14,1322,727,595
Iowa,Jones County,15,965,454,511
Iowa,Jones County,16,748,356,392
Iowa,Jones County,17,577,252,325
Iowa,Jones County,18,661,214,447
Iowa,Keokuk County,0,10225,5201,5024
Iowa,Keokuk County,1,600,318,282
Iowa,Keokuk County,2,672,355,317
Iowa,Keokuk County,3,654,353,301
Iowa,Keokuk County,4,628,359,269
Iowa,Keokuk County,5,493,253,240
Iowa,Keokuk County,6,557,298,259
Iowa,Keokuk County,7,533,275,258
Iowa,Keokuk County,8,581,299,282
Iowa,Keokuk County,9,546,281,265
Iowa,Keokuk County,10,557,269,288
Iowa,Keokuk County,11,610,315,295
Iowa,Keokuk County,12,804,405,399
Iowa,Keokuk County,13,798,409,389
Iowa,Keokuk County,14,640,341,299
Iowa,Keokuk County,15,488,240,248
Iowa,Keokuk County,16,410,186,224
Iowa,Keokuk County,17,270,112,158
Iowa,Keokuk County,18,384,133,251
Iowa,Kossuth County,0,14908,7507,7401
Iowa,Kossuth County,1,849,442,407
Iowa,Kossuth County,2,870,486,384
Iowa,Kossuth County,3,973,494,479
Iowa,Kossuth County,4,874,445,429
Iowa,Kossuth County,5,758,393,365
Iowa,Kossuth County,6,741,373,368
Iowa,Kossuth County,7,763,409,354
Iowa,Kossuth County,8,813,414,399
Iowa,Kossuth County,9,676,340,336
Iowa,Kossuth County,10,736,374,362
Iowa,Kossuth County,11,885,431,454
Iowa,Kossuth County,12,1243,656,587
Iowa,Kossuth County,13,1189,631,558
Iowa,Kossuth County,14,974,479,495
Iowa,Kossuth County,15,746,368,378
Iowa,Kossuth County,16,621,270,351
Iowa,Kossuth County,17,568,262,306
Iowa,Kossuth County,18,629,240,389
Iowa,Lee County,0,34055,17161,16894
Iowa,Lee County,1,2049,1073,976
Iowa,Lee County,2,2018,1056,962
Iowa,Lee County,3,1961,984,977
Iowa,Lee County,4,1944,1007,937
Iowa,Lee County,5,1811,960,851
Iowa,Lee County,6,2089,1121,968
Iowa,Lee County,7,1936,1043,893
Iowa,Lee County,8,2014,1075,939
Iowa,Lee County,9,1846,970,876
Iowa,Lee County,10,2029,1026,1003
Iowa,Lee County,11,2244,1147,1097
Iowa,Lee County,12,2600,1298,1302
Iowa,Lee County,13,2597,1313,1284
Iowa,Lee County,14,2254,1099,1155
Iowa,Lee County,15,1780,853,927
Iowa,Lee County,16,1206,519,687
Iowa,Lee County,17,775,328,447
Iowa,Lee County,18,902,289,613
Iowa,Linn County,0,225909,111266,114643
Iowa,Linn County,1,14337,7333,7004
Iowa,Linn County,2,14417,7428,6989
Iowa,Linn County,3,14843,7562,7281
Iowa,Linn County,4,14736,7459,7277
Iowa,Linn County,5,14717,7331,7386
Iowa,Linn County,6,15788,7969,7819
Iowa,Linn County,7,15021,7541,7480
Iowa,Linn County,8,15484,7812,7672
Iowa,Linn County,9,13861,6878,6983
Iowa,Linn County,10,14006,7000,7006
Iowa,Linn County,11,14302,7154,7148
Iowa,Linn County,12,15025,7397,7628
Iowa,Linn County,13,13670,6695,6975
Iowa,Linn County,14,11547,5415,6132
Iowa,Linn County,15,8882,4140,4742
Iowa,Linn County,16,6097,2679,3418
Iowa,Linn County,17,4484,1857,2627
Iowa,Linn County,18,4692,1616,3076
Iowa,Louisa County,0,11169,5700,5469
Iowa,Louisa County,1,683,357,326
Iowa,Louisa County,2,673,332,341
Iowa,Louisa County,3,699,385,314
Iowa,Louisa County,4,726,408,318
Iowa,Louisa County,5,641,344,297
Iowa,Louisa County,6,630,336,294
Iowa,Louisa County,7,586,288,298
Iowa,Louisa County,8,781,439,342
Iowa,Louisa County,9,660,323,337
Iowa,Louisa County,10,623,342,281
Iowa,Louisa County,11,773,381,392
Iowa,Louisa County,12,880,448,432
Iowa,Louisa County,13,749,367,382
Iowa,Louisa County,14,667,349,318
Iowa,Louisa County,15,490,246,244
Iowa,Louisa County,16,354,156,198
Iowa,Louisa County,17,269,106,163
Iowa,Louisa County,18,285,93,192
Iowa,Lucas County,0,8645,4406,4239
Iowa,Lucas County,1,566,303,263
Iowa,Lucas County,2,518,267,251
Iowa,Lucas County,3,563,287,276
Iowa,Lucas County,4,527,300,227
Iowa,Lucas County,5,478,246,232
Iowa,Lucas County,6,473,258,215
Iowa,Lucas County,7,400,210,190
Iowa,Lucas County,8,451,228,223
Iowa,Lucas County,9,430,219,211
Iowa,Lucas County,10,474,243,231
Iowa,Lucas County,11,561,296,265
Iowa,Lucas County,12,676,342,334
Iowa,Lucas County,13,646,315,331
Iowa,Lucas County,14,574,301,273
Iowa,Lucas County,15,444,220,224
Iowa,Lucas County,16,330,165,165
Iowa,Lucas County,17,261,110,151
Iowa,Lucas County,18,273,96,177
Iowa,Lyon County,0,11811,5994,5817
Iowa,Lyon County,1,901,470,431
Iowa,Lyon County,2,905,483,422
Iowa,Lyon County,3,987,524,463
Iowa,Lyon County,4,817,445,372
Iowa,Lyon County,5,590,324,266
Iowa,Lyon County,6,604,301,303
Iowa,Lyon County,7,617,311,306
Iowa,Lyon County,8,785,408,377
Iowa,Lyon County,9,711,352,359
Iowa,Lyon County,10,615,323,292
Iowa,Lyon County,11,642,330,312
Iowa,Lyon County,12,724,384,340
Iowa,Lyon County,13,773,378,395
Iowa,Lyon County,14,630,328,302
Iowa,Lyon County,15,462,219,243
Iowa,Lyon County,16,350,155,195
Iowa,Lyon County,17,289,118,171
Iowa,Lyon County,18,409,141,268
Iowa,Madison County,0,16249,8114,8135
Iowa,Madison County,1,926,495,431
Iowa,Madison County,2,1109,571,538
Iowa,Madison County,3,1286,681,605
Iowa,Madison County,4,1084,562,522
Iowa,Madison County,5,770,391,379
Iowa,Madison County,6,778,366,412
Iowa,Madison County,7,870,409,461
Iowa,Madison County,8,1056,546,510
Iowa,Madison County,9,1028,520,508
Iowa,Madison County,10,1189,584,605
Iowa,Madison County,11,1135,556,579
Iowa,Madison County,12,1170,590,580
Iowa,Madison County,13,1088,551,537
Iowa,Madison County,14,916,460,456
Iowa,Madison County,15,654,319,335
Iowa,Madison County,16,502,247,255
Iowa,Madison County,17,325,152,173
Iowa,Madison County,18,363,114,249
Iowa,Mahaska County,0,22000,11143,10857
Iowa,Mahaska County,1,1444,731,713
Iowa,Mahaska County,2,1459,752,707
Iowa,Mahaska County,3,1490,803,687
Iowa,Mahaska County,4,1542,878,664
Iowa,Mahaska County,5,1377,745,632
Iowa,Mahaska County,6,1296,654,642
Iowa,Mahaska County,7,1245,625,620
Iowa,Mahaska County,8,1351,696,655
Iowa,Mahaska County,9,1283,649,634
Iowa,Mahaska County,10,1223,607,616
Iowa,Mahaska County,11,1244,651,593
Iowa,Mahaska County,12,1535,771,764
Iowa,Mahaska County,13,1484,758,726
Iowa,Mahaska County,14,1280,644,636
Iowa,Mahaska County,15,913,437,476
Iowa,Mahaska County,16,711,317,394
Iowa,Mahaska County,17,483,220,263
Iowa,Mahaska County,18,640,205,435
Iowa,Marion County,0,33407,16705,16702
Iowa,Marion County,1,1954,984,970
Iowa,Marion County,2,2140,1077,1063
Iowa,Marion County,3,2383,1250,1133
Iowa,Marion County,4,2566,1346,1220
Iowa,Marion County,5,2375,1205,1170
Iowa,Marion County,6,1774,926,848
Iowa,Marion County,7,1819,947,872
Iowa,Marion County,8,2004,1011,993
Iowa,Marion County,9,1896,975,921
Iowa,Marion County,10,1947,984,963
Iowa,Marion County,11,2102,1061,1041
Iowa,Marion County,12,2375,1215,1160
Iowa,Marion County,13,2115,1030,1085
Iowa,Marion County,14,1850,922,928
Iowa,Marion County,15,1412,672,740
Iowa,Marion County,16,1088,483,605
Iowa,Marion County,17,810,344,466
Iowa,Marion County,18,797,273,524
Iowa,Marshall County,0,39981,20231,19750
Iowa,Marshall County,1,2628,1346,1282
Iowa,Marshall County,2,2866,1468,1398
Iowa,Marshall County,3,2979,1571,1408
Iowa,Marshall County,4,2619,1370,1249
Iowa,Marshall County,5,2347,1300,1047
Iowa,Marshall County,6,2381,1234,1147
Iowa,Marshall County,7,2396,1238,1158
Iowa,Marshall County,8,2430,1238,1192
Iowa,Marshall County,9,1992,1032,960
Iowa,Marshall County,10,2287,1173,1114
Iowa,Marshall County,11,2428,1248,1180
Iowa,Marshall County,12,2662,1328,1334
Iowa,Marshall County,13,2694,1351,1343
Iowa,Marshall County,14,2261,1139,1122
Iowa,Marshall County,15,1685,813,872
Iowa,Marshall County,16,1231,555,676
Iowa,Marshall County,17,953,412,541
Iowa,Marshall County,18,1142,415,727
Iowa,Mills County,0,15063,7580,7483
Iowa,Mills County,1,856,425,431
Iowa,Mills County,2,989,505,484
Iowa,Mills County,3,1045,532,513
Iowa,Mills County,4,991,538,453
Iowa,Mills County,5,749,383,366
Iowa,Mills County,6,718,347,371
Iowa,Mills County,7,760,385,375
Iowa,Mills County,8,924,469,455
Iowa,Mills County,9,916,462,454
Iowa,Mills County,10,1032,525,507
Iowa,Mills County,11,1007,499,508
Iowa,Mills County,12,1174,607,567
Iowa,Mills County,13,1128,574,554
Iowa,Mills County,14,980,485,495
Iowa,Mills County,15,758,376,382
Iowa,Mills County,16,428,214,214
Iowa,Mills County,17,295,140,155
Iowa,Mills County,18,313,114,199
Iowa,Mitchell County,0,10569,5268,5301
Iowa,Mitchell County,1,605,292,313
Iowa,Mitchell County,2,674,364,310
Iowa,Mitchell County,3,755,401,354
Iowa,Mitchell County,4,700,351,349
Iowa,Mitchell County,5,557,294,263
Iowa,Mitchell County,6,583,312,271
Iowa,Mitchell County,7,499,243,256
Iowa,Mitchell County,8,588,293,295
Iowa,Mitchell County,9,538,283,255
Iowa,Mitchell County,10,554,280,274
Iowa,Mitchell County,11,682,331,351
Iowa,Mitchell County,12,842,433,409
Iowa,Mitchell County,13,756,393,363
Iowa,Mitchell County,14,614,305,309
Iowa,Mitchell County,15,462,220,242
Iowa,Mitchell County,16,396,179,217
Iowa,Mitchell County,17,328,143,185
Iowa,Mitchell County,18,436,151,285
Iowa,Monona County,0,8679,4235,4444
Iowa,Monona County,1,498,226,272
Iowa,Monona County,2,498,247,251
Iowa,Monona County,3,582,299,283
Iowa,Monona County,4,515,284,231
Iowa,Monona County,5,425,212,213
Iowa,Monona County,6,449,245,204
Iowa,Monona County,7,390,186,204
Iowa,Monona County,8,469,237,232
Iowa,Monona County,9,432,213,219
Iowa,Monona County,10,456,235,221
Iowa,Monona County,11,478,237,241
Iowa,Monona County,12,688,338,350
Iowa,Monona County,13,663,339,324
Iowa,Monona County,14,562,293,269
Iowa,Monona County,15,469,232,237
Iowa,Monona County,16,384,167,217
Iowa,Monona County,17,315,134,181
Iowa,Monona County,18,406,111,295
Iowa,Monroe County,0,7790,3858,3932
Iowa,Monroe County,1,437,222,215
Iowa,Monroe County,2,477,229,248
Iowa,Monroe County,3,594,296,298
Iowa,Monroe County,4,503,269,234
Iowa,Monroe County,5,408,204,204
Iowa,Monroe County,6,391,207,184
Iowa,Monroe County,7,395,201,194
Iowa,Monroe County,8,489,259,230
Iowa,Monroe County,9,421,192,229
Iowa,Monroe County,10,489,254,235
Iowa,Monroe County,11,498,249,249
Iowa,Monroe County,12,562,264,298
Iowa,Monroe County,13,571,296,275
Iowa,Monroe County,14,476,246,230
Iowa,Monroe County,15,398,179,219
Iowa,Monroe County,16,267,119,148
Iowa,Monroe County,17,212,101,111
Iowa,Monroe County,18,202,71,131
Iowa,Montgomery County,0,10003,4876,5127
Iowa,Montgomery County,1,619,299,320
Iowa,Montgomery County,2,583,274,309
Iowa,Montgomery County,3,667,362,305
Iowa,Montgomery County,4,635,330,305
Iowa,Montgomery County,5,522,254,268
Iowa,Montgomery County,6,492,252,240
Iowa,Montgomery County,7,501,257,244
Iowa,Montgomery County,8,520,256,264
Iowa,Montgomery County,9,536,267,269
Iowa,Montgomery County,10,586,286,300
Iowa,Montgomery County,11,624,309,315
Iowa,Montgomery County,12,773,384,389
Iowa,Montgomery County,13,801,401,400
Iowa,Montgomery County,14,661,327,334
Iowa,Montgomery County,15,477,243,234
Iowa,Montgomery County,16,376,155,221
Iowa,Montgomery County,17,253,106,147
Iowa,Montgomery County,18,377,114,263
Iowa,Muscatine County,0,42929,21452,21477
Iowa,Muscatine County,1,2797,1469,1328
Iowa,Muscatine County,2,2944,1502,1442
Iowa,Muscatine County,3,3108,1594,1514
Iowa,Muscatine County,4,2840,1430,1410
Iowa,Muscatine County,5,2504,1310,1194
Iowa,Muscatine County,6,2896,1459,1437
Iowa,Muscatine County,7,2548,1343,1205
Iowa,Muscatine County,8,2699,1352,1347
Iowa,Muscatine County,9,2408,1215,1193
Iowa,Muscatine County,10,2593,1284,1309
Iowa,Muscatine County,11,2642,1338,1304
Iowa,Muscatine County,12,2992,1511,1481
Iowa,Muscatine County,13,2813,1407,1406
Iowa,Muscatine County,14,2348,1122,1226
Iowa,Muscatine County,15,1841,908,933
Iowa,Muscatine County,16,1252,545,707
Iowa,Muscatine County,17,790,350,440
Iowa,Muscatine County,18,914,313,601
Iowa,O'Brien County,0,13840,6927,6913
Iowa,O'Brien County,1,883,442,441
Iowa,O'Brien County,2,891,460,431
Iowa,O'Brien County,3,961,507,454
Iowa,O'Brien County,4,860,457,403
Iowa,O'Brien County,5,771,397,374
Iowa,O'Brien County,6,768,416,352
Iowa,O'Brien County,7,727,387,340
Iowa,O'Brien County,8,811,444,367
Iowa,O'Brien County,9,745,364,381
Iowa,O'Brien County,10,702,364,338
Iowa,O'Brien County,11,780,395,385
Iowa,O'Brien County,12,1038,514,524
Iowa,O'Brien County,13,1044,542,502
Iowa,O'Brien County,14,777,387,390
Iowa,O'Brien County,15,596,292,304
Iowa,O'Brien County,16,453,192,261
Iowa,O'Brien County,17,441,172,269
Iowa,O'Brien County,18,592,195,397
Iowa,Osceola County,0,6040,3082,2958
Iowa,Osceola County,1,349,176,173
Iowa,Osceola County,2,392,207,185
Iowa,Osceola County,3,460,246,214
Iowa,Osceola County,4,364,205,159
Iowa,Osceola County,5,284,138,146
Iowa,Osceola County,6,294,168,126
Iowa,Osceola County,7,291,166,125
Iowa,Osceola County,8,348,185,163
Iowa,Osceola County,9,282,147,135
Iowa,Osceola County,10,336,165,171
Iowa,Osceola County,11,361,181,180
Iowa,Osceola County,12,490,247,243
Iowa,Osceola County,13,490,267,223
Iowa,Osceola County,14,337,171,166
Iowa,Osceola County,15,295,146,149
Iowa,Osceola County,16,244,105,139
Iowa,Osceola County,17,190,77,113
Iowa,Osceola County,18,233,85,148
Iowa,Page County,0,15249,8051,7198
Iowa,Page County,1,794,411,383
Iowa,Page County,2,773,405,368
Iowa,Page County,3,787,433,354
Iowa,Page County,4,866,505,361
Iowa,Page County,5,832,492,340
Iowa,Page County,6,927,549,378
Iowa,Page County,7,876,514,362
Iowa,Page County,8,953,528,425
Iowa,Page County,9,961,566,395
Iowa,Page County,10,943,529,414
Iowa,Page County,11,852,460,392
Iowa,Page County,12,1093,559,534
Iowa,Page County,13,1188,567,621
Iowa,Page County,14,1030,535,495
Iowa,Page County,15,782,366,416
Iowa,Page County,16,582,266,316
Iowa,Page County,17,450,192,258
Iowa,Page County,18,560,174,386
Iowa,Palo Alto County,0,8929,4449,4480
Iowa,Palo Alto County,1,556,310,246
Iowa,Palo Alto County,2,536,255,281
Iowa,Palo Alto County,3,602,310,292
Iowa,Palo Alto County,4,579,319,260
Iowa,Palo Alto County,5,529,296,233
Iowa,Palo Alto County,6,515,242,273
Iowa,Palo Alto County,7,457,255,202
Iowa,Palo Alto County,8,512,256,256
Iowa,Palo Alto County,9,442,233,209
Iowa,Palo Alto County,10,465,229,236
Iowa,Palo Alto County,11,493,242,251
Iowa,Palo Alto County,12,640,341,299
Iowa,Palo Alto County,13,645,315,330
Iowa,Palo Alto County,14,548,275,273
Iowa,Palo Alto County,15,428,201,227
Iowa,Palo Alto County,16,306,141,165
Iowa,Palo Alto County,17,286,107,179
Iowa,Palo Alto County,18,390,122,268
Iowa,Plymouth County,0,25095,12530,12565
Iowa,Plymouth County,1,1632,819,813
Iowa,Plymouth County,2,1687,857,830
Iowa,Plymouth County,3,1856,948,908
Iowa,Plymouth County,4,1677,876,801
Iowa,Plymouth County,5,1410,729,681
Iowa,Plymouth County,6,1271,668,603
Iowa,Plymouth County,7,1324,659,665
Iowa,Plymouth County,8,1560,785,775
Iowa,Plymouth County,9,1463,751,712
Iowa,Plymouth County,10,1487,746,741
Iowa,Plymouth County,11,1551,790,761
Iowa,Plymouth County,12,1830,907,923
Iowa,Plymouth County,13,1736,884,852
Iowa,Plymouth County,14,1434,712,722
Iowa,Plymouth County,15,1086,541,545
Iowa,Plymouth County,16,806,365,441
Iowa,Plymouth County,17,575,263,312
Iowa,Plymouth County,18,710,230,480
Iowa,Pocahontas County,0,6740,3354,3386
Iowa,Pocahontas County,1,392,199,193
Iowa,Pocahontas County,2,419,186,233
Iowa,Pocahontas County,3,457,230,227
Iowa,Pocahontas County,4,406,211,195
Iowa,Pocahontas County,5,318,152,166
Iowa,Pocahontas County,6,331,176,155
Iowa,Pocahontas County,7,336,183,153
Iowa,Pocahontas County,8,349,173,176
Iowa,Pocahontas County,9,329,180,149
Iowa,Pocahontas County,10,310,156,154
Iowa,Pocahontas County,11,414,210,204
Iowa,Pocahontas County,12,560,273,287
Iowa,Pocahontas County,13,567,307,260
Iowa,Pocahontas County,14,450,229,221
Iowa,Pocahontas County,15,342,174,168
Iowa,Pocahontas County,16,296,120,176
Iowa,Pocahontas County,17,219,102,117
Iowa,Pocahontas County,18,245,93,152
Iowa,Polk County,0,487204,240245,246959
Iowa,Polk County,1,34762,17855,16907
Iowa,Polk County,2,33615,17121,16494
Iowa,Polk County,3,33844,17204,16640
Iowa,Polk County,4,30651,15448,15203
Iowa,Polk County,5,30928,15357,15571
Iowa,Polk County,6,38522,19303,19219
Iowa,Polk County,7,36938,18751,18187
Iowa,Polk County,8,35926,18074,17852
Iowa,Polk County,9,30505,15438,15067
Iowa,Polk County,10,30809,15486,15323
Iowa,Polk County,11,29495,14722,14773
Iowa,Polk County,12,30723,15001,15722
Iowa,Polk County,13,26855,12804,14051
Iowa,Polk County,14,22199,10345,11854
Iowa,Polk County,15,15829,7214,8615
Iowa,Polk County,16,10504,4618,5886
Iowa,Polk County,17,6854,2749,4105
Iowa,Polk County,18,8245,2755,5490
Iowa,Pottawattamie County,0,93533,46030,47503
Iowa,Pottawattamie County,1,5858,2948,2910
Iowa,Pottawattamie County,2,6203,3244,2959
Iowa,Pottawattamie County,3,6237,3214,3023
Iowa,Pottawattamie County,4,6224,3251,2973
Iowa,Pottawattamie County,5,5357,2763,2594
Iowa,Pottawattamie County,6,5800,2904,2896
Iowa,Pottawattamie County,7,5562,2724,2838
Iowa,Pottawattamie County,8,5880,2938,2942
Iowa,Pottawattamie County,9,5390,2724,2666
Iowa,Pottawattamie County,10,5536,2728,2808
Iowa,Pottawattamie County,11,5757,2866,2891
Iowa,Pottawattamie County,12,6918,3340,3578
Iowa,Pottawattamie County,13,6476,3112,3364
Iowa,Pottawattamie County,14,5446,2646,2800
Iowa,Pottawattamie County,15,3980,1841,2139
Iowa,Pottawattamie County,16,2793,1240,1553
Iowa,Pottawattamie County,17,1955,778,1177
Iowa,Pottawattamie County,18,2161,769,1392
Iowa,Poweshiek County,0,18699,9061,9638
Iowa,Poweshiek County,1,926,497,429
Iowa,Poweshiek County,2,997,474,523
Iowa,Poweshiek County,3,1067,543,524
Iowa,Poweshiek County,4,1617,807,810
Iowa,Poweshiek County,5,1917,918,999
Iowa,Poweshiek County,6,897,453,444
Iowa,Poweshiek County,7,930,450,480
Iowa,Poweshiek County,8,919,471,448
Iowa,Poweshiek County,9,917,451,466
Iowa,Poweshiek County,10,971,505,466
Iowa,Poweshiek County,11,1083,528,555
Iowa,Poweshiek County,12,1297,624,673
Iowa,Poweshiek County,13,1274,615,659
Iowa,Poweshiek County,14,1153,558,595
Iowa,Poweshiek County,15,891,436,455
Iowa,Poweshiek County,16,683,287,396
Iowa,Poweshiek County,17,537,235,302
Iowa,Poweshiek County,18,623,209,414
Iowa,Ringgold County,0,4968,2454,2514
Iowa,Ringgold County,1,303,177,126
Iowa,Ringgold County,2,298,149,149
Iowa,Ringgold County,3,348,185,163
Iowa,Ringgold County,4,325,163,162
Iowa,Ringgold County,5,222,120,102
Iowa,Ringgold County,6,211,101,110
Iowa,Ringgold County,7,271,133,138
Iowa,Ringgold County,8,261,134,127
Iowa,Ringgold County,9,243,128,115
Iowa,Ringgold County,10,236,116,120
Iowa,Ringgold County,11,300,148,152
Iowa,Ringgold County,12,349,167,182
Iowa,Ringgold County,13,382,194,188
Iowa,Ringgold County,14,326,161,165
Iowa,Ringgold County,15,276,140,136
Iowa,Ringgold County,16,214,104,110
Iowa,Ringgold County,17,154,63,91
Iowa,Ringgold County,18,249,71,178
Iowa,Sac County,0,9719,4791,4928
Iowa,Sac County,1,591,288,303
Iowa,Sac County,2,563,308,255
Iowa,Sac County,3,677,331,346
Iowa,Sac County,4,534,282,252
Iowa,Sac County,5,462,218,244
Iowa,Sac County,6,463,246,217
Iowa,Sac County,7,485,248,237
Iowa,Sac County,8,506,261,245
Iowa,Sac County,9,452,239,213
Iowa,Sac County,10,541,274,267
Iowa,Sac County,11,611,310,301
Iowa,Sac County,12,759,364,395
Iowa,Sac County,13,792,405,387
Iowa,Sac County,14,662,334,328
Iowa,Sac County,15,489,247,242
Iowa,Sac County,16,341,151,190
Iowa,Sac County,17,351,159,192
Iowa,Sac County,18,440,126,314
Iowa,Scott County,0,173283,84974,88309
Iowa,Scott County,1,11016,5493,5523
Iowa,Scott County,2,11369,5824,5545
Iowa,Scott County,3,11859,5958,5901
Iowa,Scott County,4,11029,5590,5439
Iowa,Scott County,5,10174,5070,5104
Iowa,Scott County,6,11340,5634,5706
Iowa,Scott County,7,11419,5612,5807
Iowa,Scott County,8,12053,6068,5985
Iowa,Scott County,9,10362,5220,5142
Iowa,Scott County,10,10684,5345,5339
Iowa,Scott County,11,10824,5357,5467
Iowa,Scott County,12,11859,5726,6133
Iowa,Scott County,13,11153,5461,5692
Iowa,Scott County,14,9324,4520,4804
Iowa,Scott County,15,7081,3405,3676
Iowa,Scott County,16,4724,2101,2623
Iowa,Scott County,17,3248,1296,1952
Iowa,Scott County,18,3765,1294,2471
Iowa,Shelby County,0,11578,5725,5853
Iowa,Shelby County,1,596,299,297
Iowa,Shelby County,2,722,377,345
Iowa,Shelby County,3,757,384,373
Iowa,Shelby County,4,777,429,348
Iowa,Shelby County,5,571,289,282
Iowa,Shelby County,6,546,269,277
Iowa,Shelby County,7,534,267,267
Iowa,Shelby County,8,585,283,302
Iowa,Shelby County,9,566,269,297
Iowa,Shelby County,10,673,353,320
Iowa,Shelby County,11,783,371,412
Iowa,Shelby County,12,972,494,478
Iowa,Shelby County,13,878,459,419
Iowa,Shelby County,14,708,347,361
Iowa,Shelby County,15,580,276,304
Iowa,Shelby County,16,448,213,235
Iowa,Shelby County,17,364,153,211
Iowa,Shelby County,18,518,193,325
Iowa,Sioux County,0,34909,17575,17334
Iowa,Sioux County,1,2462,1283,1179
Iowa,Sioux County,2,2637,1392,1245
Iowa,Sioux County,3,2771,1365,1406
Iowa,Sioux County,4,3121,1574,1547
Iowa,Sioux County,5,3109,1604,1505
Iowa,Sioux County,6,1827,992,835
Iowa,Sioux County,7,1957,1000,957
Iowa,Sioux County,8,2139,1110,1029
Iowa,Sioux County,9,1806,925,881
Iowa,Sioux County,10,1703,876,827
Iowa,Sioux County,11,1758,910,848
Iowa,Sioux County,12,2092,1062,1030
Iowa,Sioux County,13,1991,991,1000
Iowa,Sioux County,14,1672,850,822
Iowa,Sioux County,15,1138,543,595
Iowa,Sioux County,16,969,439,530
Iowa,Sioux County,17,774,329,445
Iowa,Sioux County,18,983,330,653
Iowa,Story County,0,98105,51227,46878
Iowa,Story County,1,4468,2294,2174
Iowa,Story County,2,4510,2330,2180
Iowa,Story County,3,4445,2270,2175
Iowa,Story County,4,11813,6187,5626
Iowa,Story County,5,21337,12203,9134
Iowa,Story County,6,7765,4280,3485
Iowa,Story County,7,5137,2787,2350
Iowa,Story County,8,5271,2723,2548
Iowa,Story County,9,4406,2270,2136
Iowa,Story County,10,4001,2112,1889
Iowa,Story County,11,4145,2059,2086
Iowa,Story County,12,4423,2168,2255
Iowa,Story County,13,4572,2210,2362
Iowa,Story County,14,3972,1931,2041
Iowa,Story County,15,2675,1287,1388
Iowa,Story County,16,2012,907,1105
Iowa,Story County,17,1471,627,844
Iowa,Story County,18,1682,582,1100
Iowa,Tama County,0,16904,8471,8433
Iowa,Tama County,1,1097,573,524
Iowa,Tama County,2,1058,519,539
Iowa,Tama County,3,1170,617,553
Iowa,Tama County,4,1154,619,535
Iowa,Tama County,5,920,458,462
Iowa,Tama County,6,893,465,428
Iowa,Tama County,7,869,474,395
Iowa,Tama County,8,918,447,471
Iowa,Tama County,9,854,427,427
Iowa,Tama County,10,998,509,489
Iowa,Tama County,11,1118,569,549
Iowa,Tama County,12,1242,605,637
Iowa,Tama County,13,1278,656,622
Iowa,Tama County,14,1011,503,508
Iowa,Tama County,15,755,374,381
Iowa,Tama County,16,573,276,297
Iowa,Tama County,17,444,199,245
Iowa,Tama County,18,552,181,371
Iowa,Taylor County,0,6191,3141,3050
Iowa,Taylor County,1,406,232,174
Iowa,Taylor County,2,392,212,180
Iowa,Taylor County,3,420,215,205
Iowa,Taylor County,4,379,206,173
Iowa,Taylor County,5,308,144,164
Iowa,Taylor County,6,316,155,161
Iowa,Taylor County,7,337,174,163
Iowa,Taylor County,8,382,220,162
Iowa,Taylor County,9,317,144,173
Iowa,Taylor County,10,323,163,160
Iowa,Taylor County,11,374,201,173
Iowa,Taylor County,12,454,216,238
Iowa,Taylor County,13,414,201,213
Iowa,Taylor County,14,411,208,203
Iowa,Taylor County,15,341,178,163
Iowa,Taylor County,16,211,106,105
Iowa,Taylor County,17,192,80,112
Iowa,Taylor County,18,214,86,128
Iowa,Union County,0,12359,5991,6368
Iowa,Union County,1,673,321,352
Iowa,Union County,2,728,351,377
Iowa,Union County,3,878,467,411
Iowa,Union County,4,880,440,440
Iowa,Union County,5,747,374,373
Iowa,Union County,6,674,326,348
Iowa,Union County,7,694,349,345
Iowa,Union County,8,753,367,386
Iowa,Union County,9,638,314,324
Iowa,Union County,10,697,338,359
Iowa,Union County,11,731,357,374
Iowa,Union County,12,904,441,463
Iowa,Union County,13,818,401,417
Iowa,Union County,14,751,369,382
Iowa,Union County,15,587,278,309
Iowa,Union County,16,490,209,281
Iowa,Union County,17,328,154,174
Iowa,Union County,18,388,135,253
Iowa,Van Buren County,0,7020,3613,3407
Iowa,Van Buren County,1,406,235,171
Iowa,Van Buren County,2,446,239,207
Iowa,Van Buren County,3,453,246,207
Iowa,Van Buren County,4,432,240,192
Iowa,Van Buren County,5,352,172,180
Iowa,Van Buren County,6,322,171,151
Iowa,Van Buren County,7,341,164,177
Iowa,Van Buren County,8,410,215,195
Iowa,Van Buren County,9,358,188,170
Iowa,Van Buren County,10,377,215,162
Iowa,Van Buren County,11,457,221,236
Iowa,Van Buren County,12,544,278,266
Iowa,Van Buren County,13,546,267,279
Iowa,Van Buren County,14,522,259,263
Iowa,Van Buren County,15,366,181,185
Iowa,Van Buren County,16,280,138,142
Iowa,Van Buren County,17,217,102,115
Iowa,Van Buren County,18,191,82,109
Iowa,Wapello County,0,35205,17539,17666
Iowa,Wapello County,1,2284,1160,1124
Iowa,Wapello County,2,2159,1136,1023
Iowa,Wapello County,3,2206,1100,1106
Iowa,Wapello County,4,2155,1087,1068
Iowa,Wapello County,5,2213,1165,1048
Iowa,Wapello County,6,2443,1293,1150
Iowa,Wapello County,7,2126,1096,1030
Iowa,Wapello County,8,2163,1137,1026
Iowa,Wapello County,9,1986,1038,948
Iowa,Wapello County,10,2069,1090,979
Iowa,Wapello County,11,2092,1030,1062
Iowa,Wapello County,12,2480,1192,1288
Iowa,Wapello County,13,2492,1189,1303
Iowa,Wapello County,14,2007,1002,1005
Iowa,Wapello County,15,1500,670,830
Iowa,Wapello County,16,1136,522,614
Iowa,Wapello County,17,808,331,477
Iowa,Wapello County,18,886,301,585
Iowa,Warren County,0,51056,25173,25883
Iowa,Warren County,1,3136,1612,1524
Iowa,Warren County,2,3519,1839,1680
Iowa,Warren County,3,3743,1899,1844
Iowa,Warren County,4,3796,1987,1809
Iowa,Warren County,5,3286,1562,1724
Iowa,Warren County,6,2782,1382,1400
Iowa,Warren County,7,3061,1524,1537
Iowa,Warren County,8,3483,1751,1732
Iowa,Warren County,9,3104,1572,1532
Iowa,Warren County,10,3325,1632,1693
Iowa,Warren County,11,3279,1611,1668
Iowa,Warren County,12,3472,1700,1772
Iowa,Warren County,13,3045,1490,1555
Iowa,Warren County,14,2659,1291,1368
Iowa,Warren County,15,2054,980,1074
Iowa,Warren County,16,1397,628,769
Iowa,Warren County,17,956,395,561
Iowa,Warren County,18,959,318,641
Iowa,Washington County,0,22141,10939,11202
Iowa,Washington County,1,1530,787,743
Iowa,Washington County,2,1508,784,724
Iowa,Washington County,3,1505,748,757
Iowa,Washington County,4,1439,767,672
Iowa,Washington County,5,1135,541,594
Iowa,Washington County,6,1359,718,641
Iowa,Washington County,7,1220,613,607
Iowa,Washington County,8,1281,662,619
Iowa,Washington County,9,1208,584,624
Iowa,Washington County,10,1252,612,640
Iowa,Washington County,11,1412,705,707
Iowa,Washington County,12,1554,794,760
Iowa,Washington County,13,1466,735,731
Iowa,Washington County,14,1316,632,684
Iowa,Washington County,15,1003,471,532
Iowa,Washington County,16,732,345,387
Iowa,Washington County,17,529,228,301
Iowa,Washington County,18,692,213,479
Iowa,Wayne County,0,6401,3146,3255
Iowa,Wayne County,1,446,221,225
Iowa,Wayne County,2,437,225,212
Iowa,Wayne County,3,461,235,226
Iowa,Wayne County,4,413,201,212
Iowa,Wayne County,5,289,135,154
Iowa,Wayne County,6,357,167,190
Iowa,Wayne County,7,331,159,172
Iowa,Wayne County,8,332,181,151
Iowa,Wayne County,9,290,146,144
Iowa,Wayne County,10,314,159,155
Iowa,Wayne County,11,339,175,164
Iowa,Wayne County,12,464,241,223
Iowa,Wayne County,13,512,276,236
Iowa,Wayne County,14,375,184,191
Iowa,Wayne County,15,316,161,155
Iowa,Wayne County,16,286,121,165
Iowa,Wayne County,17,196,87,109
Iowa,Wayne County,18,243,72,171
Iowa,Webster County,0,36277,18779,17498
Iowa,Webster County,1,2162,1091,1071
Iowa,Webster County,2,2119,1121,998
Iowa,Webster County,3,2209,1159,1050
Iowa,Webster County,4,2718,1556,1162
Iowa,Webster County,5,2838,1724,1114
Iowa,Webster County,6,2405,1387,1018
Iowa,Webster County,7,1964,1052,912
Iowa,Webster County,8,2127,1084,1043
Iowa,Webster County,9,1835,976,859
Iowa,Webster County,10,1967,1016,951
Iowa,Webster County,11,2062,1062,1000
Iowa,Webster County,12,2639,1302,1337
Iowa,Webster County,13,2578,1280,1298
Iowa,Webster County,14,2097,1017,1080
Iowa,Webster County,15,1555,716,839
Iowa,Webster County,16,1137,524,613
Iowa,Webster County,17,931,375,556
Iowa,Webster County,18,934,337,597
Iowa,Winnebago County,0,10518,5185,5333
Iowa,Winnebago County,1,582,298,284
Iowa,Winnebago County,2,669,301,368
Iowa,Winnebago County,3,659,321,338
Iowa,Winnebago County,4,722,370,352
Iowa,Winnebago County,5,710,385,325
Iowa,Winnebago County,6,526,312,214
Iowa,Winnebago County,7,573,293,280
Iowa,Winnebago County,8,554,286,268
Iowa,Winnebago County,9,531,265,266
Iowa,Winnebago County,10,595,300,295
Iowa,Winnebago County,11,577,289,288
Iowa,Winnebago County,12,754,382,372
Iowa,Winnebago County,13,803,394,409
Iowa,Winnebago County,14,682,353,329
Iowa,Winnebago County,15,474,226,248
Iowa,Winnebago County,16,386,164,222
Iowa,Winnebago County,17,300,133,167
Iowa,Winnebago County,18,421,113,308
Iowa,Winneshiek County,0,20029,9993,10036
Iowa,Winneshiek County,1,911,482,429
Iowa,Winneshiek County,2,937,488,449
Iowa,Winneshiek County,3,1176,599,577
Iowa,Winneshiek County,4,1752,833,919
Iowa,Winneshiek County,5,2042,1003,1039
Iowa,Winneshiek County,6,859,450,409
Iowa,Winneshiek County,7,904,481,423
Iowa,Winneshiek County,8,1029,541,488
Iowa,Winneshiek County,9,962,485,477
Iowa,Winneshiek County,10,1028,523,505
Iowa,Winneshiek County,11,1228,646,582
Iowa,Winneshiek County,12,1493,726,767
Iowa,Winneshiek County,13,1564,834,730
Iowa,Winneshiek County,14,1252,612,640
Iowa,Winneshiek County,15,928,452,476
Iowa,Winneshiek County,16,730,343,387
Iowa,Winneshiek County,17,558,253,305
Iowa,Winneshiek County,18,676,242,434
Iowa,Woodbury County,0,102539,50815,51724
Iowa,Woodbury County,1,7352,3721,3631
Iowa,Woodbury County,2,7314,3750,3564
Iowa,Woodbury County,3,7668,3847,3821
Iowa,Woodbury County,4,7494,3830,3664
Iowa,Woodbury County,5,6924,3484,3440
Iowa,Woodbury County,6,6792,3543,3249
Iowa,Woodbury County,7,6456,3391,3065
Iowa,Woodbury County,8,6607,3289,3318
Iowa,Woodbury County,9,5854,2898,2956
Iowa,Woodbury County,10,6087,3008,3079
Iowa,Woodbury County,11,5959,2976,2983
Iowa,Woodbury County,12,6462,3235,3227
Iowa,Woodbury County,13,6099,2986,3113
Iowa,Woodbury County,14,5243,2529,2714
Iowa,Woodbury County,15,3764,1719,2045
Iowa,Woodbury County,16,2663,1195,1468
Iowa,Woodbury County,17,1819,733,1086
Iowa,Woodbury County,18,1982,681,1301
Iowa,Worth County,0,7453,3767,3686
Iowa,Worth County,1,402,220,182
Iowa,Worth County,2,451,229,222
Iowa,Worth County,3,445,233,212
Iowa,Worth County,4,417,211,206
Iowa,Worth County,5,401,202,199
Iowa,Worth County,6,432,217,215
Iowa,Worth County,7,379,189,190
Iowa,Worth County,8,453,240,213
Iowa,Worth County,9,401,217,184
Iowa,Worth County,10,453,220,233
Iowa,Worth County,11,503,259,244
Iowa,Worth County,12,587,312,275
Iowa,Worth County,13,598,298,300
Iowa,Worth County,14,480,250,230
Iowa,Worth County,15,365,176,189
Iowa,Worth County,16,245,126,119
Iowa,Worth County,17,216,99,117
Iowa,Worth County,18,225,69,156
Iowa,Wright County,0,12690,6379,6311
Iowa,Wright County,1,812,429,383
Iowa,Wright County,2,787,382,405
Iowa,Wright County,3,901,456,445
Iowa,Wright County,4,822,419,403
Iowa,Wright County,5,606,326,280
Iowa,Wright County,6,656,355,301
Iowa,Wright County,7,614,313,301
Iowa,Wright County,8,697,354,343
Iowa,Wright County,9,676,331,345
Iowa,Wright County,10,640,340,300
Iowa,Wright County,11,696,369,327
Iowa,Wright County,12,915,462,453
Iowa,Wright County,13,984,507,477
Iowa,Wright County,14,831,431,400
Iowa,Wright County,15,619,296,323
Iowa,Wright County,16,481,225,256
Iowa,Wright County,17,405,182,223
Iowa,Wright County,18,548,202,346
Kansas,Allen County,0,12444,6131,6313
Kansas,Allen County,1,701,383,318
Kansas,Allen County,2,739,386,353
Kansas,Allen County,3,841,436,405
Kansas,Allen County,4,919,473,446
Kansas,Allen County,5,712,395,317
Kansas,Allen County,6,688,346,342
Kansas,Allen County,7,681,355,326
Kansas,Allen County,8,731,336,395
Kansas,Allen County,9,676,350,326
Kansas,Allen County,10,723,386,337
Kansas,Allen County,11,715,347,368
Kansas,Allen County,12,878,426,452
Kansas,Allen County,13,863,397,466
Kansas,Allen County,14,811,367,444
Kansas,Allen County,15,577,279,298
Kansas,Allen County,16,484,213,271
Kansas,Allen County,17,330,145,185
Kansas,Allen County,18,375,111,264
Kansas,Anderson County,0,7878,3911,3967
Kansas,Anderson County,1,517,267,250
Kansas,Anderson County,2,559,291,268
Kansas,Anderson County,3,576,302,274
Kansas,Anderson County,4,518,270,248
Kansas,Anderson County,5,384,204,180
Kansas,Anderson County,6,398,205,193
Kansas,Anderson County,7,377,194,183
Kansas,Anderson County,8,464,228,236
Kansas,Anderson County,9,408,195,213
Kansas,Anderson County,10,405,193,212
Kansas,Anderson County,11,466,224,242
Kansas,Anderson County,12,591,308,283
Kansas,Anderson County,13,539,265,274
Kansas,Anderson County,14,445,233,212
Kansas,Anderson County,15,395,186,209
Kansas,Anderson County,16,345,153,192
Kansas,Anderson County,17,242,102,140
Kansas,Anderson County,18,249,91,158
Kansas,Atchison County,0,16193,7861,8332
Kansas,Atchison County,1,969,490,479
Kansas,Atchison County,2,982,472,510
Kansas,Atchison County,3,1171,621,550
Kansas,Atchison County,4,1471,727,744
Kansas,Atchison County,5,1414,657,757
Kansas,Atchison County,6,836,425,411
Kansas,Atchison County,7,869,420,449
Kansas,Atchison County,8,929,469,460
Kansas,Atchison County,9,803,406,397
Kansas,Atchison County,10,887,439,448
Kansas,Atchison County,11,983,489,494
Kansas,Atchison County,12,1040,508,532
Kansas,Atchison County,13,1060,514,546
Kansas,Atchison County,14,804,408,396
Kansas,Atchison County,15,673,301,372
Kansas,Atchison County,16,527,241,286
Kansas,Atchison County,17,387,147,240
Kansas,Atchison County,18,388,127,261
Kansas,Barber County,0,4472,2301,2171
Kansas,Barber County,1,273,139,134
Kansas,Barber County,2,303,170,133
Kansas,Barber County,3,280,153,127
Kansas,Barber County,4,243,124,119
Kansas,Barber County,5,194,90,104
Kansas,Barber County,6,236,135,101
Kansas,Barber County,7,255,129,126
Kansas,Barber County,8,258,142,116
Kansas,Barber County,9,182,92,90
Kansas,Barber County,10,219,103,116
Kansas,Barber County,11,238,128,110
Kansas,Barber County,12,371,194,177
Kansas,Barber County,13,393,201,192
Kansas,Barber County,14,321,170,151
Kansas,Barber County,15,285,138,147
Kansas,Barber County,16,183,96,87
Kansas,Barber County,17,92,41,51
Kansas,Barber County,18,146,56,90
Kansas,Barton County,0,26111,12899,13212
Kansas,Barton County,1,1633,839,794
Kansas,Barton County,2,1761,909,852
Kansas,Barton County,3,1761,875,886
Kansas,Barton County,4,1730,895,835
Kansas,Barton County,5,1544,777,767
Kansas,Barton County,6,1543,764,779
Kansas,Barton County,7,1549,817,732
Kansas,Barton County,8,1573,801,772
Kansas,Barton County,9,1261,658,603
Kansas,Barton County,10,1273,618,655
Kansas,Barton County,11,1495,752,743
Kansas,Barton County,12,1980,967,1013
Kansas,Barton County,13,1990,955,1035
Kansas,Barton County,14,1551,784,767
Kansas,Barton County,15,1105,528,577
Kansas,Barton County,16,853,388,465
Kansas,Barton County,17,658,268,390
Kansas,Barton County,18,851,304,547
Kansas,Bourbon County,0,14653,7242,7411
Kansas,Bourbon County,1,1036,576,460
Kansas,Bourbon County,2,999,497,502
Kansas,Bourbon County,3,1090,541,549
Kansas,Bourbon County,4,1098,593,505
Kansas,Bourbon County,5,839,431,408
Kansas,Bourbon County,6,874,464,410
Kansas,Bourbon County,7,770,391,379
Kansas,Bourbon County,8,828,404,424
Kansas,Bourbon County,9,776,394,382
Kansas,Bourbon County,10,764,390,374
Kansas,Bourbon County,11,737,344,393
Kansas,Bourbon County,12,976,463,513
Kansas,Bourbon County,13,977,471,506
Kansas,Bourbon County,14,918,425,493
Kansas,Bourbon County,15,687,341,346
Kansas,Bourbon County,16,490,222,268
Kansas,Bourbon County,17,347,143,204
Kansas,Bourbon County,18,447,152,295
Kansas,Brown County,0,9598,4737,4861
Kansas,Brown County,1,609,328,281
Kansas,Brown County,2,712,354,358
Kansas,Brown County,3,709,359,350
Kansas,Brown County,4,592,312,280
Kansas,Brown County,5,453,225,228
Kansas,Brown County,6,495,269,226
Kansas,Brown County,7,528,259,269
Kansas,Brown County,8,567,281,286
Kansas,Brown County,9,468,251,217
Kansas,Brown County,10,513,236,277
Kansas,Brown County,11,559,288,271
Kansas,Brown County,12,706,341,365
Kansas,Brown County,13,719,337,382
Kansas,Brown County,14,622,309,313
Kansas,Brown County,15,482,239,243
Kansas,Brown County,16,372,167,205
Kansas,Brown County,17,218,99,119
Kansas,Brown County,18,274,83,191
Kansas,Butler County,0,66765,33594,33171
Kansas,Butler County,1,4017,2042,1975
Kansas,Butler County,2,4620,2401,2219
Kansas,Butler County,3,5254,2620,2634
Kansas,Butler County,4,5062,2658,2404
Kansas,Butler County,5,3836,2087,1749
Kansas,Butler County,6,3814,2074,1740
Kansas,Butler County,7,4096,2071,2025
Kansas,Butler County,8,4431,2253,2178
Kansas,Butler County,9,4163,2167,1996
Kansas,Butler County,10,4000,1994,2006
Kansas,Butler County,11,4159,2109,2050
Kansas,Butler County,12,4682,2283,2399
Kansas,Butler County,13,4502,2303,2199
Kansas,Butler County,14,3327,1605,1722
Kansas,Butler County,15,2488,1176,1312
Kansas,Butler County,16,1657,742,915
Kansas,Butler County,17,1251,511,740
Kansas,Butler County,18,1406,498,908
Kansas,Chase County,0,2629,1338,1291
Kansas,Chase County,1,135,71,64
Kansas,Chase County,2,151,84,67
Kansas,Chase County,3,149,65,84
Kansas,Chase County,4,150,73,77
Kansas,Chase County,5,158,94,64
Kansas,Chase County,6,153,90,63
Kansas,Chase County,7,128,70,58
Kansas,Chase County,8,127,75,52
Kansas,Chase County,9,137,77,60
Kansas,Chase County,10,140,67,73
Kansas,Chase County,11,157,72,85
Kansas,Chase County,12,205,110,95
Kansas,Chase County,13,178,86,92
Kansas,Chase County,14,192,95,97
Kansas,Chase County,15,161,80,81
Kansas,Chase County,16,131,68,63
Kansas,Chase County,17,78,31,47
Kansas,Chase County,18,99,30,69
Kansas,Chautauqua County,0,3309,1703,1606
Kansas,Chautauqua County,1,165,88,77
Kansas,Chautauqua County,2,186,101,85
Kansas,Chautauqua County,3,202,110,92
Kansas,Chautauqua County,4,181,93,88
Kansas,Chautauqua County,5,142,73,69
Kansas,Chautauqua County,6,155,75,80
Kansas,Chautauqua County,7,181,98,83
Kansas,Chautauqua County,8,181,94,87
Kansas,Chautauqua County,9,145,81,64
Kansas,Chautauqua County,10,168,87,81
Kansas,Chautauqua County,11,182,96,86
Kansas,Chautauqua County,12,259,143,116
Kansas,Chautauqua County,13,277,140,137
Kansas,Chautauqua County,14,227,100,127
Kansas,Chautauqua County,15,221,119,102
Kansas,Chautauqua County,16,196,93,103
Kansas,Chautauqua County,17,116,63,53
Kansas,Chautauqua County,18,125,49,76
Kansas,Cherokee County,0,20015,9844,10171
Kansas,Cherokee County,1,1155,600,555
Kansas,Cherokee County,2,1219,625,594
Kansas,Cherokee County,3,1369,680,689
Kansas,Cherokee County,4,1307,666,641
Kansas,Cherokee County,5,1064,544,520
Kansas,Cherokee County,6,1040,525,515
Kansas,Cherokee County,7,1105,562,543
Kansas,Cherokee County,8,1182,578,604
Kansas,Cherokee County,9,1091,541,550
Kansas,Cherokee County,10,1258,628,630
Kansas,Cherokee County,11,1411,701,710
Kansas,Cherokee County,12,1513,742,771
Kansas,Cherokee County,13,1438,695,743
Kansas,Cherokee County,14,1189,593,596
Kansas,Cherokee County,15,992,467,525
Kansas,Cherokee County,16,763,340,423
Kansas,Cherokee County,17,491,205,286
Kansas,Cherokee County,18,428,152,276
Kansas,Cheyenne County,0,2660,1348,1312
Kansas,Cheyenne County,1,180,109,71
Kansas,Cheyenne County,2,151,88,63
Kansas,Cheyenne County,3,140,69,71
Kansas,Cheyenne County,4,154,95,59
Kansas,Cheyenne County,5,134,79,55
Kansas,Cheyenne County,6,127,71,56
Kansas,Cheyenne County,7,120,55,65
Kansas,Cheyenne County,8,157,76,81
Kansas,Cheyenne County,9,133,67,66
Kansas,Cheyenne County,10,115,65,50
Kansas,Cheyenne County,11,133,64,69
Kansas,Cheyenne County,12,176,79,97
Kansas,Cheyenne County,13,223,117,106
Kansas,Cheyenne County,14,185,85,100
Kansas,Cheyenne County,15,165,81,84
Kansas,Cheyenne County,16,120,56,64
Kansas,Cheyenne County,17,87,37,50
Kansas,Cheyenne County,18,160,55,105
Kansas,Clark County,0,2005,995,1010
Kansas,Clark County,1,107,62,45
Kansas,Clark County,2,142,75,67
Kansas,Clark County,3,155,80,75
Kansas,Clark County,4,125,62,63
Kansas,Clark County,5,118,58,60
Kansas,Clark County,6,112,69,43
Kansas,Clark County,7,100,49,51
Kansas,Clark County,8,125,64,61
Kansas,Clark County,9,109,62,47
Kansas,Clark County,10,97,43,54
Kansas,Clark County,11,111,55,56
Kansas,Clark County,12,130,63,67
Kansas,Clark County,13,134,64,70
Kansas,Clark County,14,108,58,50
Kansas,Clark County,15,85,35,50
Kansas,Clark County,16,91,40,51
Kansas,Clark County,17,65,29,36
Kansas,Clark County,18,91,27,64
Kansas,Clay County,0,7997,4001,3996
Kansas,Clay County,1,520,263,257
Kansas,Clay County,2,512,269,243
Kansas,Clay County,3,558,289,269
Kansas,Clay County,4,446,250,196
Kansas,Clay County,5,378,197,181
Kansas,Clay County,6,377,191,186
Kansas,Clay County,7,450,246,204
Kansas,Clay County,8,476,239,237
Kansas,Clay County,9,460,233,227
Kansas,Clay County,10,416,211,205
Kansas,Clay County,11,446,224,222
Kansas,Clay County,12,542,263,279
Kansas,Clay County,13,578,298,280
Kansas,Clay County,14,512,240,272
Kansas,Clay County,15,451,223,228
Kansas,Clay County,16,328,146,182
Kansas,Clay County,17,227,97,130
Kansas,Clay County,18,320,122,198
Kansas,Cloud County,0,8729,4330,4399
Kansas,Cloud County,1,488,251,237
Kansas,Cloud County,2,623,326,297
Kansas,Cloud County,3,540,278,262
Kansas,Cloud County,4,646,336,310
Kansas,Cloud County,5,490,289,201
Kansas,Cloud County,6,499,249,250
Kansas,Cloud County,7,490,255,235
Kansas,Cloud County,8,500,258,242
Kansas,Cloud County,9,405,211,194
Kansas,Cloud County,10,454,239,215
Kansas,Cloud County,11,492,228,264
Kansas,Cloud County,12,623,317,306
Kansas,Cloud County,13,594,304,290
Kansas,Cloud County,14,528,253,275
Kansas,Cloud County,15,426,208,218
Kansas,Cloud County,16,321,149,172
Kansas,Cloud County,17,271,96,175
Kansas,Cloud County,18,339,83,256
Kansas,Coffey County,0,8233,4064,4169
Kansas,Coffey County,1,467,252,215
Kansas,Coffey County,2,483,244,239
Kansas,Coffey County,3,515,253,262
Kansas,Coffey County,4,502,263,239
Kansas,Coffey County,5,427,215,212
Kansas,Coffey County,6,462,242,220
Kansas,Coffey County,7,417,216,201
Kansas,Coffey County,8,478,240,238
Kansas,Coffey County,9,428,210,218
Kansas,Coffey County,10,503,233,270
Kansas,Coffey County,11,521,259,262
Kansas,Coffey County,12,648,311,337
Kansas,Coffey County,13,616,300,316
Kansas,Coffey County,14,579,287,292
Kansas,Coffey County,15,435,224,211
Kansas,Coffey County,16,322,147,175
Kansas,Coffey County,17,214,92,122
Kansas,Coffey County,18,216,76,140
Kansas,Comanche County,0,1748,849,899
Kansas,Comanche County,1,85,40,45
Kansas,Comanche County,2,141,75,66
Kansas,Comanche County,3,114,52,62
Kansas,Comanche County,4,114,57,57
Kansas,Comanche County,5,72,26,46
Kansas,Comanche County,6,79,35,44
Kansas,Comanche County,7,82,48,34
Kansas,Comanche County,8,92,43,49
Kansas,Comanche County,9,83,43,40
Kansas,Comanche County,10,100,57,43
Kansas,Comanche County,11,91,42,49
Kansas,Comanche County,12,126,69,57
Kansas,Comanche County,13,122,57,65
Kansas,Comanche County,14,131,63,68
Kansas,Comanche County,15,118,49,69
Kansas,Comanche County,16,85,39,46
Kansas,Comanche County,17,53,29,24
Kansas,Comanche County,18,60,25,35
Kansas,Cowley County,0,35218,17716,17502
Kansas,Cowley County,1,2154,1120,1034
Kansas,Cowley County,2,2367,1185,1182
Kansas,Cowley County,3,2368,1198,1170
Kansas,Cowley County,4,2609,1376,1233
Kansas,Cowley County,5,2331,1266,1065
Kansas,Cowley County,6,2120,1086,1034
Kansas,Cowley County,7,2143,1132,1011
Kansas,Cowley County,8,2080,1080,1000
Kansas,Cowley County,9,1958,1002,956
Kansas,Cowley County,10,2009,1056,953
Kansas,Cowley County,11,2046,1027,1019
Kansas,Cowley County,12,2389,1196,1193
Kansas,Cowley County,13,2224,1085,1139
Kansas,Cowley County,14,1898,912,986
Kansas,Cowley County,15,1650,804,846
Kansas,Cowley County,16,1114,524,590
Kansas,Cowley County,17,811,336,475
Kansas,Cowley County,18,947,331,616
Kansas,Crawford County,0,39019,19574,19445
Kansas,Crawford County,1,2437,1273,1164
Kansas,Crawford County,2,2261,1205,1056
Kansas,Crawford County,3,2366,1210,1156
Kansas,Crawford County,4,3166,1673,1493
Kansas,Crawford County,5,5328,2847,2481
Kansas,Crawford County,6,2494,1348,1146
Kansas,Crawford County,7,2025,1017,1008
Kansas,Crawford County,8,2338,1154,1184
Kansas,Crawford County,9,1980,1021,959
Kansas,Crawford County,10,2016,979,1037
Kansas,Crawford County,11,2083,1076,1007
Kansas,Crawford County,12,2228,1093,1135
Kansas,Crawford County,13,2242,1066,1176
Kansas,Crawford County,14,1876,894,982
Kansas,Crawford County,15,1430,666,764
Kansas,Crawford County,16,1103,476,627
Kansas,Crawford County,17,719,304,415
Kansas,Crawford County,18,927,272,655
Kansas,Decatur County,0,2871,1443,1428
Kansas,Decatur County,1,163,88,75
Kansas,Decatur County,2,168,88,80
Kansas,Decatur County,3,138,79,59
Kansas,Decatur County,4,144,71,73
Kansas,Decatur County,5,118,60,58
Kansas,Decatur County,6,141,71,70
Kansas,Decatur County,7,165,79,86
Kansas,Decatur County,8,123,65,58
Kansas,Decatur County,9,121,68,53
Kansas,Decatur County,10,112,57,55
Kansas,Decatur County,11,188,89,99
Kansas,Decatur County,12,213,120,93
Kansas,Decatur County,13,269,140,129
Kansas,Decatur County,14,219,112,107
Kansas,Decatur County,15,156,80,76
Kansas,Decatur County,16,133,67,66
Kansas,Decatur County,17,109,52,57
Kansas,Decatur County,18,191,57,134
Kansas,Dickinson County,0,18717,9433,9284
Kansas,Dickinson County,1,1112,591,521
Kansas,Dickinson County,2,1215,645,570
Kansas,Dickinson County,3,1298,662,636
Kansas,Dickinson County,4,1224,632,592
Kansas,Dickinson County,5,887,476,411
Kansas,Dickinson County,6,1032,551,481
Kansas,Dickinson County,7,1118,577,541
Kansas,Dickinson County,8,1154,584,570
Kansas,Dickinson County,9,1018,533,485
Kansas,Dickinson County,10,1075,541,534
Kansas,Dickinson County,11,1156,594,562
Kansas,Dickinson County,12,1412,696,716
Kansas,Dickinson County,13,1318,673,645
Kansas,Dickinson County,14,1093,554,539
Kansas,Dickinson County,15,805,386,419
Kansas,Dickinson County,16,657,297,360
Kansas,Dickinson County,17,507,220,287
Kansas,Dickinson County,18,636,221,415
Kansas,Doniphan County,0,7682,3863,3819
Kansas,Doniphan County,1,405,201,204
Kansas,Doniphan County,2,472,233,239
Kansas,Doniphan County,3,470,214,256
Kansas,Doniphan County,4,660,365,295
Kansas,Doniphan County,5,475,259,216
Kansas,Doniphan County,6,433,230,203
Kansas,Doniphan County,7,411,205,206
Kansas,Doniphan County,8,469,237,232
Kansas,Doniphan County,9,407,200,207
Kansas,Doniphan County,10,432,222,210
Kansas,Doniphan County,11,470,225,245
Kansas,Doniphan County,12,536,284,252
Kansas,Doniphan County,13,540,273,267
Kansas,Doniphan County,14,477,252,225
Kansas,Doniphan County,15,365,185,180
Kansas,Doniphan County,16,245,118,127
Kansas,Doniphan County,17,193,86,107
Kansas,Doniphan County,18,222,74,148
Kansas,Douglas County,0,121436,60520,60916
Kansas,Douglas County,1,6030,3091,2939
Kansas,Douglas County,2,6144,3142,3002
Kansas,Douglas County,3,6152,3245,2907
Kansas,Douglas County,4,10818,5298,5520
Kansas,Douglas County,5,21296,10849,10447
Kansas,Douglas County,6,9750,5166,4584
Kansas,Douglas County,7,7969,4144,3825
Kansas,Douglas County,8,7792,4032,3760
Kansas,Douglas County,9,6499,3309,3190
Kansas,Douglas County,10,6047,2965,3082
Kansas,Douglas County,11,5585,2772,2813
Kansas,Douglas County,12,6270,2913,3357
Kansas,Douglas County,13,6130,2835,3295
Kansas,Douglas County,14,5294,2571,2723
Kansas,Douglas County,15,3753,1803,1950
Kansas,Douglas County,16,2397,1047,1350
Kansas,Douglas County,17,1620,724,896
Kansas,Douglas County,18,1890,614,1276
Kansas,Edwards County,0,2849,1449,1400
Kansas,Edwards County,1,171,96,75
Kansas,Edwards County,2,188,98,90
Kansas,Edwards County,3,189,93,96
Kansas,Edwards County,4,178,89,89
Kansas,Edwards County,5,143,67,76
Kansas,Edwards County,6,130,59,71
Kansas,Edwards County,7,131,70,61
Kansas,Edwards County,8,160,90,70
Kansas,Edwards County,9,149,79,70
Kansas,Edwards County,10,154,73,81
Kansas,Edwards County,11,185,98,87
Kansas,Edwards County,12,222,111,111
Kansas,Edwards County,13,243,124,119
Kansas,Edwards County,14,192,102,90
Kansas,Edwards County,15,144,76,68
Kansas,Edwards County,16,102,49,53
Kansas,Edwards County,17,99,47,52
Kansas,Edwards County,18,69,28,41
Kansas,Elk County,0,2508,1267,1241
Kansas,Elk County,1,146,83,63
Kansas,Elk County,2,159,87,72
Kansas,Elk County,3,160,83,77
Kansas,Elk County,4,115,58,57
Kansas,Elk County,5,91,46,45
Kansas,Elk County,6,102,57,45
Kansas,Elk County,7,87,38,49
Kansas,Elk County,8,119,67,52
Kansas,Elk County,9,102,50,52
Kansas,Elk County,10,124,69,55
Kansas,Elk County,11,145,70,75
Kansas,Elk County,12,202,99,103
Kansas,Elk County,13,227,117,110
Kansas,Elk County,14,200,92,108
Kansas,Elk County,15,167,83,84
Kansas,Elk County,16,150,74,76
Kansas,Elk County,17,120,60,60
Kansas,Elk County,18,92,34,58
Kansas,Ellis County,0,28710,14458,14252
Kansas,Ellis County,1,1708,839,869
Kansas,Ellis County,2,1795,947,848
Kansas,Ellis County,3,1714,894,820
Kansas,Ellis County,4,2158,1102,1056
Kansas,Ellis County,5,3733,1855,1878
Kansas,Ellis County,6,2070,1110,960
Kansas,Ellis County,7,1785,930,855
Kansas,Ellis County,8,1692,910,782
Kansas,Ellis County,9,1454,740,714
Kansas,Ellis County,10,1401,754,647
Kansas,Ellis County,11,1417,699,718
Kansas,Ellis County,12,1627,800,827
Kansas,Ellis County,13,1740,858,882
Kansas,Ellis County,14,1436,719,717
Kansas,Ellis County,15,997,466,531
Kansas,Ellis County,16,712,326,386
Kansas,Ellis County,17,579,255,324
Kansas,Ellis County,18,692,254,438
Kansas,Ellsworth County,0,6196,3503,2693
Kansas,Ellsworth County,1,285,145,140
Kansas,Ellsworth County,2,315,156,159
Kansas,Ellsworth County,3,330,175,155
Kansas,Ellsworth County,4,301,174,127
Kansas,Ellsworth County,5,430,302,128
Kansas,Ellsworth County,6,418,292,126
Kansas,Ellsworth County,7,412,270,142
Kansas,Ellsworth County,8,408,250,158
Kansas,Ellsworth County,9,367,225,142
Kansas,Ellsworth County,10,353,229,124
Kansas,Ellsworth County,11,386,227,159
Kansas,Ellsworth County,12,431,222,209
Kansas,Ellsworth County,13,463,232,231
Kansas,Ellsworth County,14,417,211,206
Kansas,Ellsworth County,15,285,149,136
Kansas,Ellsworth County,16,232,106,126
Kansas,Ellsworth County,17,163,66,97
Kansas,Ellsworth County,18,200,72,128
Kansas,Finney County,0,36611,18844,17767
Kansas,Finney County,1,3193,1557,1636
Kansas,Finney County,2,3078,1602,1476
Kansas,Finney County,3,3028,1562,1466
Kansas,Finney County,4,3007,1633,1374
Kansas,Finney County,5,2724,1490,1234
Kansas,Finney County,6,2688,1429,1259
Kansas,Finney County,7,2495,1347,1148
Kansas,Finney County,8,2294,1221,1073
Kansas,Finney County,9,2069,1078,991
Kansas,Finney County,10,1991,995,996
Kansas,Finney County,11,2118,1069,1049
Kansas,Finney County,12,2144,1087,1057
Kansas,Finney County,13,1748,880,868
Kansas,Finney County,14,1421,714,707
Kansas,Finney County,15,950,452,498
Kansas,Finney County,16,671,319,352
Kansas,Finney County,17,436,207,229
Kansas,Finney County,18,556,202,354
Kansas,Ford County,0,33888,17584,16304
Kansas,Ford County,1,3011,1498,1513
Kansas,Ford County,2,2929,1524,1405
Kansas,Ford County,3,2752,1442,1310
Kansas,Ford County,4,2578,1403,1175
Kansas,Ford County,5,2426,1287,1139
Kansas,Ford County,6,2538,1411,1127
Kansas,Ford County,7,2143,1133,1010
Kansas,Ford County,8,2177,1212,965
Kansas,Ford County,9,1950,1042,908
Kansas,Ford County,10,1958,991,967
Kansas,Ford County,11,1962,973,989
Kansas,Ford County,12,1996,1040,956
Kansas,Ford County,13,1676,885,791
Kansas,Ford County,14,1212,623,589
Kansas,Ford County,15,870,417,453
Kansas,Ford County,16,588,270,318
Kansas,Ford County,17,486,205,281
Kansas,Ford County,18,636,228,408
Kansas,Franklin County,0,25631,12785,12846
Kansas,Franklin County,1,1529,785,744
Kansas,Franklin County,2,1686,847,839
Kansas,Franklin County,3,1811,929,882
Kansas,Franklin County,4,1816,983,833
Kansas,Franklin County,5,1504,754,750
Kansas,Franklin County,6,1551,749,802
Kansas,Franklin County,7,1496,745,751
Kansas,Franklin County,8,1551,782,769
Kansas,Franklin County,9,1387,702,685
Kansas,Franklin County,10,1594,820,774
Kansas,Franklin County,11,1635,821,814
Kansas,Franklin County,12,2052,1018,1034
Kansas,Franklin County,13,1757,901,856
Kansas,Franklin County,14,1385,663,722
Kansas,Franklin County,15,1092,529,563
Kansas,Franklin County,16,799,374,425
Kansas,Franklin County,17,502,225,277
Kansas,Franklin County,18,484,158,326
Kansas,Geary County,0,32594,17216,15378
Kansas,Geary County,1,3883,1986,1897
Kansas,Geary County,2,2980,1520,1460
Kansas,Geary County,3,2155,1136,1019
Kansas,Geary County,4,1795,975,820
Kansas,Geary County,5,4242,2598,1644
Kansas,Geary County,6,3994,2221,1773
Kansas,Geary County,7,2968,1593,1375
Kansas,Geary County,8,2329,1245,1084
Kansas,Geary County,9,1445,772,673
Kansas,Geary County,10,1108,579,529
Kansas,Geary County,11,998,470,528
Kansas,Geary County,12,991,472,519
Kansas,Geary County,13,888,435,453
Kansas,Geary County,14,860,387,473
Kansas,Geary County,15,738,344,394
Kansas,Geary County,16,500,231,269
Kansas,Geary County,17,364,135,229
Kansas,Geary County,18,356,117,239
Kansas,Gove County,0,2612,1315,1297
Kansas,Gove County,1,167,76,91
Kansas,Gove County,2,187,106,81
Kansas,Gove County,3,175,83,92
Kansas,Gove County,4,148,75,73
Kansas,Gove County,5,120,61,59
Kansas,Gove County,6,115,64,51
Kansas,Gove County,7,138,76,62
Kansas,Gove County,8,143,73,70
Kansas,Gove County,9,139,81,58
Kansas,Gove County,10,107,54,53
Kansas,Gove County,11,134,70,64
Kansas,Gove County,12,196,100,96
Kansas,Gove County,13,208,107,101
Kansas,Gove County,14,166,86,80
Kansas,Gove County,15,145,72,73
Kansas,Gove County,16,98,42,56
Kansas,Gove County,17,94,45,49
Kansas,Gove County,18,132,44,88
Kansas,Graham County,0,2492,1236,1256
Kansas,Graham County,1,101,49,52
Kansas,Graham County,2,154,83,71
Kansas,Graham County,3,152,80,72
Kansas,Graham County,4,116,61,55
Kansas,Graham County,5,100,46,54
Kansas,Graham County,6,120,72,48
Kansas,Graham County,7,119,60,59
Kansas,Graham County,8,137,77,60
Kansas,Graham County,9,128,63,65
Kansas,Graham County,10,102,51,51
Kansas,Graham County,11,135,78,57
Kansas,Graham County,12,220,95,125
Kansas,Graham County,13,224,109,115
Kansas,Graham County,14,162,72,90
Kansas,Graham County,15,138,62,76
Kansas,Graham County,16,144,72,72
Kansas,Graham County,17,126,56,70
Kansas,Graham County,18,114,50,64
Kansas,Grant County,0,7336,3684,3652
Kansas,Grant County,1,571,289,282
Kansas,Grant County,2,644,325,319
Kansas,Grant County,3,634,314,320
Kansas,Grant County,4,630,341,289
Kansas,Grant County,5,457,256,201
Kansas,Grant County,6,408,205,203
Kansas,Grant County,7,420,216,204
Kansas,Grant County,8,403,189,214
Kansas,Grant County,9,471,240,231
Kansas,Grant County,10,415,206,209
Kansas,Grant County,11,366,191,175
Kansas,Grant County,12,476,247,229
Kansas,Grant County,13,438,224,214
Kansas,Grant County,14,354,169,185
Kansas,Grant County,15,239,114,125
Kansas,Grant County,16,167,78,89
Kansas,Grant County,17,126,48,78
Kansas,Grant County,18,117,32,85
Kansas,Gray County,0,6033,3037,2996
Kansas,Gray County,1,460,220,240
Kansas,Gray County,2,458,271,187
Kansas,Gray County,3,537,262,275
Kansas,Gray County,4,458,225,233
Kansas,Gray County,5,376,198,178
Kansas,Gray County,6,336,163,173
Kansas,Gray County,7,325,171,154
Kansas,Gray County,8,356,159,197
Kansas,Gray County,9,403,207,196
Kansas,Gray County,10,298,160,138
Kansas,Gray County,11,349,184,165
Kansas,Gray County,12,420,206,214
Kansas,Gray County,13,347,182,165
Kansas,Gray County,14,301,159,142
Kansas,Gray County,15,197,91,106
Kansas,Gray County,16,144,66,78
Kansas,Gray County,17,136,60,76
Kansas,Gray County,18,132,53,79
Kansas,Greeley County,0,1227,588,639
Kansas,Greeley County,1,72,43,29
Kansas,Greeley County,2,106,46,60
Kansas,Greeley County,3,96,37,59
Kansas,Greeley County,4,73,39,34
Kansas,Greeley County,5,45,19,26
Kansas,Greeley County,6,58,27,31
Kansas,Greeley County,7,86,38,48
Kansas,Greeley County,8,86,43,43
Kansas,Greeley County,9,58,30,28
Kansas,Greeley County,10,37,23,14
Kansas,Greeley County,11,70,32,38
Kansas,Greeley County,12,97,51,46
Kansas,Greeley County,13,89,47,42
Kansas,Greeley County,14,70,35,35
Kansas,Greeley County,15,49,28,21
Kansas,Greeley County,16,40,16,24
Kansas,Greeley County,17,36,14,22
Kansas,Greeley County,18,59,20,39
Kansas,Greenwood County,0,6055,3026,3029
Kansas,Greenwood County,1,337,159,178
Kansas,Greenwood County,2,335,167,168
Kansas,Greenwood County,3,402,217,185
Kansas,Greenwood County,4,358,192,166
Kansas,Greenwood County,5,281,152,129
Kansas,Greenwood County,6,221,106,115
Kansas,Greenwood County,7,279,141,138
Kansas,Greenwood County,8,303,149,154
Kansas,Greenwood County,9,319,163,156
Kansas,Greenwood County,10,327,167,160
Kansas,Greenwood County,11,379,194,185
Kansas,Greenwood County,12,511,255,256
Kansas,Greenwood County,13,494,235,259
Kansas,Greenwood County,14,456,233,223
Kansas,Greenwood County,15,384,200,184
Kansas,Greenwood County,16,285,138,147
Kansas,Greenwood County,17,160,81,79
Kansas,Greenwood County,18,224,77,147
Kansas,Hamilton County,0,2607,1351,1256
Kansas,Hamilton County,1,198,105,93
Kansas,Hamilton County,2,244,131,113
Kansas,Hamilton County,3,200,113,87
Kansas,Hamilton County,4,178,99,79
Kansas,Hamilton County,5,142,77,65
Kansas,Hamilton County,6,181,92,89
Kansas,Hamilton County,7,177,91,86
Kansas,Hamilton County,8,164,76,88
Kansas,Hamilton County,9,140,75,65
Kansas,Hamilton County,10,151,75,76
Kansas,Hamilton County,11,147,73,74
Kansas,Hamilton County,12,176,94,82
Kansas,Hamilton County,13,144,64,80
Kansas,Hamilton County,14,125,67,58
Kansas,Hamilton County,15,87,51,36
Kansas,Hamilton County,16,77,40,37
Kansas,Hamilton County,17,44,17,27
Kansas,Hamilton County,18,32,11,21
Kansas,Harper County,0,5506,2757,2749
Kansas,Harper County,1,348,169,179
Kansas,Harper County,2,407,216,191
Kansas,Harper County,3,394,202,192
Kansas,Harper County,4,328,191,137
Kansas,Harper County,5,251,130,121
Kansas,Harper County,6,271,139,132
Kansas,Harper County,7,314,176,138
Kansas,Harper County,8,292,141,151
Kansas,Harper County,9,286,165,121
Kansas,Harper County,10,275,137,138
Kansas,Harper County,11,291,142,149
Kansas,Harper County,12,380,194,186
Kansas,Harper County,13,402,205,197
Kansas,Harper County,14,375,183,192
Kansas,Harper County,15,274,115,159
Kansas,Harper County,16,229,109,120
Kansas,Harper County,17,176,87,89
Kansas,Harper County,18,213,56,157
Kansas,Harvey County,0,34210,16893,17317
Kansas,Harvey County,1,2010,999,1011
Kansas,Harvey County,2,2302,1165,1137
Kansas,Harvey County,3,2454,1256,1198
Kansas,Harvey County,4,2585,1392,1193
Kansas,Harvey County,5,2215,1162,1053
Kansas,Harvey County,6,1869,954,915
Kansas,Harvey County,7,1903,970,933
Kansas,Harvey County,8,2076,1054,1022
Kansas,Harvey County,9,1890,945,945
Kansas,Harvey County,10,1767,874,893
Kansas,Harvey County,11,1873,916,957
Kansas,Harvey County,12,2330,1113,1217
Kansas,Harvey County,13,2254,1121,1133
Kansas,Harvey County,14,1885,941,944
Kansas,Harvey County,15,1484,703,781
Kansas,Harvey County,16,1145,497,648
Kansas,Harvey County,17,955,406,549
Kansas,Harvey County,18,1213,425,788
Kansas,Haskell County,0,3997,2008,1989
Kansas,Haskell County,1,280,144,136
Kansas,Haskell County,2,318,160,158
Kansas,Haskell County,3,326,172,154
Kansas,Haskell County,4,299,163,136
Kansas,Haskell County,5,271,135,136
Kansas,Haskell County,6,236,118,118
Kansas,Haskell County,7,237,122,115
Kansas,Haskell County,8,226,115,111
Kansas,Haskell County,9,228,122,106
Kansas,Haskell County,10,236,111,125
Kansas,Haskell County,11,214,103,111
Kansas,Haskell County,12,272,135,137
Kansas,Haskell County,13,263,126,137
Kansas,Haskell County,14,226,127,99
Kansas,Haskell County,15,134,62,72
Kansas,Haskell County,16,101,49,52
Kansas,Haskell County,17,63,23,40
Kansas,Haskell County,18,67,21,46
Kansas,Hodgeman County,0,1818,905,913
Kansas,Hodgeman County,1,117,63,54
Kansas,Hodgeman County,2,96,39,57
Kansas,Hodgeman County,3,121,56,65
Kansas,Hodgeman County,4,112,56,56
Kansas,Hodgeman County,5,87,41,46
Kansas,Hodgeman County,6,78,44,34
Kansas,Hodgeman County,7,98,45,53
Kansas,Hodgeman County,8,91,47,44
Kansas,Hodgeman County,9,77,33,44
Kansas,Hodgeman County,10,92,48,44
Kansas,Hodgeman County,11,109,55,54
Kansas,Hodgeman County,12,159,77,82
Kansas,Hodgeman County,13,145,83,62
Kansas,Hodgeman County,14,119,69,50
Kansas,Hodgeman County,15,76,40,36
Kansas,Hodgeman County,16,87,31,56
Kansas,Hodgeman County,17,86,42,44
Kansas,Hodgeman County,18,68,36,32
Kansas,Jackson County,0,13280,6644,6636
Kansas,Jackson County,1,854,414,440
Kansas,Jackson County,2,868,444,424
Kansas,Jackson County,3,988,518,470
Kansas,Jackson County,4,910,493,417
Kansas,Jackson County,5,721,379,342
Kansas,Jackson County,6,661,345,316
Kansas,Jackson County,7,731,376,355
Kansas,Jackson County,8,711,348,363
Kansas,Jackson County,9,714,353,361
Kansas,Jackson County,10,845,412,433
Kansas,Jackson County,11,887,446,441
Kansas,Jackson County,12,933,476,457
Kansas,Jackson County,13,927,463,464
Kansas,Jackson County,14,800,394,406
Kansas,Jackson County,15,678,322,356
Kansas,Jackson County,16,462,222,240
Kansas,Jackson County,17,298,115,183
Kansas,Jackson County,18,292,124,168
Kansas,Jefferson County,0,18975,9661,9314
Kansas,Jefferson County,1,1041,540,501
Kansas,Jefferson County,2,1151,606,545
Kansas,Jefferson County,3,1334,685,649
Kansas,Jefferson County,4,1221,646,575
Kansas,Jefferson County,5,945,511,434
Kansas,Jefferson County,6,929,486,443
Kansas,Jefferson County,7,1018,498,520
Kansas,Jefferson County,8,1129,592,537
Kansas,Jefferson County,9,1084,545,539
Kansas,Jefferson County,10,1146,566,580
Kansas,Jefferson County,11,1341,670,671
Kansas,Jefferson County,12,1644,853,791
Kansas,Jefferson County,13,1454,739,715
Kansas,Jefferson County,14,1153,574,579
Kansas,Jefferson County,15,897,452,445
Kansas,Jefferson County,16,640,318,322
Kansas,Jefferson County,17,412,199,213
Kansas,Jefferson County,18,436,181,255
Kansas,Jewell County,0,2841,1452,1389
Kansas,Jewell County,1,156,72,84
Kansas,Jewell County,2,148,83,65
Kansas,Jewell County,3,158,82,76
Kansas,Jewell County,4,130,71,59
Kansas,Jewell County,5,125,67,58
Kansas,Jewell County,6,129,73,56
Kansas,Jewell County,7,134,80,54
Kansas,Jewell County,8,112,59,53
Kansas,Jewell County,9,124,70,54
Kansas,Jewell County,10,126,59,67
Kansas,Jewell County,11,154,81,73
Kansas,Jewell County,12,215,96,119
Kansas,Jewell County,13,274,145,129
Kansas,Jewell County,14,241,124,117
Kansas,Jewell County,15,196,107,89
Kansas,Jewell County,16,158,77,81
Kansas,Jewell County,17,115,50,65
Kansas,Jewell County,18,146,56,90
Kansas,Johnson County,0,597555,293223,304332
Kansas,Johnson County,1,38056,19231,18825
Kansas,Johnson County,2,40070,20404,19666
Kansas,Johnson County,3,42152,21685,20467
Kansas,Johnson County,4,38545,19709,18836
Kansas,Johnson County,5,34336,17299,17037
Kansas,Johnson County,6,39929,20414,19515
Kansas,Johnson County,7,41859,20844,21015
Kansas,Johnson County,8,44166,22065,22101
Kansas,Johnson County,9,39485,19579,19906
Kansas,Johnson County,10,39700,19689,20011
Kansas,Johnson County,11,37937,18586,19351
Kansas,Johnson County,12,39095,18654,20441
Kansas,Johnson County,13,35502,16729,18773
Kansas,Johnson County,14,29678,13886,15792
Kansas,Johnson County,15,22180,10236,11944
Kansas,Johnson County,16,13972,6237,7735
Kansas,Johnson County,17,9457,3964,5493
Kansas,Johnson County,18,11436,4012,7424
Kansas,Kearny County,0,3943,1967,1976
Kansas,Kearny County,1,315,178,137
Kansas,Kearny County,2,341,178,163
Kansas,Kearny County,3,334,172,162
Kansas,Kearny County,4,249,136,113
Kansas,Kearny County,5,241,136,105
Kansas,Kearny County,6,260,131,129
Kansas,Kearny County,7,285,137,148
Kansas,Kearny County,8,234,126,108
Kansas,Kearny County,9,208,89,119
Kansas,Kearny County,10,186,94,92
Kansas,Kearny County,11,233,100,133
Kansas,Kearny County,12,250,127,123
Kansas,Kearny County,13,195,110,85
Kansas,Kearny County,14,185,80,105
Kansas,Kearny County,15,144,68,76
Kansas,Kearny County,16,94,35,59
Kansas,Kearny County,17,101,41,60
Kansas,Kearny County,18,88,29,59
Kansas,Kingman County,0,7310,3663,3647
Kansas,Kingman County,1,415,221,194
Kansas,Kingman County,2,424,238,186
Kansas,Kingman County,3,463,241,222
Kansas,Kingman County,4,463,226,237
Kansas,Kingman County,5,363,191,172
Kansas,Kingman County,6,358,191,167
Kansas,Kingman County,7,382,182,200
Kansas,Kingman County,8,415,206,209
Kansas,Kingman County,9,373,185,188
Kansas,Kingman County,10,406,205,201
Kansas,Kingman County,11,455,224,231
Kansas,Kingman County,12,609,310,299
Kansas,Kingman County,13,599,303,296
Kansas,Kingman County,14,432,224,208
Kansas,Kingman County,15,363,178,185
Kansas,Kingman County,16,288,132,156
Kansas,Kingman County,17,239,91,148
Kansas,Kingman County,18,263,115,148
Kansas,Kiowa County,0,2516,1234,1282
Kansas,Kiowa County,1,169,71,98
Kansas,Kiowa County,2,157,82,75
Kansas,Kiowa County,3,156,76,80
Kansas,Kiowa County,4,194,85,109
Kansas,Kiowa County,5,196,102,94
Kansas,Kiowa County,6,123,56,67
Kansas,Kiowa County,7,123,59,64
Kansas,Kiowa County,8,105,54,51
Kansas,Kiowa County,9,128,72,56
Kansas,Kiowa County,10,121,62,59
Kansas,Kiowa County,11,135,67,68
Kansas,Kiowa County,12,177,97,80
Kansas,Kiowa County,13,180,95,85
Kansas,Kiowa County,14,179,89,90
Kansas,Kiowa County,15,122,66,56
Kansas,Kiowa County,16,73,29,44
Kansas,Kiowa County,17,78,30,48
Kansas,Kiowa County,18,100,42,58
Kansas,Labette County,0,19964,9931,10033
Kansas,Labette County,1,1343,698,645
Kansas,Labette County,2,1301,647,654
Kansas,Labette County,3,1374,702,672
Kansas,Labette County,4,1201,641,560
Kansas,Labette County,5,1083,572,511
Kansas,Labette County,6,1191,633,558
Kansas,Labette County,7,1158,586,572
Kansas,Labette County,8,1126,568,558
Kansas,Labette County,9,955,466,489
Kansas,Labette County,10,1209,605,604
Kansas,Labette County,11,1317,663,654
Kansas,Labette County,12,1496,764,732
Kansas,Labette County,13,1398,687,711
Kansas,Labette County,14,1125,528,597
Kansas,Labette County,15,997,488,509
Kansas,Labette County,16,685,327,358
Kansas,Labette County,17,457,190,267
Kansas,Labette County,18,548,166,382
Kansas,Lane County,0,1560,788,772
Kansas,Lane County,1,89,53,36
Kansas,Lane County,2,102,63,39
Kansas,Lane County,3,98,47,51
Kansas,Lane County,4,87,42,45
Kansas,Lane County,5,73,35,38
Kansas,Lane County,6,75,40,35
Kansas,Lane County,7,88,42,46
Kansas,Lane County,8,59,31,28
Kansas,Lane County,9,76,32,44
Kansas,Lane County,10,99,57,42
Kansas,Lane County,11,98,50,48
Kansas,Lane County,12,117,58,59
Kansas,Lane County,13,132,67,65
Kansas,Lane County,14,98,50,48
Kansas,Lane County,15,94,46,48
Kansas,Lane County,16,53,26,27
Kansas,Lane County,17,66,32,34
Kansas,Lane County,18,56,17,39
Kansas,Leavenworth County,0,81352,43269,38083
Kansas,Leavenworth County,1,5308,2685,2623
Kansas,Leavenworth County,2,5503,2791,2712
Kansas,Leavenworth County,3,5354,2756,2598
Kansas,Leavenworth County,4,4852,2553,2299
Kansas,Leavenworth County,5,4830,2798,2032
Kansas,Leavenworth County,6,5229,3131,2098
Kansas,Leavenworth County,7,5982,3488,2494
Kansas,Leavenworth County,8,6283,3553,2730
Kansas,Leavenworth County,9,5430,3085,2345
Kansas,Leavenworth County,10,5205,2853,2352
Kansas,Leavenworth County,11,5071,2811,2260
Kansas,Leavenworth County,12,5561,2801,2760
Kansas,Leavenworth County,13,4965,2527,2438
Kansas,Leavenworth County,14,4023,1972,2051
Kansas,Leavenworth County,15,3098,1528,1570
Kansas,Leavenworth County,16,2059,942,1117
Kansas,Leavenworth County,17,1318,549,769
Kansas,Leavenworth County,18,1281,446,835
Kansas,Lincoln County,0,3023,1500,1523
Kansas,Lincoln County,1,162,88,74
Kansas,Lincoln County,2,204,112,92
Kansas,Lincoln County,3,194,95,99
Kansas,Lincoln County,4,190,99,91
Kansas,Lincoln County,5,125,72,53
Kansas,Lincoln County,6,130,61,69
Kansas,Lincoln County,7,108,49,59
Kansas,Lincoln County,8,185,90,95
Kansas,Lincoln County,9,139,76,63
Kansas,Lincoln County,10,158,84,74
Kansas,Lincoln County,11,187,92,95
Kansas,Lincoln County,12,229,105,124
Kansas,Lincoln County,13,273,133,140
Kansas,Lincoln County,14,224,120,104
Kansas,Lincoln County,15,175,100,75
Kansas,Lincoln County,16,96,37,59
Kansas,Lincoln County,17,91,43,48
Kansas,Lincoln County,18,153,44,109
Kansas,Linn County,0,9750,4937,4813
Kansas,Linn County,1,525,282,243
Kansas,Linn County,2,557,286,271
Kansas,Linn County,3,661,321,340
Kansas,Linn County,4,640,348,292
Kansas,Linn County,5,433,225,208
Kansas,Linn County,6,474,248,226
Kansas,Linn County,7,453,208,245
Kansas,Linn County,8,560,293,267
Kansas,Linn County,9,602,307,295
Kansas,Linn County,10,545,275,270
Kansas,Linn County,11,626,305,321
Kansas,Linn County,12,810,425,385
Kansas,Linn County,13,684,344,340
Kansas,Linn County,14,691,342,349
Kansas,Linn County,15,585,301,284
Kansas,Linn County,16,411,205,206
Kansas,Linn County,17,229,110,119
Kansas,Linn County,18,264,112,152
Kansas,Logan County,0,2844,1414,1430
Kansas,Logan County,1,210,109,101
Kansas,Logan County,2,188,100,88
Kansas,Logan County,3,176,88,88
Kansas,Logan County,4,165,85,80
Kansas,Logan County,5,152,84,68
Kansas,Logan County,6,185,89,96
Kansas,Logan County,7,145,86,59
Kansas,Logan County,8,167,84,83
Kansas,Logan County,9,162,82,80
Kansas,Logan County,10,108,59,49
Kansas,Logan County,11,149,78,71
Kansas,Logan County,12,228,104,124
Kansas,Logan County,13,217,115,102
Kansas,Logan County,14,177,97,80
Kansas,Logan County,15,112,49,63
Kansas,Logan County,16,102,38,64
Kansas,Logan County,17,91,33,58
Kansas,Logan County,18,110,34,76
Kansas,Lyon County,0,33406,16223,17183
Kansas,Lyon County,1,2010,1036,974
Kansas,Lyon County,2,2043,1044,999
Kansas,Lyon County,3,2133,1093,1040
Kansas,Lyon County,4,2651,1235,1416
Kansas,Lyon County,5,4465,1963,2502
Kansas,Lyon County,6,2263,1184,1079
Kansas,Lyon County,7,1874,975,899
Kansas,Lyon County,8,1856,911,945
Kansas,Lyon County,9,1591,786,805
Kansas,Lyon County,10,1652,875,777
Kansas,Lyon County,11,1713,821,892
Kansas,Lyon County,12,2004,978,1026
Kansas,Lyon County,13,2076,1040,1036
Kansas,Lyon County,14,1632,808,824
Kansas,Lyon County,15,1189,581,608
Kansas,Lyon County,16,843,372,471
Kansas,Lyon County,17,603,246,357
Kansas,Lyon County,18,808,275,533
Kansas,McPherson County,0,28537,13992,14545
Kansas,McPherson County,1,1601,778,823
Kansas,McPherson County,2,1801,906,895
Kansas,McPherson County,3,1935,975,960
Kansas,McPherson County,4,1948,978,970
Kansas,McPherson County,5,1745,892,853
Kansas,McPherson County,6,1680,918,762
Kansas,McPherson County,7,1658,816,842
Kansas,McPherson County,8,1759,868,891
Kansas,McPherson County,9,1542,771,771
Kansas,McPherson County,10,1473,761,712
Kansas,McPherson County,11,1604,822,782
Kansas,McPherson County,12,2120,1034,1086
Kansas,McPherson County,13,2011,992,1019
Kansas,McPherson County,14,1666,803,863
Kansas,McPherson County,15,1275,622,653
Kansas,McPherson County,16,945,419,526
Kansas,McPherson County,17,684,278,406
Kansas,McPherson County,18,1090,359,731
Kansas,Marion County,0,11950,5943,6007
Kansas,Marion County,1,610,319,291
Kansas,Marion County,2,735,374,361
Kansas,Marion County,3,729,371,358
Kansas,Marion County,4,833,430,403
Kansas,Marion County,5,803,419,384
Kansas,Marion County,6,556,283,273
Kansas,Marion County,7,572,271,301
Kansas,Marion County,8,630,319,311
Kansas,Marion County,9,541,263,278
Kansas,Marion County,10,600,308,292
Kansas,Marion County,11,733,381,352
Kansas,Marion County,12,907,460,447
Kansas,Marion County,13,918,459,459
Kansas,Marion County,14,767,381,386
Kansas,Marion County,15,641,312,329
Kansas,Marion County,16,497,242,255
Kansas,Marion County,17,366,166,200
Kansas,Marion County,18,512,185,327
Kansas,Marshall County,0,9722,4841,4881
Kansas,Marshall County,1,628,326,302
Kansas,Marshall County,2,635,325,310
Kansas,Marshall County,3,644,309,335
Kansas,Marshall County,4,607,300,307
Kansas,Marshall County,5,452,234,218
Kansas,Marshall County,6,469,252,217
Kansas,Marshall County,7,511,262,249
Kansas,Marshall County,8,583,290,293
Kansas,Marshall County,9,512,266,246
Kansas,Marshall County,10,464,237,227
Kansas,Marshall County,11,539,268,271
Kansas,Marshall County,12,764,375,389
Kansas,Marshall County,13,802,414,388
Kansas,Marshall County,14,576,288,288
Kansas,Marshall County,15,467,235,232
Kansas,Marshall County,16,371,159,212
Kansas,Marshall County,17,319,148,171
Kansas,Marshall County,18,379,153,226
Kansas,Meade County,0,4146,2104,2042
Kansas,Meade County,1,275,146,129
Kansas,Meade County,2,306,162,144
Kansas,Meade County,3,311,183,128
Kansas,Meade County,4,291,151,140
Kansas,Meade County,5,268,122,146
Kansas,Meade County,6,234,126,108
Kansas,Meade County,7,201,104,97
Kansas,Meade County,8,205,100,105
Kansas,Meade County,9,196,102,94
Kansas,Meade County,10,267,122,145
Kansas,Meade County,11,242,116,126
Kansas,Meade County,12,285,145,140
Kansas,Meade County,13,266,137,129
Kansas,Meade County,14,227,126,101
Kansas,Meade County,15,162,91,71
Kansas,Meade County,16,140,52,88
Kansas,Meade County,17,114,48,66
Kansas,Meade County,18,156,71,85
Kansas,Miami County,0,33680,16735,16945
Kansas,Miami County,1,1961,983,978
Kansas,Miami County,2,2272,1147,1125
Kansas,Miami County,3,2469,1246,1223
Kansas,Miami County,4,2341,1224,1117
Kansas,Miami County,5,1711,879,832
Kansas,Miami County,6,1691,894,797
Kansas,Miami County,7,1840,904,936
Kansas,Miami County,8,2118,1056,1062
Kansas,Miami County,9,2070,1057,1013
Kansas,Miami County,10,2110,1064,1046
Kansas,Miami County,11,2448,1207,1241
Kansas,Miami County,12,2674,1383,1291
Kansas,Miami County,13,2344,1128,1216
Kansas,Miami County,14,1798,888,910
Kansas,Miami County,15,1351,657,694
Kansas,Miami County,16,1073,496,577
Kansas,Miami County,17,657,262,395
Kansas,Miami County,18,752,260,492
Kansas,Mitchell County,0,6150,3113,3037
Kansas,Mitchell County,1,424,221,203
Kansas,Mitchell County,2,402,209,193
Kansas,Mitchell County,3,376,177,199
Kansas,Mitchell County,4,442,272,170
Kansas,Mitchell County,5,355,201,154
Kansas,Mitchell County,6,291,145,146
Kansas,Mitchell County,7,300,159,141
Kansas,Mitchell County,8,340,180,160
Kansas,Mitchell County,9,294,143,151
Kansas,Mitchell County,10,295,146,149
Kansas,Mitchell County,11,328,156,172
Kansas,Mitchell County,12,418,219,199
Kansas,Mitchell County,13,435,207,228
Kansas,Mitchell County,14,408,219,189
Kansas,Mitchell County,15,337,168,169
Kansas,Mitchell County,16,251,114,137
Kansas,Mitchell County,17,190,83,107
Kansas,Mitchell County,18,264,94,170
Kansas,Montgomery County,0,32120,15909,16211
Kansas,Montgomery County,1,1982,1035,947
Kansas,Montgomery County,2,2176,1123,1053
Kansas,Montgomery County,3,2238,1140,1098
Kansas,Montgomery County,4,2290,1266,1024
Kansas,Montgomery County,5,1738,971,767
Kansas,Montgomery County,6,1771,869,902
Kansas,Montgomery County,7,1861,936,925
Kansas,Montgomery County,8,1835,894,941
Kansas,Montgomery County,9,1612,811,801
Kansas,Montgomery County,10,1779,883,896
Kansas,Montgomery County,11,1894,905,989
Kansas,Montgomery County,12,2298,1120,1178
Kansas,Montgomery County,13,2257,1127,1130
Kansas,Montgomery County,14,1913,933,980
Kansas,Montgomery County,15,1553,732,821
Kansas,Montgomery County,16,1216,539,677
Kansas,Montgomery County,17,786,333,453
Kansas,Montgomery County,18,921,292,629
Kansas,Morris County,0,5521,2761,2760
Kansas,Morris County,1,296,159,137
Kansas,Morris County,2,309,152,157
Kansas,Morris County,3,339,178,161
Kansas,Morris County,4,298,148,150
Kansas,Morris County,5,254,139,115
Kansas,Morris County,6,283,142,141
Kansas,Morris County,7,283,143,140
Kansas,Morris County,8,318,181,137
Kansas,Morris County,9,250,128,122
Kansas,Morris County,10,266,133,133
Kansas,Morris County,11,350,176,174
Kansas,Morris County,12,451,219,232
Kansas,Morris County,13,459,223,236
Kansas,Morris County,14,397,204,193
Kansas,Morris County,15,300,142,158
Kansas,Morris County,16,265,128,137
Kansas,Morris County,17,162,67,95
Kansas,Morris County,18,241,99,142
Kansas,Morton County,0,2667,1323,1344
Kansas,Morton County,1,136,65,71
Kansas,Morton County,2,193,104,89
Kansas,Morton County,3,192,97,95
Kansas,Morton County,4,191,91,100
Kansas,Morton County,5,131,73,58
Kansas,Morton County,6,97,51,46
Kansas,Morton County,7,131,70,61
Kansas,Morton County,8,163,77,86
Kansas,Morton County,9,160,82,78
Kansas,Morton County,10,162,80,82
Kansas,Morton County,11,167,90,77
Kansas,Morton County,12,204,105,99
Kansas,Morton County,13,199,99,100
Kansas,Morton County,14,154,83,71
Kansas,Morton County,15,102,49,53
Kansas,Morton County,16,99,49,50
Kansas,Morton County,17,74,23,51
Kansas,Morton County,18,112,35,77
Kansas,Nemaha County,0,10155,5140,5015
Kansas,Nemaha County,1,738,375,363
Kansas,Nemaha County,2,778,404,374
Kansas,Nemaha County,3,706,377,329
Kansas,Nemaha County,4,664,347,317
Kansas,Nemaha County,5,574,307,267
Kansas,Nemaha County,6,535,280,255
Kansas,Nemaha County,7,548,286,262
Kansas,Nemaha County,8,562,297,265
Kansas,Nemaha County,9,478,245,233
Kansas,Nemaha County,10,543,278,265
Kansas,Nemaha County,11,593,309,284
Kansas,Nemaha County,12,744,382,362
Kansas,Nemaha County,13,644,328,316
Kansas,Nemaha County,14,549,294,255
Kansas,Nemaha County,15,384,182,202
Kansas,Nemaha County,16,343,159,184
Kansas,Nemaha County,17,304,129,175
Kansas,Nemaha County,18,468,161,307
Kansas,Neosho County,0,15951,7902,8049
Kansas,Neosho County,1,1049,543,506
Kansas,Neosho County,2,1087,557,530
Kansas,Neosho County,3,1168,601,567
Kansas,Neosho County,4,1096,548,548
Kansas,Neosho County,5,882,463,419
Kansas,Neosho County,6,832,448,384
Kansas,Neosho County,7,871,420,451
Kansas,Neosho County,8,871,411,460
Kansas,Neosho County,9,855,435,420
Kansas,Neosho County,10,874,465,409
Kansas,Neosho County,11,936,470,466
Kansas,Neosho County,12,1144,579,565
Kansas,Neosho County,13,1122,555,567
Kansas,Neosho County,14,929,470,459
Kansas,Neosho County,15,753,346,407
Kansas,Neosho County,16,583,256,327
Kansas,Neosho County,17,403,167,236
Kansas,Neosho County,18,496,168,328
Kansas,Ness County,0,2840,1401,1439
Kansas,Ness County,1,165,89,76
Kansas,Ness County,2,167,70,97
Kansas,Ness County,3,178,91,87
Kansas,Ness County,4,167,87,80
Kansas,Ness County,5,135,62,73
Kansas,Ness County,6,114,58,56
Kansas,Ness County,7,137,72,65
Kansas,Ness County,8,144,80,64
Kansas,Ness County,9,120,65,55
Kansas,Ness County,10,134,75,59
Kansas,Ness County,11,139,66,73
Kansas,Ness County,12,268,142,126
Kansas,Ness County,13,237,117,120
Kansas,Ness County,14,209,99,110
Kansas,Ness County,15,132,67,65
Kansas,Ness County,16,136,59,77
Kansas,Ness County,17,111,56,55
Kansas,Ness County,18,147,46,101
Kansas,Norton County,0,5430,3035,2395
Kansas,Norton County,1,290,135,155
Kansas,Norton County,2,267,144,123
Kansas,Norton County,3,300,160,140
Kansas,Norton County,4,275,143,132
Kansas,Norton County,5,351,232,119
Kansas,Norton County,6,386,266,120
Kansas,Norton County,7,331,216,115
Kansas,Norton County,8,336,214,122
Kansas,Norton County,9,294,191,103
Kansas,Norton County,10,369,230,139
Kansas,Norton County,11,376,217,159
Kansas,Norton County,12,371,194,177
Kansas,Norton County,13,372,203,169
Kansas,Norton County,14,279,134,145
Kansas,Norton County,15,258,124,134
Kansas,Norton County,16,190,92,98
Kansas,Norton County,17,169,76,93
Kansas,Norton County,18,216,64,152
Kansas,Osage County,0,15941,7989,7952
Kansas,Osage County,1,915,493,422
Kansas,Osage County,2,973,474,499
Kansas,Osage County,3,1117,607,510
Kansas,Osage County,4,1059,555,504
Kansas,Osage County,5,807,430,377
Kansas,Osage County,6,795,407,388
Kansas,Osage County,7,808,396,412
Kansas,Osage County,8,913,462,451
Kansas,Osage County,9,873,433,440
Kansas,Osage County,10,923,432,491
Kansas,Osage County,11,1016,515,501
Kansas,Osage County,12,1331,645,686
Kansas,Osage County,13,1248,630,618
Kansas,Osage County,14,1021,521,500
Kansas,Osage County,15,772,385,387
Kansas,Osage County,16,578,257,321
Kansas,Osage County,17,388,171,217
Kansas,Osage County,18,404,176,228
Kansas,Osborne County,0,3475,1756,1719
Kansas,Osborne County,1,192,111,81
Kansas,Osborne County,2,197,108,89
Kansas,Osborne County,3,203,98,105
Kansas,Osborne County,4,183,101,82
Kansas,Osborne County,5,172,90,82
Kansas,Osborne County,6,185,101,84
Kansas,Osborne County,7,200,100,100
Kansas,Osborne County,8,189,100,89
Kansas,Osborne County,9,162,86,76
Kansas,Osborne County,10,145,72,73
Kansas,Osborne County,11,211,114,97
Kansas,Osborne County,12,277,127,150
Kansas,Osborne County,13,291,163,128
Kansas,Osborne County,14,220,109,111
Kansas,Osborne County,15,164,85,79
Kansas,Osborne County,16,168,73,95
Kansas,Osborne County,17,143,60,83
Kansas,Osborne County,18,173,58,115
Kansas,Ottawa County,0,5802,3009,2793
Kansas,Ottawa County,1,287,147,140
Kansas,Ottawa County,2,370,201,169
Kansas,Ottawa County,3,403,226,177
Kansas,Ottawa County,4,397,230,167
Kansas,Ottawa County,5,296,165,131
Kansas,Ottawa County,6,256,144,112
Kansas,Ottawa County,7,302,159,143
Kansas,Ottawa County,8,320,172,148
Kansas,Ottawa County,9,364,185,179
Kansas,Ottawa County,10,343,178,165
Kansas,Ottawa County,11,366,170,196
Kansas,Ottawa County,12,474,240,234
Kansas,Ottawa County,13,441,222,219
Kansas,Ottawa County,14,377,194,183
Kansas,Ottawa County,15,263,124,139
Kansas,Ottawa County,16,239,108,131
Kansas,Ottawa County,17,173,92,81
Kansas,Ottawa County,18,131,52,79
Kansas,Pawnee County,0,6562,3683,2879
Kansas,Pawnee County,1,269,139,130
Kansas,Pawnee County,2,270,140,130
Kansas,Pawnee County,3,262,135,127
Kansas,Pawnee County,4,463,352,111
Kansas,Pawnee County,5,362,202,160
Kansas,Pawnee County,6,419,262,157
Kansas,Pawnee County,7,404,248,156
Kansas,Pawnee County,8,442,271,171
Kansas,Pawnee County,9,402,228,174
Kansas,Pawnee County,10,442,289,153
Kansas,Pawnee County,11,425,263,162
Kansas,Pawnee County,12,506,264,242
Kansas,Pawnee County,13,519,264,255
Kansas,Pawnee County,14,436,232,204
Kansas,Pawnee County,15,289,147,142
Kansas,Pawnee County,16,231,92,139
Kansas,Pawnee County,17,196,89,107
Kansas,Pawnee County,18,225,66,159
Kansas,Phillips County,0,5317,2638,2679
Kansas,Phillips County,1,304,159,145
Kansas,Phillips County,2,331,173,158
Kansas,Phillips County,3,348,178,170
Kansas,Phillips County,4,346,162,184
Kansas,Phillips County,5,248,126,122
Kansas,Phillips County,6,263,138,125
Kansas,Phillips County,7,256,125,131
Kansas,Phillips County,8,304,171,133
Kansas,Phillips County,9,244,112,132
Kansas,Phillips County,10,281,144,137
Kansas,Phillips County,11,296,142,154
Kansas,Phillips County,12,419,192,227
Kansas,Phillips County,13,406,226,180
Kansas,Phillips County,14,415,209,206
Kansas,Phillips County,15,302,154,148
Kansas,Phillips County,16,203,96,107
Kansas,Phillips County,17,156,68,88
Kansas,Phillips County,18,195,63,132
Kansas,Pottawatomie County,0,24277,12063,12214
Kansas,Pottawatomie County,1,1889,916,973
Kansas,Pottawatomie County,2,2004,994,1010
Kansas,Pottawatomie County,3,2045,1074,971
Kansas,Pottawatomie County,4,1721,883,838
Kansas,Pottawatomie County,5,1393,710,683
Kansas,Pottawatomie County,6,1477,735,742
Kansas,Pottawatomie County,7,1550,764,786
Kansas,Pottawatomie County,8,1805,908,897
Kansas,Pottawatomie County,9,1402,740,662
Kansas,Pottawatomie County,10,1318,664,654
Kansas,Pottawatomie County,11,1270,638,632
Kansas,Pottawatomie County,12,1567,772,795
Kansas,Pottawatomie County,13,1373,675,698
Kansas,Pottawatomie County,14,1145,567,578
Kansas,Pottawatomie County,15,861,443,418
Kansas,Pottawatomie County,16,601,268,333
Kansas,Pottawatomie County,17,386,162,224
Kansas,Pottawatomie County,18,470,150,320
Kansas,Pratt County,0,9378,4638,4740
Kansas,Pratt County,1,653,332,321
Kansas,Pratt County,2,649,327,322
Kansas,Pratt County,3,642,333,309
Kansas,Pratt County,4,677,372,305
Kansas,Pratt County,5,597,334,263
Kansas,Pratt County,6,511,261,250
Kansas,Pratt County,7,518,263,255
Kansas,Pratt County,8,547,274,273
Kansas,Pratt County,9,471,226,245
Kansas,Pratt County,10,444,214,230
Kansas,Pratt County,11,445,221,224
Kansas,Pratt County,12,636,310,326
Kansas,Pratt County,13,693,336,357
Kansas,Pratt County,14,575,290,285
Kansas,Pratt County,15,385,177,208
Kansas,Pratt County,16,342,159,183
Kansas,Pratt County,17,239,103,136
Kansas,Pratt County,18,354,106,248
Kansas,Rawlins County,0,2508,1267,1241
Kansas,Rawlins County,1,157,83,74
Kansas,Rawlins County,2,160,87,73
Kansas,Rawlins County,3,139,75,64
Kansas,Rawlins County,4,116,53,63
Kansas,Rawlins County,5,100,50,50
Kansas,Rawlins County,6,133,70,63
Kansas,Rawlins County,7,122,64,58
Kansas,Rawlins County,8,140,80,60
Kansas,Rawlins County,9,103,56,47
Kansas,Rawlins County,10,110,66,44
Kansas,Rawlins County,11,142,68,74
Kansas,Rawlins County,12,187,91,96
Kansas,Rawlins County,13,199,104,95
Kansas,Rawlins County,14,188,85,103
Kansas,Rawlins County,15,164,85,79
Kansas,Rawlins County,16,134,74,60
Kansas,Rawlins County,17,101,40,61
Kansas,Rawlins County,18,113,36,77
Kansas,Reno County,0,62342,31304,31038
Kansas,Reno County,1,3457,1781,1676
Kansas,Reno County,2,3801,1917,1884
Kansas,Reno County,3,4148,2146,2002
Kansas,Reno County,4,4170,2158,2012
Kansas,Reno County,5,3664,2014,1650
Kansas,Reno County,6,3948,2171,1777
Kansas,Reno County,7,3773,2031,1742
Kansas,Reno County,8,3832,2009,1823
Kansas,Reno County,9,3378,1778,1600
Kansas,Reno County,10,3555,1844,1711
Kansas,Reno County,11,3572,1770,1802
Kansas,Reno County,12,4276,2092,2184
Kansas,Reno County,13,4448,2197,2251
Kansas,Reno County,14,3722,1815,1907
Kansas,Reno County,15,2861,1297,1564
Kansas,Reno County,16,2130,932,1198
Kansas,Reno County,17,1577,663,914
Kansas,Reno County,18,2030,689,1341
Kansas,Republic County,0,4664,2305,2359
Kansas,Republic County,1,256,143,113
Kansas,Republic County,2,272,130,142
Kansas,Republic County,3,267,140,127
Kansas,Republic County,4,252,128,124
Kansas,Republic County,5,212,107,105
Kansas,Republic County,6,208,104,104
Kansas,Republic County,7,203,112,91
Kansas,Republic County,8,254,145,109
Kansas,Republic County,9,193,88,105
Kansas,Republic County,10,210,103,107
Kansas,Republic County,11,269,133,136
Kansas,Republic County,12,368,177,191
Kansas,Republic County,13,406,206,200
Kansas,Republic County,14,357,185,172
Kansas,Republic County,15,263,129,134
Kansas,Republic County,16,222,114,108
Kansas,Republic County,17,187,65,122
Kansas,Republic County,18,265,96,169
Kansas,Rice County,0,9531,4760,4771
Kansas,Rice County,1,561,271,290
Kansas,Rice County,2,642,313,329
Kansas,Rice County,3,590,306,284
Kansas,Rice County,4,759,404,355
Kansas,Rice County,5,749,410,339
Kansas,Rice County,6,537,288,249
Kansas,Rice County,7,531,287,244
Kansas,Rice County,8,521,283,238
Kansas,Rice County,9,431,218,213
Kansas,Rice County,10,484,260,224
Kansas,Rice County,11,529,256,273
Kansas,Rice County,12,663,315,348
Kansas,Rice County,13,691,350,341
Kansas,Rice County,14,553,263,290
Kansas,Rice County,15,419,192,227
Kansas,Rice County,16,332,140,192
Kansas,Rice County,17,268,113,155
Kansas,Rice County,18,271,91,180
Kansas,Riley County,0,73703,38675,35028
Kansas,Riley County,1,4133,2073,2060
Kansas,Riley County,2,3411,1747,1664
Kansas,Riley County,3,2986,1538,1448
Kansas,Riley County,4,7242,3663,3579
Kansas,Riley County,5,18129,10389,7740
Kansas,Riley County,6,7410,4327,3083
Kansas,Riley County,7,5402,2880,2522
Kansas,Riley County,8,4250,2207,2043
Kansas,Riley County,9,3099,1555,1544
Kansas,Riley County,10,2559,1251,1308
Kansas,Riley County,11,2394,1224,1170
Kansas,Riley County,12,2778,1295,1483
Kansas,Riley County,13,2901,1373,1528
Kansas,Riley County,14,2393,1139,1254
Kansas,Riley County,15,1688,806,882
Kansas,Riley County,16,1097,495,602
Kansas,Riley County,17,747,312,435
Kansas,Riley County,18,1084,401,683
Kansas,Rooks County,0,5013,2419,2594
Kansas,Rooks County,1,318,166,152
Kansas,Rooks County,2,296,129,167
Kansas,Rooks County,3,321,148,173
Kansas,Rooks County,4,284,141,143
Kansas,Rooks County,5,243,129,114
Kansas,Rooks County,6,276,120,156
Kansas,Rooks County,7,288,140,148
Kansas,Rooks County,8,263,130,133
Kansas,Rooks County,9,255,130,125
Kansas,Rooks County,10,275,159,116
Kansas,Rooks County,11,300,143,157
Kansas,Rooks County,12,390,199,191
Kansas,Rooks County,13,391,193,198
Kansas,Rooks County,14,316,153,163
Kansas,Rooks County,15,268,127,141
Kansas,Rooks County,16,190,77,113
Kansas,Rooks County,17,163,77,86
Kansas,Rooks County,18,176,58,118
Kansas,Rush County,0,3093,1588,1505
Kansas,Rush County,1,167,95,72
Kansas,Rush County,2,170,100,70
Kansas,Rush County,3,192,95,97
Kansas,Rush County,4,184,109,75
Kansas,Rush County,5,147,80,67
Kansas,Rush County,6,138,74,64
Kansas,Rush County,7,146,75,71
Kansas,Rush County,8,150,70,80
Kansas,Rush County,9,168,80,88
Kansas,Rush County,10,170,98,72
Kansas,Rush County,11,189,101,88
Kansas,Rush County,12,239,125,114
Kansas,Rush County,13,265,130,135
Kansas,Rush County,14,223,116,107
Kansas,Rush County,15,167,77,90
Kansas,Rush County,16,115,58,57
Kansas,Rush County,17,116,50,66
Kansas,Rush County,18,147,55,92
Kansas,Russell County,0,6907,3406,3501
Kansas,Russell County,1,412,227,185
Kansas,Russell County,2,446,225,221
Kansas,Russell County,3,412,220,192
Kansas,Russell County,4,347,174,173
Kansas,Russell County,5,330,158,172
Kansas,Russell County,6,342,177,165
Kansas,Russell County,7,366,193,173
Kansas,Russell County,8,372,185,187
Kansas,Russell County,9,325,160,165
Kansas,Russell County,10,378,183,195
Kansas,Russell County,11,425,215,210
Kansas,Russell County,12,497,248,249
Kansas,Russell County,13,566,277,289
Kansas,Russell County,14,450,215,235
Kansas,Russell County,15,423,205,218
Kansas,Russell County,16,285,129,156
Kansas,Russell County,17,213,92,121
Kansas,Russell County,18,318,123,195
Kansas,Saline County,0,54401,26984,27417
Kansas,Saline County,1,3302,1692,1610
Kansas,Saline County,2,3505,1735,1770
Kansas,Saline County,3,3603,1840,1763
Kansas,Saline County,4,3578,1921,1657
Kansas,Saline County,5,3477,1808,1669
Kansas,Saline County,6,3472,1821,1651
Kansas,Saline County,7,3284,1676,1608
Kansas,Saline County,8,3286,1652,1634
Kansas,Saline County,9,2976,1433,1543
Kansas,Saline County,10,3277,1648,1629
Kansas,Saline County,11,3307,1672,1635
Kansas,Saline County,12,3916,1962,1954
Kansas,Saline County,13,3662,1781,1881
Kansas,Saline County,14,3028,1483,1545
Kansas,Saline County,15,2339,1080,1259
Kansas,Saline County,16,1679,731,948
Kansas,Saline County,17,1250,524,726
Kansas,Saline County,18,1460,525,935
Kansas,Scott County,0,4897,2467,2430
Kansas,Scott County,1,319,159,160
Kansas,Scott County,2,372,194,178
Kansas,Scott County,3,409,217,192
Kansas,Scott County,4,326,166,160
Kansas,Scott County,5,267,145,122
Kansas,Scott County,6,298,161,137
Kansas,Scott County,7,266,140,126
Kansas,Scott County,8,245,119,126
Kansas,Scott County,9,276,136,140
Kansas,Scott County,10,264,142,122
Kansas,Scott County,11,280,150,130
Kansas,Scott County,12,321,142,179
Kansas,Scott County,13,306,140,166
Kansas,Scott County,14,315,177,138
Kansas,Scott County,15,188,91,97
Kansas,Scott County,16,165,75,90
Kansas,Scott County,17,121,62,59
Kansas,Scott County,18,159,51,108
Kansas,Sedgwick County,0,513607,254106,259501
Kansas,Sedgwick County,1,35500,18130,17370
Kansas,Sedgwick County,2,37682,19389,18293
Kansas,Sedgwick County,3,37034,18678,18356
Kansas,Sedgwick County,4,34326,17552,16774
Kansas,Sedgwick County,5,34816,18096,16720
Kansas,Sedgwick County,6,37913,19334,18579
Kansas,Sedgwick County,7,35160,17400,17760
Kansas,Sedgwick County,8,34050,16877,17173
Kansas,Sedgwick County,9,29069,14364,14705
Kansas,Sedgwick County,10,29233,14365,14868
Kansas,Sedgwick County,11,29392,14706,14686
Kansas,Sedgwick County,12,33490,16347,17143
Kansas,Sedgwick County,13,31455,15280,16175
Kansas,Sedgwick County,14,25448,12311,13137
Kansas,Sedgwick County,15,18606,8651,9955
Kansas,Sedgwick County,16,12166,5407,6759
Kansas,Sedgwick County,17,8663,3666,4997
Kansas,Sedgwick County,18,9604,3553,6051
Kansas,Seward County,0,21780,11052,10728
Kansas,Seward County,1,2000,974,1026
Kansas,Seward County,2,1988,977,1011
Kansas,Seward County,3,1873,945,928
Kansas,Seward County,4,1741,887,854
Kansas,Seward County,5,1603,851,752
Kansas,Seward County,6,1749,948,801
Kansas,Seward County,7,1549,810,739
Kansas,Seward County,8,1294,669,625
Kansas,Seward County,9,1300,686,614
Kansas,Seward County,10,1249,635,614
Kansas,Seward County,11,1198,660,538
Kansas,Seward County,12,1148,578,570
Kansas,Seward County,13,958,492,466
Kansas,Seward County,14,706,354,352
Kansas,Seward County,15,492,229,263
Kansas,Seward County,16,381,177,204
Kansas,Seward County,17,260,95,165
Kansas,Seward County,18,291,85,206
Kansas,Shawnee County,0,177499,85958,91541
Kansas,Shawnee County,1,11020,5606,5414
Kansas,Shawnee County,2,11775,5971,5804
Kansas,Shawnee County,3,11854,6082,5772
Kansas,Shawnee County,4,11622,6060,5562
Kansas,Shawnee County,5,10583,5233,5350
Kansas,Shawnee County,6,11157,5558,5599
Kansas,Shawnee County,7,10898,5237,5661
Kansas,Shawnee County,8,11267,5568,5699
Kansas,Shawnee County,9,9755,4801,4954
Kansas,Shawnee County,10,10140,4912,5228
Kansas,Shawnee County,11,10783,5312,5471
Kansas,Shawnee County,12,12224,5717,6507
Kansas,Shawnee County,13,12125,5669,6456
Kansas,Shawnee County,14,10635,4977,5658
Kansas,Shawnee County,15,7881,3733,4148
Kansas,Shawnee County,16,5557,2408,3149
Kansas,Shawnee County,17,3867,1637,2230
Kansas,Shawnee County,18,4356,1477,2879
Kansas,Sheridan County,0,2533,1274,1259
Kansas,Sheridan County,1,171,89,82
Kansas,Sheridan County,2,165,84,81
Kansas,Sheridan County,3,191,93,98
Kansas,Sheridan County,4,159,86,73
Kansas,Sheridan County,5,122,61,61
Kansas,Sheridan County,6,116,62,54
Kansas,Sheridan County,7,120,62,58
Kansas,Sheridan County,8,142,78,64
Kansas,Sheridan County,9,123,57,66
Kansas,Sheridan County,10,117,57,60
Kansas,Sheridan County,11,130,66,64
Kansas,Sheridan County,12,197,109,88
Kansas,Sheridan County,13,196,103,93
Kansas,Sheridan County,14,169,82,87
Kansas,Sheridan County,15,129,71,58
Kansas,Sheridan County,16,89,37,52
Kansas,Sheridan County,17,74,34,40
Kansas,Sheridan County,18,123,43,80
Kansas,Sherman County,0,5899,2959,2940
Kansas,Sherman County,1,399,213,186
Kansas,Sherman County,2,397,210,187
Kansas,Sherman County,3,380,174,206
Kansas,Sherman County,4,375,207,168
Kansas,Sherman County,5,350,195,155
Kansas,Sherman County,6,354,194,160
Kansas,Sherman County,7,367,176,191
Kansas,Sherman County,8,377,194,183
Kansas,Sherman County,9,288,134,154
Kansas,Sherman County,10,282,147,135
Kansas,Sherman County,11,315,158,157
Kansas,Sherman County,12,446,228,218
Kansas,Sherman County,13,432,208,224
Kansas,Sherman County,14,330,168,162
Kansas,Sherman County,15,258,130,128
Kansas,Sherman County,16,218,92,126
Kansas,Sherman County,17,168,76,92
Kansas,Sherman County,18,163,55,108
Kansas,Smith County,0,3603,1792,1811
Kansas,Smith County,1,206,96,110
Kansas,Smith County,2,190,94,96
Kansas,Smith County,3,206,112,94
Kansas,Smith County,4,196,99,97
Kansas,Smith County,5,164,80,84
Kansas,Smith County,6,163,94,69
Kansas,Smith County,7,129,62,67
Kansas,Smith County,8,197,100,97
Kansas,Smith County,9,172,87,85
Kansas,Smith County,10,160,89,71
Kansas,Smith County,11,196,93,103
Kansas,Smith County,12,317,154,163
Kansas,Smith County,13,310,159,151
Kansas,Smith County,14,289,155,134
Kansas,Smith County,15,203,106,97
Kansas,Smith County,16,154,63,91
Kansas,Smith County,17,143,59,84
Kansas,Smith County,18,208,90,118
Kansas,Stafford County,0,4178,2121,2057
Kansas,Stafford County,1,269,133,136
Kansas,Stafford County,2,266,143,123
Kansas,Stafford County,3,283,147,136
Kansas,Stafford County,4,277,169,108
Kansas,Stafford County,5,209,118,91
Kansas,Stafford County,6,189,90,99
Kansas,Stafford County,7,221,115,106
Kansas,Stafford County,8,224,122,102
Kansas,Stafford County,9,175,77,98
Kansas,Stafford County,10,201,100,101
Kansas,Stafford County,11,269,126,143
Kansas,Stafford County,12,335,178,157
Kansas,Stafford County,13,333,173,160
Kansas,Stafford County,14,251,129,122
Kansas,Stafford County,15,209,96,113
Kansas,Stafford County,16,165,81,84
Kansas,Stafford County,17,123,58,65
Kansas,Stafford County,18,179,66,113
Kansas,Stanton County,0,1987,990,997
Kansas,Stanton County,1,138,72,66
Kansas,Stanton County,2,151,70,81
Kansas,Stanton County,3,139,62,77
Kansas,Stanton County,4,162,90,72
Kansas,Stanton County,5,109,60,49
Kansas,Stanton County,6,97,45,52
Kansas,Stanton County,7,111,68,43
Kansas,Stanton County,8,119,52,67
Kansas,Stanton County,9,124,68,56
Kansas,Stanton County,10,117,54,63
Kansas,Stanton County,11,109,57,52
Kansas,Stanton County,12,123,62,61
Kansas,Stanton County,13,138,72,66
Kansas,Stanton County,14,95,49,46
Kansas,Stanton County,15,83,33,50
Kansas,Stanton County,16,56,25,31
Kansas,Stanton County,17,55,24,31
Kansas,Stanton County,18,61,27,34
Kansas,Stevens County,0,5559,2754,2805
Kansas,Stevens County,1,343,181,162
Kansas,Stevens County,2,486,224,262
Kansas,Stevens County,3,502,215,287
Kansas,Stevens County,4,416,212,204
Kansas,Stevens County,5,313,173,140
Kansas,Stevens County,6,316,162,154
Kansas,Stevens County,7,273,123,150
Kansas,Stevens County,8,355,177,178
Kansas,Stevens County,9,302,167,135
Kansas,Stevens County,10,340,179,161
Kansas,Stevens County,11,344,193,151
Kansas,Stevens County,12,362,183,179
Kansas,Stevens County,13,323,173,150
Kansas,Stevens County,14,254,127,127
Kansas,Stevens County,15,209,99,110
Kansas,Stevens County,16,151,63,88
Kansas,Stevens County,17,105,46,59
Kansas,Stevens County,18,165,57,108
Kansas,Sumner County,0,22996,11519,11477
Kansas,Sumner County,1,1349,680,669
Kansas,Sumner County,2,1636,827,809
Kansas,Sumner County,3,1620,842,778
Kansas,Sumner County,4,1563,823,740
Kansas,Sumner County,5,1210,635,575
Kansas,Sumner County,6,1281,651,630
Kansas,Sumner County,7,1321,681,640
Kansas,Sumner County,8,1343,697,646
Kansas,Sumner County,9,1323,680,643
Kansas,Sumner County,10,1221,622,599
Kansas,Sumner County,11,1388,673,715
Kansas,Sumner County,12,1684,854,830
Kansas,Sumner County,13,1754,872,882
Kansas,Sumner County,14,1413,718,695
Kansas,Sumner County,15,970,485,485
Kansas,Sumner County,16,730,340,390
Kansas,Sumner County,17,561,224,337
Kansas,Sumner County,18,629,215,414
Kansas,Thomas County,0,7711,3775,3936
Kansas,Thomas County,1,561,281,280
Kansas,Thomas County,2,510,279,231
Kansas,Thomas County,3,469,228,241
Kansas,Thomas County,4,619,299,320
Kansas,Thomas County,5,635,290,345
Kansas,Thomas County,6,496,230,266
Kansas,Thomas County,7,482,257,225
Kansas,Thomas County,8,392,207,185
Kansas,Thomas County,9,418,217,201
Kansas,Thomas County,10,373,187,186
Kansas,Thomas County,11,359,175,184
Kansas,Thomas County,12,531,261,270
Kansas,Thomas County,13,504,246,258
Kansas,Thomas County,14,425,222,203
Kansas,Thomas County,15,282,138,144
Kansas,Thomas County,16,239,100,139
Kansas,Thomas County,17,185,76,109
Kansas,Thomas County,18,231,82,149
Kansas,Trego County,0,2793,1418,1375
Kansas,Trego County,1,135,84,51
Kansas,Trego County,2,134,74,60
Kansas,Trego County,3,137,67,70
Kansas,Trego County,4,150,73,77
Kansas,Trego County,5,118,58,60
Kansas,Trego County,6,134,78,56
Kansas,Trego County,7,148,79,69
Kansas,Trego County,8,154,73,81
Kansas,Trego County,9,118,59,59
Kansas,Trego County,10,165,88,77
Kansas,Trego County,11,158,73,85
Kansas,Trego County,12,245,121,124
Kansas,Trego County,13,257,127,130
Kansas,Trego County,14,237,120,117
Kansas,Trego County,15,157,84,73
Kansas,Trego County,16,122,61,61
Kansas,Trego County,17,97,44,53
Kansas,Trego County,18,127,55,72
Kansas,Wabaunsee County,0,6899,3527,3372
Kansas,Wabaunsee County,1,398,217,181
Kansas,Wabaunsee County,2,441,246,195
Kansas,Wabaunsee County,3,464,244,220
Kansas,Wabaunsee County,4,466,237,229
Kansas,Wabaunsee County,5,330,166,164
Kansas,Wabaunsee County,6,325,157,168
Kansas,Wabaunsee County,7,335,174,161
Kansas,Wabaunsee County,8,380,189,191
Kansas,Wabaunsee County,9,390,203,187
Kansas,Wabaunsee County,10,371,177,194
Kansas,Wabaunsee County,11,438,225,213
Kansas,Wabaunsee County,12,603,302,301
Kansas,Wabaunsee County,13,577,300,277
Kansas,Wabaunsee County,14,464,247,217
Kansas,Wabaunsee County,15,337,179,158
Kansas,Wabaunsee County,16,242,120,122
Kansas,Wabaunsee County,17,180,88,92
Kansas,Wabaunsee County,18,158,56,102
Kansas,Wallace County,0,1503,750,753
Kansas,Wallace County,1,119,61,58
Kansas,Wallace County,2,94,43,51
Kansas,Wallace County,3,97,38,59
Kansas,Wallace County,4,107,55,52
Kansas,Wallace County,5,74,45,29
Kansas,Wallace County,6,71,28,43
Kansas,Wallace County,7,81,42,39
Kansas,Wallace County,8,74,35,39
Kansas,Wallace County,9,62,33,29
Kansas,Wallace County,10,59,32,27
Kansas,Wallace County,11,87,46,41
Kansas,Wallace County,12,117,56,61
Kansas,Wallace County,13,111,67,44
Kansas,Wallace County,14,99,49,50
Kansas,Wallace County,15,84,48,36
Kansas,Wallace County,16,48,29,19
Kansas,Wallace County,17,47,16,31
Kansas,Wallace County,18,72,27,45
Kansas,Washington County,0,5420,2767,2653
Kansas,Washington County,1,359,188,171
Kansas,Washington County,2,333,190,143
Kansas,Washington County,3,328,167,161
Kansas,Washington County,4,298,160,138
Kansas,Washington County,5,308,165,143
Kansas,Washington County,6,255,131,124
Kansas,Washington County,7,246,115,131
Kansas,Washington County,8,313,180,133
Kansas,Washington County,9,250,137,113
Kansas,Washington County,10,278,151,127
Kansas,Washington County,11,336,170,166
Kansas,Washington County,12,419,217,202
Kansas,Washington County,13,399,206,193
Kansas,Washington County,14,339,169,170
Kansas,Washington County,15,277,142,135
Kansas,Washington County,16,234,102,132
Kansas,Washington County,17,194,82,112
Kansas,Washington County,18,254,95,159
Kansas,Wichita County,0,2105,1073,1032
Kansas,Wichita County,1,117,65,52
Kansas,Wichita County,2,186,95,91
Kansas,Wichita County,3,144,65,79
Kansas,Wichita County,4,165,71,94
Kansas,Wichita County,5,109,67,42
Kansas,Wichita County,6,108,53,55
Kansas,Wichita County,7,95,52,43
Kansas,Wichita County,8,107,47,60
Kansas,Wichita County,9,122,72,50
Kansas,Wichita County,10,130,72,58
Kansas,Wichita County,11,101,56,45
Kansas,Wichita County,12,138,70,68
Kansas,Wichita County,13,157,87,70
Kansas,Wichita County,14,130,69,61
Kansas,Wichita County,15,91,44,47
Kansas,Wichita County,16,69,31,38
Kansas,Wichita County,17,59,26,33
Kansas,Wichita County,18,77,31,46
Kansas,Wilson County,0,8665,4289,4376
Kansas,Wilson County,1,544,281,263
Kansas,Wilson County,2,590,304,286
Kansas,Wilson County,3,584,283,301
Kansas,Wilson County,4,557,298,259
Kansas,Wilson County,5,404,221,183
Kansas,Wilson County,6,458,233,225
Kansas,Wilson County,7,464,226,238
Kansas,Wilson County,8,513,253,260
Kansas,Wilson County,9,421,220,201
Kansas,Wilson County,10,504,257,247
Kansas,Wilson County,11,475,227,248
Kansas,Wilson County,12,602,299,303
Kansas,Wilson County,13,695,341,354
Kansas,Wilson County,14,581,281,300
Kansas,Wilson County,15,474,232,242
Kansas,Wilson County,16,342,165,177
Kansas,Wilson County,17,206,90,116
Kansas,Wilson County,18,251,78,173
Kansas,Woodson County,0,3183,1601,1582
Kansas,Woodson County,1,168,93,75
Kansas,Woodson County,2,181,98,83
Kansas,Woodson County,3,194,92,102
Kansas,Woodson County,4,196,103,93
Kansas,Woodson County,5,133,64,69
Kansas,Woodson County,6,160,83,77
Kansas,Woodson County,7,168,79,89
Kansas,Woodson County,8,211,99,112
Kansas,Woodson County,9,138,92,46
Kansas,Woodson County,10,147,84,63
Kansas,Woodson County,11,195,90,105
Kansas,Woodson County,12,263,129,134
Kansas,Woodson County,13,256,131,125
Kansas,Woodson County,14,263,133,130
Kansas,Woodson County,15,178,85,93
Kansas,Woodson County,16,124,61,63
Kansas,Woodson County,17,83,31,52
Kansas,Woodson County,18,125,54,71
Kansas,Wyandotte County,0,165324,82022,83302
Kansas,Wyandotte County,1,13195,6873,6322
Kansas,Wyandotte County,2,13071,6670,6401
Kansas,Wyandotte County,3,12854,6588,6266
Kansas,Wyandotte County,4,10722,5463,5259
Kansas,Wyandotte County,5,10318,4984,5334
Kansas,Wyandotte County,6,12908,6502,6406
Kansas,Wyandotte County,7,12036,6250,5786
Kansas,Wyandotte County,8,11593,5780,5813
Kansas,Wyandotte County,9,9910,5051,4859
Kansas,Wyandotte County,10,9666,4905,4761
Kansas,Wyandotte County,11,9250,4650,4600
Kansas,Wyandotte County,12,10188,5000,5188
Kansas,Wyandotte County,13,9332,4519,4813
Kansas,Wyandotte County,14,7221,3343,3878
Kansas,Wyandotte County,15,4959,2177,2782
Kansas,Wyandotte County,16,3380,1498,1882
Kansas,Wyandotte County,17,2212,896,1316
Kansas,Wyandotte County,18,2509,873,1636
Kentucky,Adair County,0,19215,9508,9707
Kentucky,Adair County,1,1059,542,517
Kentucky,Adair County,2,977,520,457
Kentucky,Adair County,3,1129,591,538
Kentucky,Adair County,4,1521,801,720
Kentucky,Adair County,5,1467,760,707
Kentucky,Adair County,6,1236,622,614
Kentucky,Adair County,7,1009,499,510
Kentucky,Adair County,8,1027,495,532
Kentucky,Adair County,9,1028,495,533
Kentucky,Adair County,10,1180,604,576
Kentucky,Adair County,11,1328,633,695
Kentucky,Adair County,12,1406,657,749
Kentucky,Adair County,13,1277,623,654
Kentucky,Adair County,14,1185,589,596
Kentucky,Adair County,15,915,458,457
Kentucky,Adair County,16,666,300,366
Kentucky,Adair County,17,433,193,240
Kentucky,Adair County,18,372,126,246
Kentucky,Allen County,0,21122,10446,10676
Kentucky,Allen County,1,1253,629,624
Kentucky,Allen County,2,1385,713,672
Kentucky,Allen County,3,1365,695,670
Kentucky,Allen County,4,1338,697,641
Kentucky,Allen County,5,1096,571,525
Kentucky,Allen County,6,1482,724,758
Kentucky,Allen County,7,1207,610,597
Kentucky,Allen County,8,1194,583,611
Kentucky,Allen County,9,1254,625,629
Kentucky,Allen County,10,1459,723,736
Kentucky,Allen County,11,1472,726,746
Kentucky,Allen County,12,1497,724,773
Kentucky,Allen County,13,1395,714,681
Kentucky,Allen County,14,1235,596,639
Kentucky,Allen County,15,1022,462,560
Kentucky,Allen County,16,708,344,364
Kentucky,Allen County,17,442,191,251
Kentucky,Allen County,18,318,119,199
Kentucky,Anderson County,0,22663,11107,11556
Kentucky,Anderson County,1,1384,739,645
Kentucky,Anderson County,2,1442,755,687
Kentucky,Anderson County,3,1616,836,780
Kentucky,Anderson County,4,1407,742,665
Kentucky,Anderson County,5,1189,586,603
Kentucky,Anderson County,6,1435,694,741
Kentucky,Anderson County,7,1284,623,661
Kentucky,Anderson County,8,1380,665,715
Kentucky,Anderson County,9,1510,736,774
Kentucky,Anderson County,10,1692,842,850
Kentucky,Anderson County,11,1665,817,848
Kentucky,Anderson County,12,1699,820,879
Kentucky,Anderson County,13,1388,714,674
Kentucky,Anderson County,14,1232,560,672
Kentucky,Anderson County,15,926,416,510
Kentucky,Anderson County,16,630,281,349
Kentucky,Anderson County,17,408,188,220
Kentucky,Anderson County,18,376,93,283
Kentucky,Ballard County,0,7979,3977,4002
Kentucky,Ballard County,1,396,210,186
Kentucky,Ballard County,2,482,253,229
Kentucky,Ballard County,3,503,259,244
Kentucky,Ballard County,4,512,285,227
Kentucky,Ballard County,5,404,220,184
Kentucky,Ballard County,6,431,222,209
Kentucky,Ballard County,7,433,216,217
Kentucky,Ballard County,8,446,216,230
Kentucky,Ballard County,9,478,256,222
Kentucky,Ballard County,10,546,260,286
Kentucky,Ballard County,11,516,258,258
Kentucky,Ballard County,12,552,259,293
Kentucky,Ballard County,13,610,300,310
Kentucky,Ballard County,14,522,270,252
Kentucky,Ballard County,15,428,181,247
Kentucky,Ballard County,16,303,138,165
Kentucky,Ballard County,17,216,105,111
Kentucky,Ballard County,18,201,69,132
Kentucky,Barren County,0,44176,21353,22823
Kentucky,Barren County,1,2905,1472,1433
Kentucky,Barren County,2,2746,1391,1355
Kentucky,Barren County,3,2986,1495,1491
Kentucky,Barren County,4,2680,1365,1315
Kentucky,Barren County,5,2455,1251,1204
Kentucky,Barren County,6,2786,1418,1368
Kentucky,Barren County,7,2547,1237,1310
Kentucky,Barren County,8,2768,1379,1389
Kentucky,Barren County,9,2619,1271,1348
Kentucky,Barren County,10,2852,1409,1443
Kentucky,Barren County,11,2948,1423,1525
Kentucky,Barren County,12,3166,1513,1653
Kentucky,Barren County,13,2900,1397,1503
Kentucky,Barren County,14,2477,1166,1311
Kentucky,Barren County,15,1961,897,1064
Kentucky,Barren County,16,1478,613,865
Kentucky,Barren County,17,951,386,565
Kentucky,Barren County,18,951,270,681
Kentucky,Bath County,0,12383,6111,6272
Kentucky,Bath County,1,828,431,397
Kentucky,Bath County,2,846,437,409
Kentucky,Bath County,3,914,467,447
Kentucky,Bath County,4,806,429,377
Kentucky,Bath County,5,707,360,347
Kentucky,Bath County,6,738,358,380
Kentucky,Bath County,7,605,272,333
Kentucky,Bath County,8,733,330,403
Kentucky,Bath County,9,763,406,357
Kentucky,Bath County,10,835,401,434
Kentucky,Bath County,11,866,426,440
Kentucky,Bath County,12,853,451,402
Kentucky,Bath County,13,809,379,430
Kentucky,Bath County,14,703,357,346
Kentucky,Bath County,15,533,252,281
Kentucky,Bath County,16,363,166,197
Kentucky,Bath County,17,255,102,153
Kentucky,Bath County,18,226,87,139
Kentucky,Bell County,0,26569,13024,13545
Kentucky,Bell County,1,1565,784,781
Kentucky,Bell County,2,1542,807,735
Kentucky,Bell County,3,1571,776,795
Kentucky,Bell County,4,1516,823,693
Kentucky,Bell County,5,1574,847,727
Kentucky,Bell County,6,1762,877,885
Kentucky,Bell County,7,1523,796,727
Kentucky,Bell County,8,1475,748,727
Kentucky,Bell County,9,1561,758,803
Kentucky,Bell County,10,1777,898,879
Kentucky,Bell County,11,1811,845,966
Kentucky,Bell County,12,1939,956,983
Kentucky,Bell County,13,1848,881,967
Kentucky,Bell County,14,1668,816,852
Kentucky,Bell County,15,1344,589,755
Kentucky,Bell County,16,968,421,547
Kentucky,Bell County,17,565,226,339
Kentucky,Bell County,18,560,176,384
Kentucky,Boone County,0,131533,65164,66369
Kentucky,Boone County,1,8606,4408,4198
Kentucky,Boone County,2,9271,4722,4549
Kentucky,Boone County,3,10177,5208,4969
Kentucky,Boone County,4,9200,4701,4499
Kentucky,Boone County,5,7520,3879,3641
Kentucky,Boone County,6,8052,4095,3957
Kentucky,Boone County,7,8127,4046,4081
Kentucky,Boone County,8,9122,4463,4659
Kentucky,Boone County,9,8756,4334,4422
Kentucky,Boone County,10,9370,4728,4642
Kentucky,Boone County,11,9113,4529,4584
Kentucky,Boone County,12,8762,4301,4461
Kentucky,Boone County,13,7653,3746,3907
Kentucky,Boone County,14,6279,2903,3376
Kentucky,Boone County,15,4847,2272,2575
Kentucky,Boone County,16,3176,1451,1725
Kentucky,Boone County,17,1815,764,1051
Kentucky,Boone County,18,1687,614,1073
Kentucky,Bourbon County,0,20184,9838,10346
Kentucky,Bourbon County,1,1226,631,595
Kentucky,Bourbon County,2,1271,673,598
Kentucky,Bourbon County,3,1336,672,664
Kentucky,Bourbon County,4,1211,626,585
Kentucky,Bourbon County,5,1152,627,525
Kentucky,Bourbon County,6,1283,641,642
Kentucky,Bourbon County,7,1013,486,527
Kentucky,Bourbon County,8,1097,538,559
Kentucky,Bourbon County,9,1225,587,638
Kentucky,Bourbon County,10,1384,640,744
Kentucky,Bourbon County,11,1346,647,699
Kentucky,Bourbon County,12,1487,743,744
Kentucky,Bourbon County,13,1338,638,700
Kentucky,Bourbon County,14,1167,547,620
Kentucky,Bourbon County,15,950,456,494
Kentucky,Bourbon County,16,743,325,418
Kentucky,Bourbon County,17,478,185,293
Kentucky,Bourbon County,18,477,176,301
Kentucky,Boyd County,0,47240,23510,23730
Kentucky,Boyd County,1,2631,1340,1291
Kentucky,Boyd County,2,2765,1391,1374
Kentucky,Boyd County,3,2849,1423,1426
Kentucky,Boyd County,4,2669,1455,1214
Kentucky,Boyd County,5,2401,1232,1169
Kentucky,Boyd County,6,2954,1596,1358
Kentucky,Boyd County,7,2744,1411,1333
Kentucky,Boyd County,8,3014,1601,1413
Kentucky,Boyd County,9,2867,1496,1371
Kentucky,Boyd County,10,3077,1594,1483
Kentucky,Boyd County,11,3224,1666,1558
Kentucky,Boyd County,12,3352,1642,1710
Kentucky,Boyd County,13,3472,1637,1835
Kentucky,Boyd County,14,2872,1367,1505
Kentucky,Boyd County,15,2373,1113,1260
Kentucky,Boyd County,16,1672,763,909
Kentucky,Boyd County,17,1191,433,758
Kentucky,Boyd County,18,1113,350,763
Kentucky,Boyle County,0,30100,14993,15107
Kentucky,Boyle County,1,1605,796,809
Kentucky,Boyle County,2,1609,879,730
Kentucky,Boyle County,3,1736,874,862
Kentucky,Boyle County,4,2182,1092,1090
Kentucky,Boyle County,5,2483,1297,1186
Kentucky,Boyle County,6,1916,1107,809
Kentucky,Boyle County,7,1707,989,718
Kentucky,Boyle County,8,1657,838,819
Kentucky,Boyle County,9,1739,904,835
Kentucky,Boyle County,10,1968,1046,922
Kentucky,Boyle County,11,1883,903,980
Kentucky,Boyle County,12,1946,928,1018
Kentucky,Boyle County,13,1912,906,1006
Kentucky,Boyle County,14,1774,801,973
Kentucky,Boyle County,15,1418,648,770
Kentucky,Boyle County,16,1018,440,578
Kentucky,Boyle County,17,706,279,427
Kentucky,Boyle County,18,841,266,575
Kentucky,Bracken County,0,8239,4129,4110
Kentucky,Bracken County,1,491,251,240
Kentucky,Bracken County,2,533,275,258
Kentucky,Bracken County,3,568,295,273
Kentucky,Bracken County,4,501,268,233
Kentucky,Bracken County,5,433,228,205
Kentucky,Bracken County,6,510,243,267
Kentucky,Bracken County,7,464,233,231
Kentucky,Bracken County,8,494,253,241
Kentucky,Bracken County,9,477,244,233
Kentucky,Bracken County,10,550,272,278
Kentucky,Bracken County,11,614,308,306
Kentucky,Bracken County,12,636,314,322
Kentucky,Bracken County,13,598,313,285
Kentucky,Bracken County,14,504,252,252
Kentucky,Bracken County,15,335,164,171
Kentucky,Bracken County,16,239,105,134
Kentucky,Bracken County,17,163,64,99
Kentucky,Bracken County,18,129,47,82
Kentucky,Breathitt County,0,12726,6366,6360
Kentucky,Breathitt County,1,747,370,377
Kentucky,Breathitt County,2,682,378,304
Kentucky,Breathitt County,3,708,362,346
Kentucky,Breathitt County,4,695,394,301
Kentucky,Breathitt County,5,719,377,342
Kentucky,Breathitt County,6,862,443,419
Kentucky,Breathitt County,7,691,350,341
Kentucky,Breathitt County,8,791,400,391
Kentucky,Breathitt County,9,847,438,409
Kentucky,Breathitt County,10,888,429,459
Kentucky,Breathitt County,11,969,480,489
Kentucky,Breathitt County,12,968,505,463
Kentucky,Breathitt County,13,966,461,505
Kentucky,Breathitt County,14,800,391,409
Kentucky,Breathitt County,15,598,276,322
Kentucky,Breathitt County,16,372,158,214
Kentucky,Breathitt County,17,220,83,137
Kentucky,Breathitt County,18,203,71,132
Kentucky,Breckinridge County,0,20388,10249,10139
Kentucky,Breckinridge County,1,1270,667,603
Kentucky,Breckinridge County,2,1206,641,565
Kentucky,Breckinridge County,3,1353,659,694
Kentucky,Breckinridge County,4,1276,703,573
Kentucky,Breckinridge County,5,1055,540,515
Kentucky,Breckinridge County,6,1107,579,528
Kentucky,Breckinridge County,7,1005,510,495
Kentucky,Breckinridge County,8,1220,621,599
Kentucky,Breckinridge County,9,1166,612,554
Kentucky,Breckinridge County,10,1279,599,680
Kentucky,Breckinridge County,11,1412,709,703
Kentucky,Breckinridge County,12,1593,803,790
Kentucky,Breckinridge County,13,1505,753,752
Kentucky,Breckinridge County,14,1349,668,681
Kentucky,Breckinridge County,15,1062,514,548
Kentucky,Breckinridge County,16,727,338,389
Kentucky,Breckinridge County,17,430,198,232
Kentucky,Breckinridge County,18,373,135,238
Kentucky,Bullitt County,0,81069,40302,40767
Kentucky,Bullitt County,1,4328,2234,2094
Kentucky,Bullitt County,2,4825,2542,2283
Kentucky,Bullitt County,3,5306,2708,2598
Kentucky,Bullitt County,4,5063,2622,2441
Kentucky,Bullitt County,5,4586,2323,2263
Kentucky,Bullitt County,6,5510,2796,2714
Kentucky,Bullitt County,7,5002,2473,2529
Kentucky,Bullitt County,8,5413,2709,2704
Kentucky,Bullitt County,9,5312,2637,2675
Kentucky,Bullitt County,10,5756,2871,2885
Kentucky,Bullitt County,11,5990,2939,3051
Kentucky,Bullitt County,12,6026,3005,3021
Kentucky,Bullitt County,13,5300,2586,2714
Kentucky,Bullitt County,14,4394,2078,2316
Kentucky,Bullitt County,15,3501,1674,1827
Kentucky,Bullitt County,16,2367,1112,1255
Kentucky,Bullitt County,17,1316,569,747
Kentucky,Bullitt County,18,1074,424,650
Kentucky,Butler County,0,12772,6413,6359
Kentucky,Butler County,1,798,415,383
Kentucky,Butler County,2,783,399,384
Kentucky,Butler County,3,791,410,381
Kentucky,Butler County,4,741,400,341
Kentucky,Butler County,5,622,309,313
Kentucky,Butler County,6,749,384,365
Kentucky,Butler County,7,767,374,393
Kentucky,Butler County,8,824,436,388
Kentucky,Butler County,9,786,415,371
Kentucky,Butler County,10,833,446,387
Kentucky,Butler County,11,847,399,448
Kentucky,Butler County,12,905,458,447
Kentucky,Butler County,13,926,445,481
Kentucky,Butler County,14,773,390,383
Kentucky,Butler County,15,607,304,303
Kentucky,Butler County,16,477,232,245
Kentucky,Butler County,17,280,117,163
Kentucky,Butler County,18,263,80,183
Kentucky,Caldwell County,0,12715,6130,6585
Kentucky,Caldwell County,1,738,371,367
Kentucky,Caldwell County,2,796,408,388
Kentucky,Caldwell County,3,806,403,403
Kentucky,Caldwell County,4,777,392,385
Kentucky,Caldwell County,5,654,335,319
Kentucky,Caldwell County,6,797,383,414
Kentucky,Caldwell County,7,669,302,367
Kentucky,Caldwell County,8,671,332,339
Kentucky,Caldwell County,9,761,372,389
Kentucky,Caldwell County,10,841,430,411
Kentucky,Caldwell County,11,772,381,391
Kentucky,Caldwell County,12,887,441,446
Kentucky,Caldwell County,13,894,429,465
Kentucky,Caldwell County,14,808,373,435
Kentucky,Caldwell County,15,684,307,377
Kentucky,Caldwell County,16,488,222,266
Kentucky,Caldwell County,17,317,134,183
Kentucky,Caldwell County,18,355,115,240
Kentucky,Calloway County,0,39135,19061,20074
Kentucky,Calloway County,1,2022,992,1030
Kentucky,Calloway County,2,1982,1029,953
Kentucky,Calloway County,3,1931,976,955
Kentucky,Calloway County,4,3235,1461,1774
Kentucky,Calloway County,5,5645,2804,2841
Kentucky,Calloway County,6,2639,1361,1278
Kentucky,Calloway County,7,2070,1039,1031
Kentucky,Calloway County,8,2085,1060,1025
Kentucky,Calloway County,9,1904,994,910
Kentucky,Calloway County,10,2135,1068,1067
Kentucky,Calloway County,11,2190,1062,1128
Kentucky,Calloway County,12,2340,1127,1213
Kentucky,Calloway County,13,2343,1095,1248
Kentucky,Calloway County,14,2032,975,1057
Kentucky,Calloway County,15,1715,842,873
Kentucky,Calloway County,16,1258,542,716
Kentucky,Calloway County,17,837,362,475
Kentucky,Calloway County,18,772,272,500
Kentucky,Campbell County,0,93152,45696,47456
Kentucky,Campbell County,1,5431,2735,2696
Kentucky,Campbell County,2,5239,2668,2571
Kentucky,Campbell County,3,5364,2719,2645
Kentucky,Campbell County,4,6135,3031,3104
Kentucky,Campbell County,5,6439,3236,3203
Kentucky,Campbell County,6,7369,3737,3632
Kentucky,Campbell County,7,6500,3313,3187
Kentucky,Campbell County,8,6090,3085,3005
Kentucky,Campbell County,9,5210,2544,2666
Kentucky,Campbell County,10,5583,2826,2757
Kentucky,Campbell County,11,6013,2955,3058
Kentucky,Campbell County,12,6866,3386,3480
Kentucky,Campbell County,13,6364,3065,3299
Kentucky,Campbell County,14,5050,2381,2669
Kentucky,Campbell County,15,3554,1678,1876
Kentucky,Campbell County,16,2484,1056,1428
Kentucky,Campbell County,17,1666,632,1034
Kentucky,Campbell County,18,1795,649,1146
Kentucky,Carlisle County,0,4771,2353,2418
Kentucky,Carlisle County,1,321,179,142
Kentucky,Carlisle County,2,288,136,152
Kentucky,Carlisle County,3,300,164,136
Kentucky,Carlisle County,4,269,134,135
Kentucky,Carlisle County,5,215,110,105
Kentucky,Carlisle County,6,290,144,146
Kentucky,Carlisle County,7,244,121,123
Kentucky,Carlisle County,8,270,136,134
Kentucky,Carlisle County,9,288,150,138
Kentucky,Carlisle County,10,296,149,147
Kentucky,Carlisle County,11,304,140,164
Kentucky,Carlisle County,12,340,193,147
Kentucky,Carlisle County,13,323,157,166
Kentucky,Carlisle County,14,295,134,161
Kentucky,Carlisle County,15,249,114,135
Kentucky,Carlisle County,16,184,94,90
Kentucky,Carlisle County,17,154,62,92
Kentucky,Carlisle County,18,141,36,105
Kentucky,Carroll County,0,10737,5412,5325
Kentucky,Carroll County,1,789,400,389
Kentucky,Carroll County,2,845,427,418
Kentucky,Carroll County,3,748,376,372
Kentucky,Carroll County,4,663,337,326
Kentucky,Carroll County,5,628,333,295
Kentucky,Carroll County,6,695,380,315
Kentucky,Carroll County,7,590,302,288
Kentucky,Carroll County,8,707,362,345
Kentucky,Carroll County,9,596,293,303
Kentucky,Carroll County,10,667,355,312
Kentucky,Carroll County,11,703,357,346
Kentucky,Carroll County,12,779,398,381
Kentucky,Carroll County,13,692,343,349
Kentucky,Carroll County,14,549,268,281
Kentucky,Carroll County,15,431,201,230
Kentucky,Carroll County,16,263,123,140
Kentucky,Carroll County,17,202,88,114
Kentucky,Carroll County,18,190,69,121
Kentucky,Carter County,0,27004,13290,13714
Kentucky,Carter County,1,1724,881,843
Kentucky,Carter County,2,1604,819,785
Kentucky,Carter County,3,1720,911,809
Kentucky,Carter County,4,1699,893,806
Kentucky,Carter County,5,1633,813,820
Kentucky,Carter County,6,1708,842,866
Kentucky,Carter County,7,1362,698,664
Kentucky,Carter County,8,1570,797,773
Kentucky,Carter County,9,1576,751,825
Kentucky,Carter County,10,1810,874,936
Kentucky,Carter County,11,1808,879,929
Kentucky,Carter County,12,1897,947,950
Kentucky,Carter County,13,1828,898,930
Kentucky,Carter County,14,1608,750,858
Kentucky,Carter County,15,1384,653,731
Kentucky,Carter County,16,960,423,537
Kentucky,Carter County,17,635,271,364
Kentucky,Carter County,18,478,190,288
Kentucky,Casey County,0,15888,7702,8186
Kentucky,Casey County,1,1036,511,525
Kentucky,Casey County,2,997,501,496
Kentucky,Casey County,3,999,530,469
Kentucky,Casey County,4,946,477,469
Kentucky,Casey County,5,856,419,437
Kentucky,Casey County,6,993,467,526
Kentucky,Casey County,7,841,424,417
Kentucky,Casey County,8,903,459,444
Kentucky,Casey County,9,923,432,491
Kentucky,Casey County,10,1054,531,523
Kentucky,Casey County,11,1043,534,509
Kentucky,Casey County,12,1038,525,513
Kentucky,Casey County,13,1062,507,555
Kentucky,Casey County,14,1001,478,523
Kentucky,Casey County,15,898,409,489
Kentucky,Casey County,16,606,265,341
Kentucky,Casey County,17,340,134,206
Kentucky,Casey County,18,352,99,253
Kentucky,Christian County,0,71671,38320,33351
Kentucky,Christian County,1,6882,3576,3306
Kentucky,Christian County,2,5272,2707,2565
Kentucky,Christian County,3,4590,2401,2189
Kentucky,Christian County,4,4761,2788,1973
Kentucky,Christian County,5,9704,6751,2953
Kentucky,Christian County,6,7132,4262,2870
Kentucky,Christian County,7,4774,2490,2284
Kentucky,Christian County,8,3991,2045,1946
Kentucky,Christian County,9,3166,1534,1632
Kentucky,Christian County,10,3126,1534,1592
Kentucky,Christian County,11,3025,1391,1634
Kentucky,Christian County,12,3296,1581,1715
Kentucky,Christian County,13,3161,1450,1711
Kentucky,Christian County,14,2653,1265,1388
Kentucky,Christian County,15,2219,980,1239
Kentucky,Christian County,16,1636,677,959
Kentucky,Christian County,17,1148,491,657
Kentucky,Christian County,18,1135,397,738
Kentucky,Clark County,0,36249,17704,18545
Kentucky,Clark County,1,2202,1120,1082
Kentucky,Clark County,2,2212,1151,1061
Kentucky,Clark County,3,2338,1220,1118
Kentucky,Clark County,4,2079,1090,989
Kentucky,Clark County,5,2037,1047,990
Kentucky,Clark County,6,2293,1164,1129
Kentucky,Clark County,7,2108,1047,1061
Kentucky,Clark County,8,2064,997,1067
Kentucky,Clark County,9,2312,1107,1205
Kentucky,Clark County,10,2548,1283,1265
Kentucky,Clark County,11,2511,1203,1308
Kentucky,Clark County,12,2683,1289,1394
Kentucky,Clark County,13,2382,1128,1254
Kentucky,Clark County,14,2066,964,1102
Kentucky,Clark County,15,1749,805,944
Kentucky,Clark County,16,1184,542,642
Kentucky,Clark County,17,767,295,472
Kentucky,Clark County,18,714,252,462
Kentucky,Clay County,0,20105,10467,9638
Kentucky,Clay County,1,1184,572,612
Kentucky,Clay County,2,1152,596,556
Kentucky,Clay County,3,1129,577,552
Kentucky,Clay County,4,1158,622,536
Kentucky,Clay County,5,1050,590,460
Kentucky,Clay County,6,1611,891,720
Kentucky,Clay County,7,1469,905,564
Kentucky,Clay County,8,1386,764,622
Kentucky,Clay County,9,1347,728,619
Kentucky,Clay County,10,1441,795,646
Kentucky,Clay County,11,1408,745,663
Kentucky,Clay County,12,1421,699,722
Kentucky,Clay County,13,1284,618,666
Kentucky,Clay County,14,1083,527,556
Kentucky,Clay County,15,829,362,467
Kentucky,Clay County,16,557,243,314
Kentucky,Clay County,17,323,129,194
Kentucky,Clay County,18,273,104,169
Kentucky,Clinton County,0,10206,5014,5192
Kentucky,Clinton County,1,612,285,327
Kentucky,Clinton County,2,622,299,323
Kentucky,Clinton County,3,636,350,286
Kentucky,Clinton County,4,626,325,301
Kentucky,Clinton County,5,526,275,251
Kentucky,Clinton County,6,647,307,340
Kentucky,Clinton County,7,537,266,271
Kentucky,Clinton County,8,595,285,310
Kentucky,Clinton County,9,570,291,279
Kentucky,Clinton County,10,660,335,325
Kentucky,Clinton County,11,712,351,361
Kentucky,Clinton County,12,756,372,384
Kentucky,Clinton County,13,717,350,367
Kentucky,Clinton County,14,626,314,312
Kentucky,Clinton County,15,526,267,259
Kentucky,Clinton County,16,415,171,244
Kentucky,Clinton County,17,256,113,143
Kentucky,Clinton County,18,167,58,109
Kentucky,Crittenden County,0,8915,4488,4427
Kentucky,Crittenden County,1,471,235,236
Kentucky,Crittenden County,2,532,278,254
Kentucky,Crittenden County,3,622,322,300
Kentucky,Crittenden County,4,524,290,234
Kentucky,Crittenden County,5,461,232,229
Kentucky,Crittenden County,6,493,270,223
Kentucky,Crittenden County,7,432,224,208
Kentucky,Crittenden County,8,551,272,279
Kentucky,Crittenden County,9,516,278,238
Kentucky,Crittenden County,10,534,267,267
Kentucky,Crittenden County,11,608,314,294
Kentucky,Crittenden County,12,668,303,365
Kentucky,Crittenden County,13,651,332,319
Kentucky,Crittenden County,14,576,277,299
Kentucky,Crittenden County,15,487,239,248
Kentucky,Crittenden County,16,396,179,217
Kentucky,Crittenden County,17,200,105,95
Kentucky,Crittenden County,18,193,71,122
Kentucky,Cumberland County,0,6659,3245,3414
Kentucky,Cumberland County,1,404,213,191
Kentucky,Cumberland County,2,424,208,216
Kentucky,Cumberland County,3,382,200,182
Kentucky,Cumberland County,4,361,174,187
Kentucky,Cumberland County,5,306,171,135
Kentucky,Cumberland County,6,392,169,223
Kentucky,Cumberland County,7,333,176,157
Kentucky,Cumberland County,8,345,173,172
Kentucky,Cumberland County,9,342,165,177
Kentucky,Cumberland County,10,396,192,204
Kentucky,Cumberland County,11,453,205,248
Kentucky,Cumberland County,12,545,270,275
Kentucky,Cumberland County,13,520,267,253
Kentucky,Cumberland County,14,461,224,237
Kentucky,Cumberland County,15,375,180,195
Kentucky,Cumberland County,16,293,129,164
Kentucky,Cumberland County,17,177,82,95
Kentucky,Cumberland County,18,150,47,103
Kentucky,Daviess County,0,101104,49399,51705
Kentucky,Daviess County,1,6827,3553,3274
Kentucky,Daviess County,2,6865,3533,3332
Kentucky,Daviess County,3,6977,3540,3437
Kentucky,Daviess County,4,6377,3235,3142
Kentucky,Daviess County,5,5871,2965,2906
Kentucky,Daviess County,6,6849,3440,3409
Kentucky,Daviess County,7,6175,3018,3157
Kentucky,Daviess County,8,6192,3091,3101
Kentucky,Daviess County,9,5761,2896,2865
Kentucky,Daviess County,10,6146,3064,3082
Kentucky,Daviess County,11,6293,3101,3192
Kentucky,Daviess County,12,6956,3294,3662
Kentucky,Daviess County,13,6687,3213,3474
Kentucky,Daviess County,14,5362,2542,2820
Kentucky,Daviess County,15,4425,1996,2429
Kentucky,Daviess County,16,2957,1305,1652
Kentucky,Daviess County,17,2139,887,1252
Kentucky,Daviess County,18,2245,726,1519
Kentucky,Edmonson County,0,12274,6161,6113
Kentucky,Edmonson County,1,584,288,296
Kentucky,Edmonson County,2,616,317,299
Kentucky,Edmonson County,3,628,332,296
Kentucky,Edmonson County,4,758,438,320
Kentucky,Edmonson County,5,747,398,349
Kentucky,Edmonson County,6,774,398,376
Kentucky,Edmonson County,7,684,337,347
Kentucky,Edmonson County,8,739,361,378
Kentucky,Edmonson County,9,741,371,370
Kentucky,Edmonson County,10,797,375,422
Kentucky,Edmonson County,11,787,384,403
Kentucky,Edmonson County,12,981,514,467
Kentucky,Edmonson County,13,892,434,458
Kentucky,Edmonson County,14,817,413,404
Kentucky,Edmonson County,15,677,325,352
Kentucky,Edmonson County,16,514,242,272
Kentucky,Edmonson County,17,262,120,142
Kentucky,Edmonson County,18,276,114,162
Kentucky,Elliott County,0,7508,4245,3263
Kentucky,Elliott County,1,344,186,158
Kentucky,Elliott County,2,378,190,188
Kentucky,Elliott County,3,396,193,203
Kentucky,Elliott County,4,384,210,174
Kentucky,Elliott County,5,441,283,158
Kentucky,Elliott County,6,555,381,174
Kentucky,Elliott County,7,483,325,158
Kentucky,Elliott County,8,496,311,185
Kentucky,Elliott County,9,518,296,222
Kentucky,Elliott County,10,549,353,196
Kentucky,Elliott County,11,518,290,228
Kentucky,Elliott County,12,464,257,207
Kentucky,Elliott County,13,499,252,247
Kentucky,Elliott County,14,470,253,217
Kentucky,Elliott County,15,397,188,209
Kentucky,Elliott County,16,267,128,139
Kentucky,Elliott County,17,190,99,91
Kentucky,Elliott County,18,159,50,109
Kentucky,Estill County,0,14198,7033,7165
Kentucky,Estill County,1,765,381,384
Kentucky,Estill County,2,816,415,401
Kentucky,Estill County,3,916,462,454
Kentucky,Estill County,4,812,427,385
Kentucky,Estill County,5,751,385,366
Kentucky,Estill County,6,887,465,422
Kentucky,Estill County,7,739,411,328
Kentucky,Estill County,8,831,415,416
Kentucky,Estill County,9,871,429,442
Kentucky,Estill County,10,971,512,459
Kentucky,Estill County,11,1109,549,560
Kentucky,Estill County,12,1124,560,564
Kentucky,Estill County,13,904,416,488
Kentucky,Estill County,14,912,418,494
Kentucky,Estill County,15,747,340,407
Kentucky,Estill County,16,539,253,286
Kentucky,Estill County,17,294,123,171
Kentucky,Estill County,18,210,72,138
Kentucky,Fayette County,0,323780,158892,164888
Kentucky,Fayette County,1,19525,10104,9421
Kentucky,Fayette County,2,18736,9611,9125
Kentucky,Fayette County,3,18729,9571,9158
Kentucky,Fayette County,4,22301,11028,11273
Kentucky,Fayette County,5,33854,16731,17123
Kentucky,Fayette County,6,26868,13761,13107
Kentucky,Fayette County,7,23044,11737,11307
Kentucky,Fayette County,8,22447,11319,11128
Kentucky,Fayette County,9,19975,10082,9893
Kentucky,Fayette County,10,19242,9582,9660
Kentucky,Fayette County,11,18520,9285,9235
Kentucky,Fayette County,12,19213,9125,10088
Kentucky,Fayette County,13,18112,8410,9702
Kentucky,Fayette County,14,14910,6822,8088
Kentucky,Fayette County,15,11001,4970,6031
Kentucky,Fayette County,16,7483,3154,4329
Kentucky,Fayette County,17,4684,1905,2779
Kentucky,Fayette County,18,5136,1695,3441
Kentucky,Fleming County,0,14432,7090,7342
Kentucky,Fleming County,1,907,448,459
Kentucky,Fleming County,2,969,517,452
Kentucky,Fleming County,3,983,495,488
Kentucky,Fleming County,4,944,471,473
Kentucky,Fleming County,5,770,388,382
Kentucky,Fleming County,6,847,427,420
Kentucky,Fleming County,7,782,397,385
Kentucky,Fleming County,8,830,400,430
Kentucky,Fleming County,9,896,434,462
Kentucky,Fleming County,10,965,461,504
Kentucky,Fleming County,11,1024,524,500
Kentucky,Fleming County,12,962,488,474
Kentucky,Fleming County,13,970,453,517
Kentucky,Fleming County,14,837,415,422
Kentucky,Fleming County,15,727,335,392
Kentucky,Fleming County,16,477,226,251
Kentucky,Fleming County,17,295,124,171
Kentucky,Fleming County,18,247,87,160
Kentucky,Floyd County,0,35845,17523,18322
Kentucky,Floyd County,1,2092,1094,998
Kentucky,Floyd County,2,2202,1153,1049
Kentucky,Floyd County,3,2241,1176,1065
Kentucky,Floyd County,4,2070,1164,906
Kentucky,Floyd County,5,1891,1026,865
Kentucky,Floyd County,6,2201,1042,1159
Kentucky,Floyd County,7,2020,982,1038
Kentucky,Floyd County,8,2207,1093,1114
Kentucky,Floyd County,9,2265,1126,1139
Kentucky,Floyd County,10,2391,1152,1239
Kentucky,Floyd County,11,2459,1178,1281
Kentucky,Floyd County,12,2576,1190,1386
Kentucky,Floyd County,13,2642,1255,1387
Kentucky,Floyd County,14,2368,1120,1248
Kentucky,Floyd County,15,1759,781,978
Kentucky,Floyd County,16,1202,505,697
Kentucky,Floyd County,17,709,310,399
Kentucky,Floyd County,18,550,176,374
Kentucky,Franklin County,0,50815,24539,26276
Kentucky,Franklin County,1,2842,1419,1423
Kentucky,Franklin County,2,2891,1477,1414
Kentucky,Franklin County,3,3070,1575,1495
Kentucky,Franklin County,4,3264,1612,1652
Kentucky,Franklin County,5,3172,1605,1567
Kentucky,Franklin County,6,3462,1717,1745
Kentucky,Franklin County,7,3059,1515,1544
Kentucky,Franklin County,8,3100,1544,1556
Kentucky,Franklin County,9,3073,1513,1560
Kentucky,Franklin County,10,3368,1667,1701
Kentucky,Franklin County,11,3419,1645,1774
Kentucky,Franklin County,12,3528,1658,1870
Kentucky,Franklin County,13,3419,1576,1843
Kentucky,Franklin County,14,3135,1473,1662
Kentucky,Franklin County,15,2413,1067,1346
Kentucky,Franklin County,16,1605,725,880
Kentucky,Franklin County,17,1021,413,608
Kentucky,Franklin County,18,974,338,636
Kentucky,Fulton County,0,6120,3042,3078
Kentucky,Fulton County,1,402,210,192
Kentucky,Fulton County,2,389,210,179
Kentucky,Fulton County,3,339,180,159
Kentucky,Fulton County,4,319,159,160
Kentucky,Fulton County,5,332,189,143
Kentucky,Fulton County,6,443,228,215
Kentucky,Fulton County,7,375,206,169
Kentucky,Fulton County,8,366,196,170
Kentucky,Fulton County,9,297,150,147
Kentucky,Fulton County,10,337,187,150
Kentucky,Fulton County,11,384,174,210
Kentucky,Fulton County,12,420,180,240
Kentucky,Fulton County,13,480,245,235
Kentucky,Fulton County,14,407,184,223
Kentucky,Fulton County,15,339,149,190
Kentucky,Fulton County,16,212,99,113
Kentucky,Fulton County,17,148,55,93
Kentucky,Fulton County,18,131,41,90
Kentucky,Gallatin County,0,8832,4473,4359
Kentucky,Gallatin County,1,565,276,289
Kentucky,Gallatin County,2,574,279,295
Kentucky,Gallatin County,3,624,320,304
Kentucky,Gallatin County,4,586,320,266
Kentucky,Gallatin County,5,508,274,234
Kentucky,Gallatin County,6,634,340,294
Kentucky,Gallatin County,7,497,243,254
Kentucky,Gallatin County,8,556,278,278
Kentucky,Gallatin County,9,531,272,259
Kentucky,Gallatin County,10,603,316,287
Kentucky,Gallatin County,11,658,322,336
Kentucky,Gallatin County,12,666,335,331
Kentucky,Gallatin County,13,597,305,292
Kentucky,Gallatin County,14,425,217,208
Kentucky,Gallatin County,15,354,174,180
Kentucky,Gallatin County,16,248,126,122
Kentucky,Gallatin County,17,113,49,64
Kentucky,Gallatin County,18,93,27,66
Kentucky,Garrard County,0,17560,8656,8904
Kentucky,Garrard County,1,974,519,455
Kentucky,Garrard County,2,1076,582,494
Kentucky,Garrard County,3,1088,573,515
Kentucky,Garrard County,4,1023,537,486
Kentucky,Garrard County,5,863,439,424
Kentucky,Garrard County,6,984,466,518
Kentucky,Garrard County,7,957,482,475
Kentucky,Garrard County,8,1059,489,570
Kentucky,Garrard County,9,1050,549,501
Kentucky,Garrard County,10,1190,607,583
Kentucky,Garrard County,11,1314,650,664
Kentucky,Garrard County,12,1490,738,752
Kentucky,Garrard County,13,1303,616,687
Kentucky,Garrard County,14,1063,500,563
Kentucky,Garrard County,15,818,389,429
Kentucky,Garrard County,16,598,256,342
Kentucky,Garrard County,17,366,162,204
Kentucky,Garrard County,18,344,102,242
Kentucky,Grant County,0,25121,12579,12542
Kentucky,Grant County,1,1884,963,921
Kentucky,Grant County,2,1748,914,834
Kentucky,Grant County,3,1958,941,1017
Kentucky,Grant County,4,1711,871,840
Kentucky,Grant County,5,1526,826,700
Kentucky,Grant County,6,1649,851,798
Kentucky,Grant County,7,1483,769,714
Kentucky,Grant County,8,1568,775,793
Kentucky,Grant County,9,1491,763,728
Kentucky,Grant County,10,1791,892,899
Kentucky,Grant County,11,1662,840,822
Kentucky,Grant County,12,1730,840,890
Kentucky,Grant County,13,1468,728,740
Kentucky,Grant County,14,1183,562,621
Kentucky,Grant County,15,933,459,474
Kentucky,Grant County,16,699,335,364
Kentucky,Grant County,17,357,157,200
Kentucky,Grant County,18,280,93,187
Kentucky,Graves County,0,37317,18254,19063
Kentucky,Graves County,1,2516,1306,1210
Kentucky,Graves County,2,2526,1284,1242
Kentucky,Graves County,3,2409,1227,1182
Kentucky,Graves County,4,2290,1164,1126
Kentucky,Graves County,5,2060,1082,978
Kentucky,Graves County,6,2388,1170,1218
Kentucky,Graves County,7,2097,1035,1062
Kentucky,Graves County,8,2236,1045,1191
Kentucky,Graves County,9,2146,1082,1064
Kentucky,Graves County,10,2260,1101,1159
Kentucky,Graves County,11,2457,1236,1221
Kentucky,Graves County,12,2600,1238,1362
Kentucky,Graves County,13,2431,1180,1251
Kentucky,Graves County,14,2156,1043,1113
Kentucky,Graves County,15,1773,828,945
Kentucky,Graves County,16,1349,603,746
Kentucky,Graves County,17,809,331,478
Kentucky,Graves County,18,814,299,515
Kentucky,Grayson County,0,26321,13283,13038
Kentucky,Grayson County,1,1598,810,788
Kentucky,Grayson County,2,1667,843,824
Kentucky,Grayson County,3,1794,947,847
Kentucky,Grayson County,4,1643,862,781
Kentucky,Grayson County,5,1457,800,657
Kentucky,Grayson County,6,1730,883,847
Kentucky,Grayson County,7,1476,793,683
Kentucky,Grayson County,8,1638,842,796
Kentucky,Grayson County,9,1567,801,766
Kentucky,Grayson County,10,1650,834,816
Kentucky,Grayson County,11,1707,871,836
Kentucky,Grayson County,12,1922,988,934
Kentucky,Grayson County,13,1795,865,930
Kentucky,Grayson County,14,1611,764,847
Kentucky,Grayson County,15,1197,573,624
Kentucky,Grayson County,16,894,422,472
Kentucky,Grayson County,17,529,234,295
Kentucky,Grayson County,18,446,151,295
Kentucky,Green County,0,11049,5446,5603
Kentucky,Green County,1,609,276,333
Kentucky,Green County,2,621,321,300
Kentucky,Green County,3,672,341,331
Kentucky,Green County,4,631,336,295
Kentucky,Green County,5,570,311,259
Kentucky,Green County,6,606,282,324
Kentucky,Green County,7,518,276,242
Kentucky,Green County,8,665,316,349
Kentucky,Green County,9,631,315,316
Kentucky,Green County,10,708,366,342
Kentucky,Green County,11,843,398,445
Kentucky,Green County,12,896,472,424
Kentucky,Green County,13,799,409,390
Kentucky,Green County,14,733,363,370
Kentucky,Green County,15,580,270,310
Kentucky,Green County,16,434,184,250
Kentucky,Green County,17,285,126,159
Kentucky,Green County,18,248,84,164
Kentucky,Greenup County,0,35268,17148,18120
Kentucky,Greenup County,1,1876,938,938
Kentucky,Greenup County,2,2048,1081,967
Kentucky,Greenup County,3,2272,1162,1110
Kentucky,Greenup County,4,2000,1082,918
Kentucky,Greenup County,5,1785,927,858
Kentucky,Greenup County,6,2109,1097,1012
Kentucky,Greenup County,7,1771,852,919
Kentucky,Greenup County,8,2136,1083,1053
Kentucky,Greenup County,9,2163,1073,1090
Kentucky,Greenup County,10,2377,1118,1259
Kentucky,Greenup County,11,2336,1127,1209
Kentucky,Greenup County,12,2430,1163,1267
Kentucky,Greenup County,13,2577,1217,1360
Kentucky,Greenup County,14,2304,1069,1235
Kentucky,Greenup County,15,1960,906,1054
Kentucky,Greenup County,16,1313,568,745
Kentucky,Greenup County,17,958,388,570
Kentucky,Greenup County,18,853,297,556
Kentucky,Hancock County,0,8758,4494,4264
Kentucky,Hancock County,1,601,315,286
Kentucky,Hancock County,2,576,298,278
Kentucky,Hancock County,3,652,375,277
Kentucky,Hancock County,4,591,319,272
Kentucky,Hancock County,5,465,223,242
Kentucky,Hancock County,6,539,282,257
Kentucky,Hancock County,7,443,240,203
Kentucky,Hancock County,8,512,245,267
Kentucky,Hancock County,9,518,261,257
Kentucky,Hancock County,10,603,305,298
Kentucky,Hancock County,11,581,309,272
Kentucky,Hancock County,12,621,303,318
Kentucky,Hancock County,13,570,306,264
Kentucky,Hancock County,14,457,237,220
Kentucky,Hancock County,15,422,204,218
Kentucky,Hancock County,16,297,142,155
Kentucky,Hancock County,17,173,81,92
Kentucky,Hancock County,18,137,49,88
Kentucky,Hardin County,0,110356,54969,55387
Kentucky,Hardin County,1,7362,3735,3627
Kentucky,Hardin County,2,7431,3853,3578
Kentucky,Hardin County,3,7805,4012,3793
Kentucky,Hardin County,4,7224,3852,3372
Kentucky,Hardin County,5,7467,4264,3203
Kentucky,Hardin County,6,7760,3968,3792
Kentucky,Hardin County,7,7228,3616,3612
Kentucky,Hardin County,8,7439,3723,3716
Kentucky,Hardin County,9,6778,3396,3382
Kentucky,Hardin County,10,7129,3538,3591
Kentucky,Hardin County,11,7056,3477,3579
Kentucky,Hardin County,12,7727,3762,3965
Kentucky,Hardin County,13,6553,3082,3471
Kentucky,Hardin County,14,5268,2506,2762
Kentucky,Hardin County,15,3890,1703,2187
Kentucky,Hardin County,16,2830,1224,1606
Kentucky,Hardin County,17,1707,670,1037
Kentucky,Hardin County,18,1702,588,1114
Kentucky,Harlan County,0,26409,12677,13732
Kentucky,Harlan County,1,1735,872,863
Kentucky,Harlan County,2,1728,847,881
Kentucky,Harlan County,3,1638,820,818
Kentucky,Harlan County,4,1437,728,709
Kentucky,Harlan County,5,1332,655,677
Kentucky,Harlan County,6,1718,835,883
Kentucky,Harlan County,7,1540,751,789
Kentucky,Harlan County,8,1531,762,769
Kentucky,Harlan County,9,1518,760,758
Kentucky,Harlan County,10,1671,821,850
Kentucky,Harlan County,11,1777,862,915
Kentucky,Harlan County,12,1864,836,1028
Kentucky,Harlan County,13,1975,944,1031
Kentucky,Harlan County,14,1769,847,922
Kentucky,Harlan County,15,1275,577,698
Kentucky,Harlan County,16,833,370,463
Kentucky,Harlan County,17,554,221,333
Kentucky,Harlan County,18,514,169,345
Kentucky,Harrison County,0,18778,9228,9550
Kentucky,Harrison County,1,1164,602,562
Kentucky,Harrison County,2,1065,539,526
Kentucky,Harrison County,3,1244,626,618
Kentucky,Harrison County,4,1176,636,540
Kentucky,Harrison County,5,1060,537,523
Kentucky,Harrison County,6,1194,615,579
Kentucky,Harrison County,7,958,471,487
Kentucky,Harrison County,8,1035,504,531
Kentucky,Harrison County,9,1104,531,573
Kentucky,Harrison County,10,1262,632,630
Kentucky,Harrison County,11,1377,672,705
Kentucky,Harrison County,12,1458,718,740
Kentucky,Harrison County,13,1383,671,712
Kentucky,Harrison County,14,1101,537,564
Kentucky,Harrison County,15,817,393,424
Kentucky,Harrison County,16,623,278,345
Kentucky,Harrison County,17,397,160,237
Kentucky,Harrison County,18,360,106,254
Kentucky,Hart County,0,18906,9298,9608
Kentucky,Hart County,1,1324,621,703
Kentucky,Hart County,2,1221,634,587
Kentucky,Hart County,3,1291,644,647
Kentucky,Hart County,4,1204,611,593
Kentucky,Hart County,5,1073,554,519
Kentucky,Hart County,6,1210,616,594
Kentucky,Hart County,7,1014,530,484
Kentucky,Hart County,8,1061,520,541
Kentucky,Hart County,9,1086,550,536
Kentucky,Hart County,10,1161,584,577
Kentucky,Hart County,11,1350,653,697
Kentucky,Hart County,12,1499,759,740
Kentucky,Hart County,13,1280,619,661
Kentucky,Hart County,14,1009,499,510
Kentucky,Hart County,15,829,368,461
Kentucky,Hart County,16,586,282,304
Kentucky,Hart County,17,381,164,217
Kentucky,Hart County,18,327,90,237
Kentucky,Henderson County,0,45591,22006,23585
Kentucky,Henderson County,1,2758,1367,1391
Kentucky,Henderson County,2,2922,1533,1389
Kentucky,Henderson County,3,3132,1566,1566
Kentucky,Henderson County,4,2713,1399,1314
Kentucky,Henderson County,5,2452,1252,1200
Kentucky,Henderson County,6,2940,1463,1477
Kentucky,Henderson County,7,2685,1294,1391
Kentucky,Henderson County,8,2896,1395,1501
Kentucky,Henderson County,9,2626,1275,1351
Kentucky,Henderson County,10,2862,1415,1447
Kentucky,Henderson County,11,2963,1450,1513
Kentucky,Henderson County,12,3322,1594,1728
Kentucky,Henderson County,13,3308,1515,1793
Kentucky,Henderson County,14,2662,1251,1411
Kentucky,Henderson County,15,2115,944,1171
Kentucky,Henderson County,16,1411,635,776
Kentucky,Henderson County,17,905,358,547
Kentucky,Henderson County,18,919,300,619
Kentucky,Henry County,0,16106,7969,8137
Kentucky,Henry County,1,949,503,446
Kentucky,Henry County,2,1032,531,501
Kentucky,Henry County,3,1103,600,503
Kentucky,Henry County,4,1086,566,520
Kentucky,Henry County,5,866,443,423
Kentucky,Henry County,6,897,454,443
Kentucky,Henry County,7,897,445,452
Kentucky,Henry County,8,975,473,502
Kentucky,Henry County,9,937,482,455
Kentucky,Henry County,10,1057,506,551
Kentucky,Henry County,11,1152,542,610
Kentucky,Henry County,12,1160,578,582
Kentucky,Henry County,13,1165,578,587
Kentucky,Henry County,14,1015,477,538
Kentucky,Henry County,15,707,325,382
Kentucky,Henry County,16,510,243,267
Kentucky,Henry County,17,335,149,186
Kentucky,Henry County,18,263,74,189
Kentucky,Hickman County,0,4421,2084,2337
Kentucky,Hickman County,1,205,103,102
Kentucky,Hickman County,2,229,115,114
Kentucky,Hickman County,3,260,125,135
Kentucky,Hickman County,4,233,112,121
Kentucky,Hickman County,5,208,109,99
Kentucky,Hickman County,6,211,92,119
Kentucky,Hickman County,7,249,125,124
Kentucky,Hickman County,8,214,114,100
Kentucky,Hickman County,9,235,111,124
Kentucky,Hickman County,10,279,133,146
Kentucky,Hickman County,11,324,174,150
Kentucky,Hickman County,12,324,146,178
Kentucky,Hickman County,13,321,140,181
Kentucky,Hickman County,14,305,141,164
Kentucky,Hickman County,15,304,135,169
Kentucky,Hickman County,16,202,96,106
Kentucky,Hickman County,17,152,68,84
Kentucky,Hickman County,18,166,45,121
Kentucky,Hopkins County,0,45068,21976,23092
Kentucky,Hopkins County,1,2650,1340,1310
Kentucky,Hopkins County,2,2806,1395,1411
Kentucky,Hopkins County,3,3013,1561,1452
Kentucky,Hopkins County,4,2612,1376,1236
Kentucky,Hopkins County,5,2423,1215,1208
Kentucky,Hopkins County,6,2913,1463,1450
Kentucky,Hopkins County,7,2598,1289,1309
Kentucky,Hopkins County,8,2736,1337,1399
Kentucky,Hopkins County,9,2772,1373,1399
Kentucky,Hopkins County,10,2743,1389,1354
Kentucky,Hopkins County,11,3041,1497,1544
Kentucky,Hopkins County,12,3198,1484,1714
Kentucky,Hopkins County,13,3249,1544,1705
Kentucky,Hopkins County,14,2744,1296,1448
Kentucky,Hopkins County,15,2132,1009,1123
Kentucky,Hopkins County,16,1499,661,838
Kentucky,Hopkins County,17,1038,450,588
Kentucky,Hopkins County,18,901,297,604
Kentucky,Jackson County,0,13442,6682,6760
Kentucky,Jackson County,1,860,436,424
Kentucky,Jackson County,2,831,445,386
Kentucky,Jackson County,3,856,458,398
Kentucky,Jackson County,4,792,420,372
Kentucky,Jackson County,5,687,365,322
Kentucky,Jackson County,6,834,410,424
Kentucky,Jackson County,7,721,356,365
Kentucky,Jackson County,8,870,431,439
Kentucky,Jackson County,9,873,424,449
Kentucky,Jackson County,10,942,480,462
Kentucky,Jackson County,11,928,441,487
Kentucky,Jackson County,12,960,470,490
Kentucky,Jackson County,13,971,469,502
Kentucky,Jackson County,14,794,390,404
Kentucky,Jackson County,15,660,320,340
Kentucky,Jackson County,16,439,208,231
Kentucky,Jackson County,17,256,105,151
Kentucky,Jackson County,18,168,54,114
Kentucky,Jefferson County,0,770517,372427,398090
Kentucky,Jefferson County,1,48326,24792,23534
Kentucky,Jefferson County,2,46872,23955,22917
Kentucky,Jefferson County,3,47334,24162,23172
Kentucky,Jefferson County,4,46268,23523,22745
Kentucky,Jefferson County,5,47959,24082,23877
Kentucky,Jefferson County,6,60494,29851,30643
Kentucky,Jefferson County,7,53784,26995,26789
Kentucky,Jefferson County,8,51052,25250,25802
Kentucky,Jefferson County,9,45398,22162,23236
Kentucky,Jefferson County,10,47345,22874,24471
Kentucky,Jefferson County,11,47592,23025,24567
Kentucky,Jefferson County,12,53221,25296,27925
Kentucky,Jefferson County,13,50369,23507,26862
Kentucky,Jefferson County,14,42210,19276,22934
Kentucky,Jefferson County,15,30963,14038,16925
Kentucky,Jefferson County,16,21001,8806,12195
Kentucky,Jefferson County,17,14396,5614,8782
Kentucky,Jefferson County,18,15933,5219,10714
Kentucky,Jessamine County,0,53920,26281,27639
Kentucky,Jessamine County,1,3481,1813,1668
Kentucky,Jessamine County,2,3612,1860,1752
Kentucky,Jessamine County,3,3630,1838,1792
Kentucky,Jessamine County,4,3798,1899,1899
Kentucky,Jessamine County,5,3733,1852,1881
Kentucky,Jessamine County,6,3642,1798,1844
Kentucky,Jessamine County,7,3184,1540,1644
Kentucky,Jessamine County,8,3334,1615,1719
Kentucky,Jessamine County,9,3353,1652,1701
Kentucky,Jessamine County,10,3635,1785,1850
Kentucky,Jessamine County,11,3399,1590,1809
Kentucky,Jessamine County,12,3657,1729,1928
Kentucky,Jessamine County,13,3375,1578,1797
Kentucky,Jessamine County,14,2643,1240,1403
Kentucky,Jessamine County,15,2166,1026,1140
Kentucky,Jessamine County,16,1322,601,721
Kentucky,Jessamine County,17,926,431,495
Kentucky,Jessamine County,18,1030,434,596
Kentucky,Johnson County,0,22386,10971,11415
Kentucky,Johnson County,1,1203,596,607
Kentucky,Johnson County,2,1359,667,692
Kentucky,Johnson County,3,1438,757,681
Kentucky,Johnson County,4,1377,728,649
Kentucky,Johnson County,5,1207,635,572
Kentucky,Johnson County,6,1326,666,660
Kentucky,Johnson County,7,1250,622,628
Kentucky,Johnson County,8,1384,680,704
Kentucky,Johnson County,9,1420,695,725
Kentucky,Johnson County,10,1575,769,806
Kentucky,Johnson County,11,1587,764,823
Kentucky,Johnson County,12,1585,748,837
Kentucky,Johnson County,13,1558,731,827
Kentucky,Johnson County,14,1409,681,728
Kentucky,Johnson County,15,1139,569,570
Kentucky,Johnson County,16,738,335,403
Kentucky,Johnson County,17,460,207,253
Kentucky,Johnson County,18,371,121,250
Kentucky,Kenton County,0,166051,82155,83896
Kentucky,Kenton County,1,11218,5758,5460
Kentucky,Kenton County,2,10911,5643,5268
Kentucky,Kenton County,3,11022,5493,5529
Kentucky,Kenton County,4,9915,5238,4677
Kentucky,Kenton County,5,9704,4988,4716
Kentucky,Kenton County,6,12577,6321,6256
Kentucky,Kenton County,7,12019,6011,6008
Kentucky,Kenton County,8,11559,5757,5802
Kentucky,Kenton County,9,10143,5146,4997
Kentucky,Kenton County,10,10036,5047,4989
Kentucky,Kenton County,11,10952,5321,5631
Kentucky,Kenton County,12,11417,5659,5758
Kentucky,Kenton County,13,10599,5168,5431
Kentucky,Kenton County,14,8598,4064,4534
Kentucky,Kenton County,15,6116,2854,3262
Kentucky,Kenton County,16,3984,1724,2260
Kentucky,Kenton County,17,2615,1093,1522
Kentucky,Kenton County,18,2666,870,1796
Kentucky,Knott County,0,15126,7473,7653
Kentucky,Knott County,1,841,425,416
Kentucky,Knott County,2,842,452,390
Kentucky,Knott County,3,845,418,427
Kentucky,Knott County,4,1035,543,492
Kentucky,Knott County,5,1031,538,493
Kentucky,Knott County,6,885,433,452
Kentucky,Knott County,7,725,355,370
Kentucky,Knott County,8,825,408,417
Kentucky,Knott County,9,900,440,460
Kentucky,Knott County,10,979,492,487
Kentucky,Knott County,11,1131,539,592
Kentucky,Knott County,12,1158,576,582
Kentucky,Knott County,13,1135,596,539
Kentucky,Knott County,14,977,470,507
Kentucky,Knott County,15,760,379,381
Kentucky,Knott County,16,483,201,282
Kentucky,Knott County,17,316,135,181
Kentucky,Knott County,18,258,73,185
Kentucky,Knox County,0,31304,15336,15968
Kentucky,Knox County,1,1962,992,970
Kentucky,Knox County,2,2004,1045,959
Kentucky,Knox County,3,2107,1085,1022
Kentucky,Knox County,4,2078,1093,985
Kentucky,Knox County,5,2026,1098,928
Kentucky,Knox County,6,2105,1035,1070
Kentucky,Knox County,7,1826,902,924
Kentucky,Knox County,8,1825,907,918
Kentucky,Knox County,9,1830,901,929
Kentucky,Knox County,10,2059,1023,1036
Kentucky,Knox County,11,2088,1014,1074
Kentucky,Knox County,12,2094,1012,1082
Kentucky,Knox County,13,1894,893,1001
Kentucky,Knox County,14,1633,733,900
Kentucky,Knox County,15,1515,682,833
Kentucky,Knox County,16,1085,480,605
Kentucky,Knox County,17,655,268,387
Kentucky,Knox County,18,518,173,345
Kentucky,Larue County,0,14307,7102,7205
Kentucky,Larue County,1,804,434,370
Kentucky,Larue County,2,859,439,420
Kentucky,Larue County,3,977,502,475
Kentucky,Larue County,4,872,477,395
Kentucky,Larue County,5,822,438,384
Kentucky,Larue County,6,875,428,447
Kentucky,Larue County,7,830,416,414
Kentucky,Larue County,8,938,472,466
Kentucky,Larue County,9,824,407,417
Kentucky,Larue County,10,887,433,454
Kentucky,Larue County,11,1011,508,503
Kentucky,Larue County,12,1085,534,551
Kentucky,Larue County,13,999,487,512
Kentucky,Larue County,14,828,399,429
Kentucky,Larue County,15,599,293,306
Kentucky,Larue County,16,460,188,272
Kentucky,Larue County,17,340,155,185
Kentucky,Larue County,18,297,92,205
Kentucky,Laurel County,0,60669,29725,30944
Kentucky,Laurel County,1,3739,1894,1845
Kentucky,Laurel County,2,3850,1982,1868
Kentucky,Laurel County,3,3977,2018,1959
Kentucky,Laurel County,4,3770,1942,1828
Kentucky,Laurel County,5,3394,1726,1668
Kentucky,Laurel County,6,4110,2049,2061
Kentucky,Laurel County,7,3707,1823,1884
Kentucky,Laurel County,8,3888,1869,2019
Kentucky,Laurel County,9,3886,1897,1989
Kentucky,Laurel County,10,4108,2106,2002
Kentucky,Laurel County,11,4217,2050,2167
Kentucky,Laurel County,12,4134,1979,2155
Kentucky,Laurel County,13,3968,1841,2127
Kentucky,Laurel County,14,3396,1635,1761
Kentucky,Laurel County,15,2645,1257,1388
Kentucky,Laurel County,16,1812,822,990
Kentucky,Laurel County,17,1172,499,673
Kentucky,Laurel County,18,896,336,560
Kentucky,Lawrence County,0,15571,7758,7813
Kentucky,Lawrence County,1,974,531,443
Kentucky,Lawrence County,2,1050,551,499
Kentucky,Lawrence County,3,1055,539,516
Kentucky,Lawrence County,4,925,488,437
Kentucky,Lawrence County,5,776,401,375
Kentucky,Lawrence County,6,969,492,477
Kentucky,Lawrence County,7,825,427,398
Kentucky,Lawrence County,8,970,458,512
Kentucky,Lawrence County,9,965,482,483
Kentucky,Lawrence County,10,1042,512,530
Kentucky,Lawrence County,11,1047,535,512
Kentucky,Lawrence County,12,1144,547,597
Kentucky,Lawrence County,13,1130,535,595
Kentucky,Lawrence County,14,947,452,495
Kentucky,Lawrence County,15,730,357,373
Kentucky,Lawrence County,16,492,237,255
Kentucky,Lawrence County,17,297,128,169
Kentucky,Lawrence County,18,233,86,147
Kentucky,Lee County,0,7033,3810,3223
Kentucky,Lee County,1,406,227,179
Kentucky,Lee County,2,330,189,141
Kentucky,Lee County,3,379,196,183
Kentucky,Lee County,4,360,195,165
Kentucky,Lee County,5,374,223,151
Kentucky,Lee County,6,476,301,175
Kentucky,Lee County,7,461,271,190
Kentucky,Lee County,8,447,277,170
Kentucky,Lee County,9,429,247,182
Kentucky,Lee County,10,477,271,206
Kentucky,Lee County,11,580,303,277
Kentucky,Lee County,12,566,276,290
Kentucky,Lee County,13,512,276,236
Kentucky,Lee County,14,461,221,240
Kentucky,Lee County,15,357,170,187
Kentucky,Lee County,16,191,86,105
Kentucky,Lee County,17,133,56,77
Kentucky,Lee County,18,94,25,69
Kentucky,Leslie County,0,10143,5062,5081
Kentucky,Leslie County,1,599,320,279
Kentucky,Leslie County,2,634,343,291
Kentucky,Leslie County,3,587,302,285
Kentucky,Leslie County,4,550,301,249
Kentucky,Leslie County,5,487,249,238
Kentucky,Leslie County,6,693,344,349
Kentucky,Leslie County,7,612,333,279
Kentucky,Leslie County,8,565,275,290
Kentucky,Leslie County,9,649,327,322
Kentucky,Leslie County,10,663,305,358
Kentucky,Leslie County,11,760,383,377
Kentucky,Leslie County,12,783,400,383
Kentucky,Leslie County,13,743,365,378
Kentucky,Leslie County,14,629,293,336
Kentucky,Leslie County,15,462,242,220
Kentucky,Leslie County,16,337,142,195
Kentucky,Leslie County,17,214,73,141
Kentucky,Leslie County,18,176,65,111
Kentucky,Letcher County,0,21899,10698,11201
Kentucky,Letcher County,1,1318,658,660
Kentucky,Letcher County,2,1309,651,658
Kentucky,Letcher County,3,1379,726,653
Kentucky,Letcher County,4,1151,607,544
Kentucky,Letcher County,5,1054,544,510
Kentucky,Letcher County,6,1244,642,602
Kentucky,Letcher County,7,1203,603,600
Kentucky,Letcher County,8,1390,672,718
Kentucky,Letcher County,9,1321,656,665
Kentucky,Letcher County,10,1414,694,720
Kentucky,Letcher County,11,1485,701,784
Kentucky,Letcher County,12,1696,804,892
Kentucky,Letcher County,13,1658,799,859
Kentucky,Letcher County,14,1567,734,833
Kentucky,Letcher County,15,1120,548,572
Kentucky,Letcher County,16,753,345,408
Kentucky,Letcher County,17,494,194,300
Kentucky,Letcher County,18,343,120,223
Kentucky,Lewis County,0,13257,6627,6630
Kentucky,Lewis County,1,737,370,367
Kentucky,Lewis County,2,757,395,362
Kentucky,Lewis County,3,851,434,417
Kentucky,Lewis County,4,767,395,372
Kentucky,Lewis County,5,710,369,341
Kentucky,Lewis County,6,852,455,397
Kentucky,Lewis County,7,687,336,351
Kentucky,Lewis County,8,767,356,411
Kentucky,Lewis County,9,834,427,407
Kentucky,Lewis County,10,872,454,418
Kentucky,Lewis County,11,906,458,448
Kentucky,Lewis County,12,1052,493,559
Kentucky,Lewis County,13,996,499,497
Kentucky,Lewis County,14,819,386,433
Kentucky,Lewis County,15,624,325,299
Kentucky,Lewis County,16,476,226,250
Kentucky,Lewis County,17,324,158,166
Kentucky,Lewis County,18,226,91,135
Kentucky,Lincoln County,0,24644,12076,12568
Kentucky,Lincoln County,1,1658,858,800
Kentucky,Lincoln County,2,1580,788,792
Kentucky,Lincoln County,3,1633,849,784
Kentucky,Lincoln County,4,1484,767,717
Kentucky,Lincoln County,5,1317,671,646
Kentucky,Lincoln County,6,1567,780,787
Kentucky,Lincoln County,7,1340,671,669
Kentucky,Lincoln County,8,1367,656,711
Kentucky,Lincoln County,9,1416,704,712
Kentucky,Lincoln County,10,1664,807,857
Kentucky,Lincoln County,11,1776,888,888
Kentucky,Lincoln County,12,1718,847,871
Kentucky,Lincoln County,13,1633,802,831
Kentucky,Lincoln County,14,1491,703,788
Kentucky,Lincoln County,15,1119,491,628
Kentucky,Lincoln County,16,856,382,474
Kentucky,Lincoln County,17,561,244,317
Kentucky,Lincoln County,18,464,168,296
Kentucky,Livingston County,0,9242,4540,4702
Kentucky,Livingston County,1,508,271,237
Kentucky,Livingston County,2,504,273,231
Kentucky,Livingston County,3,557,283,274
Kentucky,Livingston County,4,476,224,252
Kentucky,Livingston County,5,453,220,233
Kentucky,Livingston County,6,531,267,264
Kentucky,Livingston County,7,454,240,214
Kentucky,Livingston County,8,471,234,237
Kentucky,Livingston County,9,500,242,258
Kentucky,Livingston County,10,592,292,300
Kentucky,Livingston County,11,680,332,348
Kentucky,Livingston County,12,734,352,382
Kentucky,Livingston County,13,776,383,393
Kentucky,Livingston County,14,629,311,318
Kentucky,Livingston County,15,539,252,287
Kentucky,Livingston County,16,405,190,215
Kentucky,Livingston County,17,227,110,117
Kentucky,Livingston County,18,206,64,142
Kentucky,Logan County,0,26989,13311,13678
Kentucky,Logan County,1,1739,928,811
Kentucky,Logan County,2,1777,902,875
Kentucky,Logan County,3,1741,883,858
Kentucky,Logan County,4,1632,847,785
Kentucky,Logan County,5,1469,753,716
Kentucky,Logan County,6,1686,840,846
Kentucky,Logan County,7,1569,785,784
Kentucky,Logan County,8,1657,826,831
Kentucky,Logan County,9,1487,731,756
Kentucky,Logan County,10,1667,860,807
Kentucky,Logan County,11,1792,878,914
Kentucky,Logan County,12,2004,1000,1004
Kentucky,Logan County,13,1745,809,936
Kentucky,Logan County,14,1531,738,793
Kentucky,Logan County,15,1358,612,746
Kentucky,Logan County,16,1008,468,540
Kentucky,Logan County,17,562,253,309
Kentucky,Logan County,18,565,198,367
Kentucky,Lyon County,0,8009,4388,3621
Kentucky,Lyon County,1,290,152,138
Kentucky,Lyon County,2,296,156,140
Kentucky,Lyon County,3,373,205,168
Kentucky,Lyon County,4,331,167,164
Kentucky,Lyon County,5,405,244,161
Kentucky,Lyon County,6,494,340,154
Kentucky,Lyon County,7,398,279,119
Kentucky,Lyon County,8,451,279,172
Kentucky,Lyon County,9,492,311,181
Kentucky,Lyon County,10,517,304,213
Kentucky,Lyon County,11,558,309,249
Kentucky,Lyon County,12,634,311,323
Kentucky,Lyon County,13,690,347,343
Kentucky,Lyon County,14,675,330,345
Kentucky,Lyon County,15,545,264,281
Kentucky,Lyon County,16,407,199,208
Kentucky,Lyon County,17,247,118,129
Kentucky,Lyon County,18,206,73,133
Kentucky,McCracken County,0,65346,31393,33953
Kentucky,McCracken County,1,3973,2053,1920
Kentucky,McCracken County,2,4077,2102,1975
Kentucky,McCracken County,3,4107,2057,2050
Kentucky,McCracken County,4,3735,1925,1810
Kentucky,McCracken County,5,3357,1672,1685
Kentucky,McCracken County,6,4117,1981,2136
Kentucky,McCracken County,7,3900,1921,1979
Kentucky,McCracken County,8,3958,1959,1999
Kentucky,McCracken County,9,3850,1878,1972
Kentucky,McCracken County,10,4076,2044,2032
Kentucky,McCracken County,11,4044,1954,2090
Kentucky,McCracken County,12,4588,2169,2419
Kentucky,McCracken County,13,4624,2229,2395
Kentucky,McCracken County,14,4138,1910,2228
Kentucky,McCracken County,15,3182,1424,1758
Kentucky,McCracken County,16,2372,992,1380
Kentucky,McCracken County,17,1535,597,938
Kentucky,McCracken County,18,1713,526,1187
Kentucky,McCreary County,0,17408,9462,7946
Kentucky,McCreary County,1,1036,531,505
Kentucky,McCreary County,2,1040,531,509
Kentucky,McCreary County,3,1095,577,518
Kentucky,McCreary County,4,1034,587,447
Kentucky,McCreary County,5,968,529,439
Kentucky,McCreary County,6,1276,762,514
Kentucky,McCreary County,7,1214,774,440
Kentucky,McCreary County,8,1205,753,452
Kentucky,McCreary County,9,1233,720,513
Kentucky,McCreary County,10,1190,678,512
Kentucky,McCreary County,11,1203,639,564
Kentucky,McCreary County,12,1135,583,552
Kentucky,McCreary County,13,986,503,483
Kentucky,McCreary County,14,926,432,494
Kentucky,McCreary County,15,812,380,432
Kentucky,McCreary County,16,529,258,271
Kentucky,McCreary County,17,307,136,171
Kentucky,McCreary County,18,219,89,130
Kentucky,McLean County,0,9252,4551,4701
Kentucky,McLean County,1,530,275,255
Kentucky,McLean County,2,615,318,297
Kentucky,McLean County,3,641,319,322
Kentucky,McLean County,4,614,335,279
Kentucky,McLean County,5,430,206,224
Kentucky,McLean County,6,516,264,252
Kentucky,McLean County,7,477,236,241
Kentucky,McLean County,8,532,258,274
Kentucky,McLean County,9,551,269,282
Kentucky,McLean County,10,568,271,297
Kentucky,McLean County,11,667,345,322
Kentucky,McLean County,12,678,323,355
Kentucky,McLean County,13,633,313,320
Kentucky,McLean County,14,553,265,288
Kentucky,McLean County,15,502,241,261
Kentucky,McLean County,16,337,153,184
Kentucky,McLean County,17,208,92,116
Kentucky,McLean County,18,200,68,132
Kentucky,Madison County,0,92368,44872,47496
Kentucky,Madison County,1,5218,2692,2526
Kentucky,Madison County,2,5361,2712,2649
Kentucky,Madison County,3,5401,2753,2648
Kentucky,Madison County,4,8094,3762,4332
Kentucky,Madison County,5,11342,5566,5776
Kentucky,Madison County,6,6469,3350,3119
Kentucky,Madison County,7,4960,2445,2515
Kentucky,Madison County,8,5562,2711,2851
Kentucky,Madison County,9,5489,2746,2743
Kentucky,Madison County,10,5721,2822,2899
Kentucky,Madison County,11,5490,2680,2810
Kentucky,Madison County,12,5504,2644,2860
Kentucky,Madison County,13,5020,2330,2690
Kentucky,Madison County,14,4315,2027,2288
Kentucky,Madison County,15,3408,1592,1816
Kentucky,Madison County,16,2221,980,1241
Kentucky,Madison County,17,1397,588,809
Kentucky,Madison County,18,1396,472,924
Kentucky,Magoffin County,0,12362,6176,6186
Kentucky,Magoffin County,1,729,378,351
Kentucky,Magoffin County,2,748,398,350
Kentucky,Magoffin County,3,792,397,395
Kentucky,Magoffin County,4,751,394,357
Kentucky,Magoffin County,5,613,315,298
Kentucky,Magoffin County,6,817,420,397
Kentucky,Magoffin County,7,658,325,333
Kentucky,Magoffin County,8,689,344,345
Kentucky,Magoffin County,9,800,387,413
Kentucky,Magoffin County,10,873,460,413
Kentucky,Magoffin County,11,897,454,443
Kentucky,Magoffin County,12,962,479,483
Kentucky,Magoffin County,13,910,439,471
Kentucky,Magoffin County,14,738,361,377
Kentucky,Magoffin County,15,559,252,307
Kentucky,Magoffin County,16,396,179,217
Kentucky,Magoffin County,17,248,107,141
Kentucky,Magoffin County,18,182,87,95
Kentucky,Marion County,0,19404,9605,9799
Kentucky,Marion County,1,1219,645,574
Kentucky,Marion County,2,1346,647,699
Kentucky,Marion County,3,1347,662,685
Kentucky,Marion County,4,1219,617,602
Kentucky,Marion County,5,1179,616,563
Kentucky,Marion County,6,1181,643,538
Kentucky,Marion County,7,1072,554,518
Kentucky,Marion County,8,1258,635,623
Kentucky,Marion County,9,1137,605,532
Kentucky,Marion County,10,1186,555,631
Kentucky,Marion County,11,1400,702,698
Kentucky,Marion County,12,1420,720,700
Kentucky,Marion County,13,1254,617,637
Kentucky,Marion County,14,1029,503,526
Kentucky,Marion County,15,845,396,449
Kentucky,Marion County,16,534,243,291
Kentucky,Marion County,17,351,125,226
Kentucky,Marion County,18,427,120,307
Kentucky,Marshall County,0,31191,15281,15910
Kentucky,Marshall County,1,1687,894,793
Kentucky,Marshall County,2,1718,892,826
Kentucky,Marshall County,3,1856,963,893
Kentucky,Marshall County,4,1761,896,865
Kentucky,Marshall County,5,1513,768,745
Kentucky,Marshall County,6,1841,915,926
Kentucky,Marshall County,7,1603,765,838
Kentucky,Marshall County,8,1870,903,967
Kentucky,Marshall County,9,1757,887,870
Kentucky,Marshall County,10,2001,996,1005
Kentucky,Marshall County,11,2121,1068,1053
Kentucky,Marshall County,12,2331,1132,1199
Kentucky,Marshall County,13,2323,1094,1229
Kentucky,Marshall County,14,2078,1034,1044
Kentucky,Marshall County,15,1806,847,959
Kentucky,Marshall County,16,1323,616,707
Kentucky,Marshall County,17,868,347,521
Kentucky,Marshall County,18,734,264,470
Kentucky,Martin County,0,11323,6219,5104
Kentucky,Martin County,1,533,273,260
Kentucky,Martin County,2,612,314,298
Kentucky,Martin County,3,673,360,313
Kentucky,Martin County,4,605,302,303
Kentucky,Martin County,5,606,384,222
Kentucky,Martin County,6,925,636,289
Kentucky,Martin County,7,926,641,285
Kentucky,Martin County,8,839,544,295
Kentucky,Martin County,9,724,403,321
Kentucky,Martin County,10,750,405,345
Kentucky,Martin County,11,772,394,378
Kentucky,Martin County,12,749,341,408
Kentucky,Martin County,13,728,359,369
Kentucky,Martin County,14,686,332,354
Kentucky,Martin County,15,468,241,227
Kentucky,Martin County,16,317,140,177
Kentucky,Martin County,17,230,88,142
Kentucky,Martin County,18,180,62,118
Kentucky,Mason County,0,17150,8305,8845
Kentucky,Mason County,1,1054,533,521
Kentucky,Mason County,2,1111,553,558
Kentucky,Mason County,3,1181,622,559
Kentucky,Mason County,4,1044,533,511
Kentucky,Mason County,5,992,535,457
Kentucky,Mason County,6,1093,533,560
Kentucky,Mason County,7,937,469,468
Kentucky,Mason County,8,947,446,501
Kentucky,Mason County,9,951,454,497
Kentucky,Mason County,10,1128,555,573
Kentucky,Mason County,11,1216,616,600
Kentucky,Mason County,12,1191,576,615
Kentucky,Mason County,13,1158,530,628
Kentucky,Mason County,14,1102,530,572
Kentucky,Mason County,15,780,326,454
Kentucky,Mason County,16,601,247,354
Kentucky,Mason County,17,339,141,198
Kentucky,Mason County,18,325,106,219
Kentucky,Meade County,0,28715,14460,14255
Kentucky,Meade County,1,1519,768,751
Kentucky,Meade County,2,1808,951,857
Kentucky,Meade County,3,1949,975,974
Kentucky,Meade County,4,1820,970,850
Kentucky,Meade County,5,1708,912,796
Kentucky,Meade County,6,1853,926,927
Kentucky,Meade County,7,1983,974,1009
Kentucky,Meade County,8,2023,1015,1008
Kentucky,Meade County,9,1918,936,982
Kentucky,Meade County,10,2015,1018,997
Kentucky,Meade County,11,2062,1043,1019
Kentucky,Meade County,12,2097,1036,1061
Kentucky,Meade County,13,1934,987,947
Kentucky,Meade County,14,1364,695,669
Kentucky,Meade County,15,1102,553,549
Kentucky,Meade County,16,750,354,396
Kentucky,Meade County,17,429,198,231
Kentucky,Meade County,18,381,149,232
Kentucky,Menifee County,0,6451,3281,3170
Kentucky,Menifee County,1,338,175,163
Kentucky,Menifee County,2,303,152,151
Kentucky,Menifee County,3,310,161,149
Kentucky,Menifee County,4,435,269,166
Kentucky,Menifee County,5,374,213,161
Kentucky,Menifee County,6,365,203,162
Kentucky,Menifee County,7,317,171,146
Kentucky,Menifee County,8,334,163,171
Kentucky,Menifee County,9,408,203,205
Kentucky,Menifee County,10,429,218,211
Kentucky,Menifee County,11,469,241,228
Kentucky,Menifee County,12,533,262,271
Kentucky,Menifee County,13,483,247,236
Kentucky,Menifee County,14,470,226,244
Kentucky,Menifee County,15,338,157,181
Kentucky,Menifee County,16,256,117,139
Kentucky,Menifee County,17,160,65,95
Kentucky,Menifee County,18,129,38,91
Kentucky,Mercer County,0,21774,10683,11091
Kentucky,Mercer County,1,1284,655,629
Kentucky,Mercer County,2,1314,696,618
Kentucky,Mercer County,3,1372,700,672
Kentucky,Mercer County,4,1252,664,588
Kentucky,Mercer County,5,1202,617,585
Kentucky,Mercer County,6,1306,676,630
Kentucky,Mercer County,7,1179,601,578
Kentucky,Mercer County,8,1220,608,612
Kentucky,Mercer County,9,1174,573,601
Kentucky,Mercer County,10,1416,694,722
Kentucky,Mercer County,11,1642,782,860
Kentucky,Mercer County,12,1733,852,881
Kentucky,Mercer County,13,1591,798,793
Kentucky,Mercer County,14,1297,601,696
Kentucky,Mercer County,15,1092,495,597
Kentucky,Mercer County,16,759,343,416
Kentucky,Mercer County,17,488,194,294
Kentucky,Mercer County,18,453,134,319
Kentucky,Metcalfe County,0,10030,4973,5057
Kentucky,Metcalfe County,1,625,319,306
Kentucky,Metcalfe County,2,690,367,323
Kentucky,Metcalfe County,3,654,333,321
Kentucky,Metcalfe County,4,590,312,278
Kentucky,Metcalfe County,5,533,280,253
Kentucky,Metcalfe County,6,617,318,299
Kentucky,Metcalfe County,7,512,256,256
Kentucky,Metcalfe County,8,586,281,305
Kentucky,Metcalfe County,9,538,271,267
Kentucky,Metcalfe County,10,635,328,307
Kentucky,Metcalfe County,11,721,354,367
Kentucky,Metcalfe County,12,728,365,363
Kentucky,Metcalfe County,13,727,356,371
Kentucky,Metcalfe County,14,572,264,308
Kentucky,Metcalfe County,15,461,215,246
Kentucky,Metcalfe County,16,374,181,193
Kentucky,Metcalfe County,17,269,114,155
Kentucky,Metcalfe County,18,198,59,139
Kentucky,Monroe County,0,10718,5343,5375
Kentucky,Monroe County,1,675,365,310
Kentucky,Monroe County,2,640,333,307
Kentucky,Monroe County,3,692,372,320
Kentucky,Monroe County,4,646,348,298
Kentucky,Monroe County,5,593,304,289
Kentucky,Monroe County,6,625,316,309
Kentucky,Monroe County,7,569,299,270
Kentucky,Monroe County,8,631,294,337
Kentucky,Monroe County,9,626,335,291
Kentucky,Monroe County,10,674,330,344
Kentucky,Monroe County,11,757,391,366
Kentucky,Monroe County,12,808,398,410
Kentucky,Monroe County,13,766,383,383
Kentucky,Monroe County,14,631,290,341
Kentucky,Monroe County,15,554,254,300
Kentucky,Monroe County,16,395,179,216
Kentucky,Monroe County,17,269,104,165
Kentucky,Monroe County,18,167,48,119
Kentucky,Montgomery County,0,28203,13790,14413
Kentucky,Montgomery County,1,1869,962,907
Kentucky,Montgomery County,2,1821,966,855
Kentucky,Montgomery County,3,1863,979,884
Kentucky,Montgomery County,4,1747,912,835
Kentucky,Montgomery County,5,1572,831,741
Kentucky,Montgomery County,6,1999,992,1007
Kentucky,Montgomery County,7,1629,829,800
Kentucky,Montgomery County,8,1747,825,922
Kentucky,Montgomery County,9,1934,918,1016
Kentucky,Montgomery County,10,2027,991,1036
Kentucky,Montgomery County,11,1916,939,977
Kentucky,Montgomery County,12,1838,883,955
Kentucky,Montgomery County,13,1770,807,963
Kentucky,Montgomery County,14,1526,699,827
Kentucky,Montgomery County,15,1184,530,654
Kentucky,Montgomery County,16,808,360,448
Kentucky,Montgomery County,17,485,204,281
Kentucky,Montgomery County,18,468,163,305
Kentucky,Morgan County,0,13345,7627,5718
Kentucky,Morgan County,1,654,368,286
Kentucky,Morgan County,2,643,345,298
Kentucky,Morgan County,3,690,359,331
Kentucky,Morgan County,4,683,396,287
Kentucky,Morgan County,5,808,548,260
Kentucky,Morgan County,6,1057,720,337
Kentucky,Morgan County,7,956,639,317
Kentucky,Morgan County,8,932,555,377
Kentucky,Morgan County,9,935,573,362
Kentucky,Morgan County,10,1015,600,415
Kentucky,Morgan County,11,868,464,404
Kentucky,Morgan County,12,925,496,429
Kentucky,Morgan County,13,944,510,434
Kentucky,Morgan County,14,825,417,408
Kentucky,Morgan County,15,541,254,287
Kentucky,Morgan County,16,373,162,211
Kentucky,Morgan County,17,274,134,140
Kentucky,Morgan County,18,222,87,135
Kentucky,Muhlenberg County,0,30774,15708,15066
Kentucky,Muhlenberg County,1,1729,908,821
Kentucky,Muhlenberg County,2,1641,848,793
Kentucky,Muhlenberg County,3,1837,980,857
Kentucky,Muhlenberg County,4,1958,1047,911
Kentucky,Muhlenberg County,5,1949,1136,813
Kentucky,Muhlenberg County,6,1967,1074,893
Kentucky,Muhlenberg County,7,1768,972,796
Kentucky,Muhlenberg County,8,1871,957,914
Kentucky,Muhlenberg County,9,1929,1054,875
Kentucky,Muhlenberg County,10,1970,1049,921
Kentucky,Muhlenberg County,11,2016,1033,983
Kentucky,Muhlenberg County,12,2179,1069,1110
Kentucky,Muhlenberg County,13,2075,1001,1074
Kentucky,Muhlenberg County,14,1802,880,922
Kentucky,Muhlenberg County,15,1592,733,859
Kentucky,Muhlenberg County,16,1129,487,642
Kentucky,Muhlenberg County,17,724,288,436
Kentucky,Muhlenberg County,18,638,192,446
Kentucky,Nelson County,0,45851,22625,23226
Kentucky,Nelson County,1,2844,1482,1362
Kentucky,Nelson County,2,3046,1588,1458
Kentucky,Nelson County,3,3090,1643,1447
Kentucky,Nelson County,4,2813,1455,1358
Kentucky,Nelson County,5,2619,1316,1303
Kentucky,Nelson County,6,3098,1529,1569
Kentucky,Nelson County,7,2739,1342,1397
Kentucky,Nelson County,8,3008,1500,1508
Kentucky,Nelson County,9,2712,1349,1363
Kentucky,Nelson County,10,3017,1482,1535
Kentucky,Nelson County,11,3184,1549,1635
Kentucky,Nelson County,12,3420,1692,1728
Kentucky,Nelson County,13,3086,1512,1574
Kentucky,Nelson County,14,2607,1247,1360
Kentucky,Nelson County,15,1896,907,989
Kentucky,Nelson County,16,1225,516,709
Kentucky,Nelson County,17,757,306,451
Kentucky,Nelson County,18,690,210,480
Kentucky,Nicholas County,0,7166,3550,3616
Kentucky,Nicholas County,1,463,242,221
Kentucky,Nicholas County,2,469,230,239
Kentucky,Nicholas County,3,472,236,236
Kentucky,Nicholas County,4,472,244,228
Kentucky,Nicholas County,5,406,216,190
Kentucky,Nicholas County,6,431,205,226
Kentucky,Nicholas County,7,347,174,173
Kentucky,Nicholas County,8,455,222,233
Kentucky,Nicholas County,9,434,224,210
Kentucky,Nicholas County,10,484,229,255
Kentucky,Nicholas County,11,535,290,245
Kentucky,Nicholas County,12,544,268,276
Kentucky,Nicholas County,13,469,230,239
Kentucky,Nicholas County,14,387,174,213
Kentucky,Nicholas County,15,331,165,166
Kentucky,Nicholas County,16,210,94,116
Kentucky,Nicholas County,17,128,48,80
Kentucky,Nicholas County,18,129,59,70
Kentucky,Ohio County,0,24087,11991,12096
Kentucky,Ohio County,1,1464,746,718
Kentucky,Ohio County,2,1601,786,815
Kentucky,Ohio County,3,1815,915,900
Kentucky,Ohio County,4,1536,831,705
Kentucky,Ohio County,5,1280,668,612
Kentucky,Ohio County,6,1463,795,668
Kentucky,Ohio County,7,1356,648,708
Kentucky,Ohio County,8,1525,771,754
Kentucky,Ohio County,9,1469,736,733
Kentucky,Ohio County,10,1529,765,764
Kentucky,Ohio County,11,1527,751,776
Kentucky,Ohio County,12,1676,830,846
Kentucky,Ohio County,13,1559,754,805
Kentucky,Ohio County,14,1388,670,718
Kentucky,Ohio County,15,1127,552,575
Kentucky,Ohio County,16,804,394,410
Kentucky,Ohio County,17,496,213,283
Kentucky,Ohio County,18,472,166,306
Kentucky,Oldham County,0,66470,34810,31660
Kentucky,Oldham County,1,3370,1679,1691
Kentucky,Oldham County,2,4663,2335,2328
Kentucky,Oldham County,3,5439,2729,2710
Kentucky,Oldham County,4,5176,2720,2456
Kentucky,Oldham County,5,3738,2112,1626
Kentucky,Oldham County,6,3175,1897,1278
Kentucky,Oldham County,7,3540,2021,1519
Kentucky,Oldham County,8,4770,2575,2195
Kentucky,Oldham County,9,4907,2670,2237
Kentucky,Oldham County,10,5512,2939,2573
Kentucky,Oldham County,11,5055,2755,2300
Kentucky,Oldham County,12,4571,2335,2236
Kentucky,Oldham County,13,3777,1868,1909
Kentucky,Oldham County,14,3129,1558,1571
Kentucky,Oldham County,15,2558,1261,1297
Kentucky,Oldham County,16,1513,727,786
Kentucky,Oldham County,17,816,379,437
Kentucky,Oldham County,18,761,250,511
Kentucky,Owen County,0,10880,5403,5477
Kentucky,Owen County,1,551,290,261
Kentucky,Owen County,2,636,338,298
Kentucky,Owen County,3,775,363,412
Kentucky,Owen County,4,679,340,339
Kentucky,Owen County,5,578,297,281
Kentucky,Owen County,6,641,304,337
Kentucky,Owen County,7,543,275,268
Kentucky,Owen County,8,683,361,322
Kentucky,Owen County,9,650,301,349
Kentucky,Owen County,10,765,384,381
Kentucky,Owen County,11,709,366,343
Kentucky,Owen County,12,823,418,405
Kentucky,Owen County,13,834,401,433
Kentucky,Owen County,14,704,363,341
Kentucky,Owen County,15,525,245,280
Kentucky,Owen County,16,399,213,186
Kentucky,Owen County,17,195,91,104
Kentucky,Owen County,18,190,53,137
Kentucky,Owsley County,0,4472,2208,2264
Kentucky,Owsley County,1,299,160,139
Kentucky,Owsley County,2,248,110,138
Kentucky,Owsley County,3,280,147,133
Kentucky,Owsley County,4,259,126,133
Kentucky,Owsley County,5,226,103,123
Kentucky,Owsley County,6,261,135,126
Kentucky,Owsley County,7,282,155,127
Kentucky,Owsley County,8,244,115,129
Kentucky,Owsley County,9,254,137,117
Kentucky,Owsley County,10,287,139,148
Kentucky,Owsley County,11,316,151,165
Kentucky,Owsley County,12,318,174,144
Kentucky,Owsley County,13,321,155,166
Kentucky,Owsley County,14,311,154,157
Kentucky,Owsley County,15,195,92,103
Kentucky,Owsley County,16,179,78,101
Kentucky,Owsley County,17,99,37,62
Kentucky,Owsley County,18,93,40,53
Kentucky,Pendleton County,0,14529,7406,7123
Kentucky,Pendleton County,1,862,470,392
Kentucky,Pendleton County,2,841,449,392
Kentucky,Pendleton County,3,969,507,462
Kentucky,Pendleton County,4,905,453,452
Kentucky,Pendleton County,5,801,453,348
Kentucky,Pendleton County,6,968,484,484
Kentucky,Pendleton County,7,779,394,385
Kentucky,Pendleton County,8,833,414,419
Kentucky,Pendleton County,9,833,443,390
Kentucky,Pendleton County,10,1013,526,487
Kentucky,Pendleton County,11,1137,593,544
Kentucky,Pendleton County,12,1179,595,584
Kentucky,Pendleton County,13,1072,550,522
Kentucky,Pendleton County,14,841,409,432
Kentucky,Pendleton County,15,602,291,311
Kentucky,Pendleton County,16,413,182,231
Kentucky,Pendleton County,17,242,111,131
Kentucky,Pendleton County,18,239,82,157
Kentucky,Perry County,0,26092,12836,13256
Kentucky,Perry County,1,1754,887,867
Kentucky,Perry County,2,1658,880,778
Kentucky,Perry County,3,1625,844,781
Kentucky,Perry County,4,1412,721,691
Kentucky,Perry County,5,1295,648,647
Kentucky,Perry County,6,1668,824,844
Kentucky,Perry County,7,1577,803,774
Kentucky,Perry County,8,1627,813,814
Kentucky,Perry County,9,1691,840,851
Kentucky,Perry County,10,1696,824,872
Kentucky,Perry County,11,1911,918,993
Kentucky,Perry County,12,1857,854,1003
Kentucky,Perry County,13,1892,924,968
Kentucky,Perry County,14,1616,788,828
Kentucky,Perry County,15,1156,524,632
Kentucky,Perry County,16,750,343,407
Kentucky,Perry County,17,510,232,278
Kentucky,Perry County,18,397,169,228
Kentucky,Pike County,0,58402,28499,29903
Kentucky,Pike County,1,3071,1554,1517
Kentucky,Pike County,2,3324,1701,1623
Kentucky,Pike County,3,3519,1757,1762
Kentucky,Pike County,4,3467,1813,1654
Kentucky,Pike County,5,3258,1704,1554
Kentucky,Pike County,6,3472,1832,1640
Kentucky,Pike County,7,3048,1551,1497
Kentucky,Pike County,8,3528,1748,1780
Kentucky,Pike County,9,3867,1932,1935
Kentucky,Pike County,10,3946,1878,2068
Kentucky,Pike County,11,4097,1964,2133
Kentucky,Pike County,12,4419,2130,2289
Kentucky,Pike County,13,4424,2146,2278
Kentucky,Pike County,14,3824,1836,1988
Kentucky,Pike County,15,2948,1296,1652
Kentucky,Pike County,16,1876,778,1098
Kentucky,Pike County,17,1176,509,667
Kentucky,Pike County,18,1138,370,768
Kentucky,Powell County,0,12442,6177,6265
Kentucky,Powell County,1,837,431,406
Kentucky,Powell County,2,822,420,402
Kentucky,Powell County,3,848,437,411
Kentucky,Powell County,4,763,399,364
Kentucky,Powell County,5,701,342,359
Kentucky,Powell County,6,795,404,391
Kentucky,Powell County,7,718,364,354
Kentucky,Powell County,8,834,417,417
Kentucky,Powell County,9,786,396,390
Kentucky,Powell County,10,853,432,421
Kentucky,Powell County,11,808,431,377
Kentucky,Powell County,12,855,393,462
Kentucky,Powell County,13,847,430,417
Kentucky,Powell County,14,692,320,372
Kentucky,Powell County,15,556,259,297
Kentucky,Powell County,16,351,166,185
Kentucky,Powell County,17,209,80,129
Kentucky,Powell County,18,167,56,111
Kentucky,Pulaski County,0,64623,31566,33057
Kentucky,Pulaski County,1,3698,1866,1832
Kentucky,Pulaski County,2,3931,2077,1854
Kentucky,Pulaski County,3,4184,2116,2068
Kentucky,Pulaski County,4,3827,2015,1812
Kentucky,Pulaski County,5,3416,1743,1673
Kentucky,Pulaski County,6,4078,2047,2031
Kentucky,Pulaski County,7,3571,1714,1857
Kentucky,Pulaski County,8,3861,1877,1984
Kentucky,Pulaski County,9,3990,1982,2008
Kentucky,Pulaski County,10,4333,2129,2204
Kentucky,Pulaski County,11,4426,2155,2271
Kentucky,Pulaski County,12,4690,2233,2457
Kentucky,Pulaski County,13,4488,2142,2346
Kentucky,Pulaski County,14,3913,1857,2056
Kentucky,Pulaski County,15,3305,1540,1765
Kentucky,Pulaski County,16,2287,1044,1243
Kentucky,Pulaski County,17,1488,639,849
Kentucky,Pulaski County,18,1137,390,747
Kentucky,Robertson County,0,2135,1079,1056
Kentucky,Robertson County,1,108,57,51
Kentucky,Robertson County,2,120,60,60
Kentucky,Robertson County,3,138,68,70
Kentucky,Robertson County,4,116,65,51
Kentucky,Robertson County,5,115,63,52
Kentucky,Robertson County,6,117,57,60
Kentucky,Robertson County,7,105,55,50
Kentucky,Robertson County,8,95,43,52
Kentucky,Robertson County,9,130,72,58
Kentucky,Robertson County,10,132,61,71
Kentucky,Robertson County,11,165,93,72
Kentucky,Robertson County,12,178,85,93
Kentucky,Robertson County,13,156,72,84
Kentucky,Robertson County,14,121,73,48
Kentucky,Robertson County,15,118,47,71
Kentucky,Robertson County,16,100,54,46
Kentucky,Robertson County,17,55,25,30
Kentucky,Robertson County,18,66,29,37
Kentucky,Rockcastle County,0,16750,8185,8565
Kentucky,Rockcastle County,1,897,458,439
Kentucky,Rockcastle County,2,936,465,471
Kentucky,Rockcastle County,3,1086,514,572
Kentucky,Rockcastle County,4,1040,545,495
Kentucky,Rockcastle County,5,873,440,433
Kentucky,Rockcastle County,6,1057,537,520
Kentucky,Rockcastle County,7,925,459,466
Kentucky,Rockcastle County,8,907,433,474
Kentucky,Rockcastle County,9,1034,483,551
Kentucky,Rockcastle County,10,1199,590,609
Kentucky,Rockcastle County,11,1316,689,627
Kentucky,Rockcastle County,12,1259,608,651
Kentucky,Rockcastle County,13,1180,608,572
Kentucky,Rockcastle County,14,985,458,527
Kentucky,Rockcastle County,15,827,366,461
Kentucky,Rockcastle County,16,605,280,325
Kentucky,Rockcastle County,17,357,154,203
Kentucky,Rockcastle County,18,267,98,169
Kentucky,Rowan County,0,24583,11905,12678
Kentucky,Rowan County,1,1339,659,680
Kentucky,Rowan County,2,1343,693,650
Kentucky,Rowan County,3,1307,690,617
Kentucky,Rowan County,4,2586,1205,1381
Kentucky,Rowan County,5,3668,1818,1850
Kentucky,Rowan County,6,1813,967,846
Kentucky,Rowan County,7,1230,604,626
Kentucky,Rowan County,8,1234,620,614
Kentucky,Rowan County,9,1211,591,620
Kentucky,Rowan County,10,1293,626,667
Kentucky,Rowan County,11,1407,671,736
Kentucky,Rowan County,12,1355,633,722
Kentucky,Rowan County,13,1348,630,718
Kentucky,Rowan County,14,1082,491,591
Kentucky,Rowan County,15,922,403,519
Kentucky,Rowan County,16,665,291,374
Kentucky,Rowan County,17,438,188,250
Kentucky,Rowan County,18,342,125,217
Kentucky,Russell County,0,17821,8756,9065
Kentucky,Russell County,1,1082,584,498
Kentucky,Russell County,2,1180,602,578
Kentucky,Russell County,3,1106,552,554
Kentucky,Russell County,4,1003,515,488
Kentucky,Russell County,5,897,463,434
Kentucky,Russell County,6,1018,498,520
Kentucky,Russell County,7,917,472,445
Kentucky,Russell County,8,978,477,501
Kentucky,Russell County,9,1016,476,540
Kentucky,Russell County,10,1205,606,599
Kentucky,Russell County,11,1290,625,665
Kentucky,Russell County,12,1261,619,642
Kentucky,Russell County,13,1271,580,691
Kentucky,Russell County,14,1165,580,585
Kentucky,Russell County,15,937,472,465
Kentucky,Russell County,16,650,313,337
Kentucky,Russell County,17,431,190,241
Kentucky,Russell County,18,414,132,282
Kentucky,Scott County,0,56031,27650,28381
Kentucky,Scott County,1,3672,1874,1798
Kentucky,Scott County,2,3952,2001,1951
Kentucky,Scott County,3,4131,2084,2047
Kentucky,Scott County,4,3862,1913,1949
Kentucky,Scott County,5,3626,1875,1751
Kentucky,Scott County,6,4043,2078,1965
Kentucky,Scott County,7,3643,1801,1842
Kentucky,Scott County,8,4097,1994,2103
Kentucky,Scott County,9,3914,1874,2040
Kentucky,Scott County,10,4045,2061,1984
Kentucky,Scott County,11,3698,1851,1847
Kentucky,Scott County,12,3543,1788,1755
Kentucky,Scott County,13,3058,1445,1613
Kentucky,Scott County,14,2557,1225,1332
Kentucky,Scott County,15,1757,796,961
Kentucky,Scott County,16,1162,528,634
Kentucky,Scott County,17,655,259,396
Kentucky,Scott County,18,616,203,413
Kentucky,Shelby County,0,48518,23581,24937
Kentucky,Shelby County,1,3006,1529,1477
Kentucky,Shelby County,2,3080,1679,1401
Kentucky,Shelby County,3,3013,1528,1485
Kentucky,Shelby County,4,3250,1618,1632
Kentucky,Shelby County,5,3043,1523,1520
Kentucky,Shelby County,6,3024,1392,1632
Kentucky,Shelby County,7,2952,1364,1588
Kentucky,Shelby County,8,3218,1527,1691
Kentucky,Shelby County,9,3108,1484,1624
Kentucky,Shelby County,10,3400,1652,1748
Kentucky,Shelby County,11,3424,1668,1756
Kentucky,Shelby County,12,3463,1718,1745
Kentucky,Shelby County,13,3053,1452,1601
Kentucky,Shelby County,14,2589,1234,1355
Kentucky,Shelby County,15,2067,985,1082
Kentucky,Shelby County,16,1370,643,727
Kentucky,Shelby County,17,734,334,400
Kentucky,Shelby County,18,724,251,473
Kentucky,Simpson County,0,18529,9119,9410
Kentucky,Simpson County,1,1206,608,598
Kentucky,Simpson County,2,1220,646,574
Kentucky,Simpson County,3,1247,621,626
Kentucky,Simpson County,4,1238,669,569
Kentucky,Simpson County,5,1084,536,548
Kentucky,Simpson County,6,1297,713,584
Kentucky,Simpson County,7,1086,519,567
Kentucky,Simpson County,8,1101,542,559
Kentucky,Simpson County,9,1046,511,535
Kentucky,Simpson County,10,1219,601,618
Kentucky,Simpson County,11,1238,602,636
Kentucky,Simpson County,12,1330,672,658
Kentucky,Simpson County,13,1161,562,599
Kentucky,Simpson County,14,1004,465,539
Kentucky,Simpson County,15,830,365,465
Kentucky,Simpson County,16,565,232,333
Kentucky,Simpson County,17,348,149,199
Kentucky,Simpson County,18,309,106,203
Kentucky,Spencer County,0,18794,9515,9279
Kentucky,Spencer County,1,1032,549,483
Kentucky,Spencer County,2,1111,575,536
Kentucky,Spencer County,3,1297,687,610
Kentucky,Spencer County,4,1238,649,589
Kentucky,Spencer County,5,947,484,463
Kentucky,Spencer County,6,980,488,492
Kentucky,Spencer County,7,1054,510,544
Kentucky,Spencer County,8,1271,615,656
Kentucky,Spencer County,9,1286,640,646
Kentucky,Spencer County,10,1527,780,747
Kentucky,Spencer County,11,1524,761,763
Kentucky,Spencer County,12,1576,795,781
Kentucky,Spencer County,13,1324,698,626
Kentucky,Spencer County,14,1022,506,516
Kentucky,Spencer County,15,702,332,370
Kentucky,Spencer County,16,459,233,226
Kentucky,Spencer County,17,236,118,118
Kentucky,Spencer County,18,208,95,113
Kentucky,Taylor County,0,25549,12483,13066
Kentucky,Taylor County,1,1624,816,808
Kentucky,Taylor County,2,1570,816,754
Kentucky,Taylor County,3,1514,781,733
Kentucky,Taylor County,4,1987,977,1010
Kentucky,Taylor County,5,1960,1013,947
Kentucky,Taylor County,6,1664,863,801
Kentucky,Taylor County,7,1520,787,733
Kentucky,Taylor County,8,1444,746,698
Kentucky,Taylor County,9,1255,627,628
Kentucky,Taylor County,10,1389,669,720
Kentucky,Taylor County,11,1578,768,810
Kentucky,Taylor County,12,1753,822,931
Kentucky,Taylor County,13,1692,785,907
Kentucky,Taylor County,14,1408,666,742
Kentucky,Taylor County,15,1171,544,627
Kentucky,Taylor County,16,887,404,483
Kentucky,Taylor County,17,633,236,397
Kentucky,Taylor County,18,500,163,337
Kentucky,Todd County,0,12311,6129,6182
Kentucky,Todd County,1,861,420,441
Kentucky,Todd County,2,894,455,439
Kentucky,Todd County,3,973,489,484
Kentucky,Todd County,4,868,452,416
Kentucky,Todd County,5,696,371,325
Kentucky,Todd County,6,747,376,371
Kentucky,Todd County,7,700,349,351
Kentucky,Todd County,8,707,356,351
Kentucky,Todd County,9,724,364,360
Kentucky,Todd County,10,761,385,376
Kentucky,Todd County,11,805,409,396
Kentucky,Todd County,12,834,413,421
Kentucky,Todd County,13,759,387,372
Kentucky,Todd County,14,627,288,339
Kentucky,Todd County,15,526,264,262
Kentucky,Todd County,16,365,168,197
Kentucky,Todd County,17,252,118,134
Kentucky,Todd County,18,212,65,147
Kentucky,Trigg County,0,14643,7259,7384
Kentucky,Trigg County,1,793,436,357
Kentucky,Trigg County,2,871,445,426
Kentucky,Trigg County,3,951,464,487
Kentucky,Trigg County,4,883,453,430
Kentucky,Trigg County,5,663,357,306
Kentucky,Trigg County,6,760,396,364
Kentucky,Trigg County,7,702,334,368
Kentucky,Trigg County,8,737,344,393
Kentucky,Trigg County,9,788,397,391
Kentucky,Trigg County,10,920,452,468
Kentucky,Trigg County,11,1037,489,548
Kentucky,Trigg County,12,1133,558,575
Kentucky,Trigg County,13,1146,539,607
Kentucky,Trigg County,14,1029,505,524
Kentucky,Trigg County,15,915,452,463
Kentucky,Trigg County,16,657,341,316
Kentucky,Trigg County,17,384,195,189
Kentucky,Trigg County,18,274,102,172
Kentucky,Trimble County,0,8515,4267,4248
Kentucky,Trimble County,1,485,251,234
Kentucky,Trimble County,2,515,267,248
Kentucky,Trimble County,3,570,298,272
Kentucky,Trimble County,4,495,259,236
Kentucky,Trimble County,5,476,235,241
Kentucky,Trimble County,6,526,267,259
Kentucky,Trimble County,7,428,212,216
Kentucky,Trimble County,8,510,239,271
Kentucky,Trimble County,9,502,247,255
Kentucky,Trimble County,10,642,324,318
Kentucky,Trimble County,11,609,312,297
Kentucky,Trimble County,12,670,364,306
Kentucky,Trimble County,13,598,299,299
Kentucky,Trimble County,14,478,226,252
Kentucky,Trimble County,15,462,235,227
Kentucky,Trimble County,16,252,99,153
Kentucky,Trimble County,17,156,72,84
Kentucky,Trimble County,18,141,61,80
Kentucky,Union County,0,14505,7556,6949
Kentucky,Union County,1,744,378,366
Kentucky,Union County,2,703,367,336
Kentucky,Union County,3,715,358,357
Kentucky,Union County,4,1288,815,473
Kentucky,Union County,5,1569,1080,489
Kentucky,Union County,6,872,453,419
Kentucky,Union County,7,770,394,376
Kentucky,Union County,8,865,408,457
Kentucky,Union County,9,837,422,415
Kentucky,Union County,10,841,413,428
Kentucky,Union County,11,916,447,469
Kentucky,Union County,12,945,452,493
Kentucky,Union County,13,1035,496,539
Kentucky,Union County,14,863,419,444
Kentucky,Union County,15,640,324,316
Kentucky,Union County,16,391,164,227
Kentucky,Union County,17,273,110,163
Kentucky,Union County,18,238,56,182
Kentucky,Warren County,0,131264,64205,67059
Kentucky,Warren County,1,8460,4196,4264
Kentucky,Warren County,2,8387,4206,4181
Kentucky,Warren County,3,8420,4225,4195
Kentucky,Warren County,4,10971,5309,5662
Kentucky,Warren County,5,15190,7757,7433
Kentucky,Warren County,6,9760,4950,4810
Kentucky,Warren County,7,7960,4060,3900
Kentucky,Warren County,8,8458,4181,4277
Kentucky,Warren County,9,7585,3702,3883
Kentucky,Warren County,10,7517,3767,3750
Kentucky,Warren County,11,7313,3524,3789
Kentucky,Warren County,12,7558,3676,3882
Kentucky,Warren County,13,6789,3173,3616
Kentucky,Warren County,14,5631,2621,3010
Kentucky,Warren County,15,4495,2094,2401
Kentucky,Warren County,16,2992,1341,1651
Kentucky,Warren County,17,1825,783,1042
Kentucky,Warren County,18,1953,640,1313
Kentucky,Washington County,0,12084,5980,6104
Kentucky,Washington County,1,799,437,362
Kentucky,Washington County,2,757,386,371
Kentucky,Washington County,3,788,412,376
Kentucky,Washington County,4,794,454,340
Kentucky,Washington County,5,691,352,339
Kentucky,Washington County,6,723,362,361
Kentucky,Washington County,7,603,283,320
Kentucky,Washington County,8,664,345,319
Kentucky,Washington County,9,698,343,355
Kentucky,Washington County,10,792,380,412
Kentucky,Washington County,11,903,469,434
Kentucky,Washington County,12,883,428,455
Kentucky,Washington County,13,813,398,415
Kentucky,Washington County,14,719,347,372
Kentucky,Washington County,15,514,247,267
Kentucky,Washington County,16,370,166,204
Kentucky,Washington County,17,297,99,198
Kentucky,Washington County,18,276,72,204
Kentucky,Wayne County,0,20468,10174,10294
Kentucky,Wayne County,1,1118,592,526
Kentucky,Wayne County,2,1177,595,582
Kentucky,Wayne County,3,1175,590,585
Kentucky,Wayne County,4,1144,597,547
Kentucky,Wayne County,5,1069,562,507
Kentucky,Wayne County,6,1256,622,634
Kentucky,Wayne County,7,1112,566,546
Kentucky,Wayne County,8,1175,617,558
Kentucky,Wayne County,9,1166,604,562
Kentucky,Wayne County,10,1383,704,679
Kentucky,Wayne County,11,1378,677,701
Kentucky,Wayne County,12,1483,693,790
Kentucky,Wayne County,13,1526,738,788
Kentucky,Wayne County,14,1387,702,685
Kentucky,Wayne County,15,1148,519,629
Kentucky,Wayne County,16,839,387,452
Kentucky,Wayne County,17,540,251,289
Kentucky,Wayne County,18,392,158,234
Kentucky,Webster County,0,13111,6487,6624
Kentucky,Webster County,1,872,403,469
Kentucky,Webster County,2,831,431,400
Kentucky,Webster County,3,889,445,444
Kentucky,Webster County,4,718,349,369
Kentucky,Webster County,5,689,358,331
Kentucky,Webster County,6,850,449,401
Kentucky,Webster County,7,776,408,368
Kentucky,Webster County,8,821,434,387
Kentucky,Webster County,9,819,427,392
Kentucky,Webster County,10,840,422,418
Kentucky,Webster County,11,855,429,426
Kentucky,Webster County,12,909,434,475
Kentucky,Webster County,13,959,471,488
Kentucky,Webster County,14,788,391,397
Kentucky,Webster County,15,565,269,296
Kentucky,Webster County,16,394,179,215
Kentucky,Webster County,17,280,98,182
Kentucky,Webster County,18,256,90,166
Kentucky,Whitley County,0,36242,17835,18407
Kentucky,Whitley County,1,2824,1448,1376
Kentucky,Whitley County,2,2502,1280,1222
Kentucky,Whitley County,3,2387,1279,1108
Kentucky,Whitley County,4,2670,1349,1321
Kentucky,Whitley County,5,2797,1467,1330
Kentucky,Whitley County,6,2383,1173,1210
Kentucky,Whitley County,7,1980,988,992
Kentucky,Whitley County,8,2049,1000,1049
Kentucky,Whitley County,9,1991,988,1003
Kentucky,Whitley County,10,2138,1042,1096
Kentucky,Whitley County,11,2293,1084,1209
Kentucky,Whitley County,12,2212,1080,1132
Kentucky,Whitley County,13,2237,1058,1179
Kentucky,Whitley County,14,1888,926,962
Kentucky,Whitley County,15,1479,694,785
Kentucky,Whitley County,16,1148,495,653
Kentucky,Whitley County,17,696,299,397
Kentucky,Whitley County,18,568,185,383
Kentucky,Wolfe County,0,7177,3515,3662
Kentucky,Wolfe County,1,442,229,213
Kentucky,Wolfe County,2,416,217,199
Kentucky,Wolfe County,3,485,253,232
Kentucky,Wolfe County,4,439,219,220
Kentucky,Wolfe County,5,351,185,166
Kentucky,Wolfe County,6,394,207,187
Kentucky,Wolfe County,7,376,173,203
Kentucky,Wolfe County,8,441,206,235
Kentucky,Wolfe County,9,449,215,234
Kentucky,Wolfe County,10,419,199,220
Kentucky,Wolfe County,11,510,255,255
Kentucky,Wolfe County,12,571,277,294
Kentucky,Wolfe County,13,496,235,261
Kentucky,Wolfe County,14,467,241,226
Kentucky,Wolfe County,15,376,185,191
Kentucky,Wolfe County,16,250,98,152
Kentucky,Wolfe County,17,166,81,85
Kentucky,Wolfe County,18,129,40,89
Kentucky,Woodford County,0,26533,12773,13760
Kentucky,Woodford County,1,1534,810,724
Kentucky,Woodford County,2,1595,794,801
Kentucky,Woodford County,3,1672,808,864
Kentucky,Woodford County,4,1697,794,903
Kentucky,Woodford County,5,1500,673,827
Kentucky,Woodford County,6,1368,678,690
Kentucky,Woodford County,7,1358,689,669
Kentucky,Woodford County,8,1593,790,803
Kentucky,Woodford County,9,1629,828,801
Kentucky,Woodford County,10,1738,856,882
Kentucky,Woodford County,11,1803,844,959
Kentucky,Woodford County,12,2138,1035,1103
Kentucky,Woodford County,13,1920,914,1006
Kentucky,Woodford County,14,1783,845,938
Kentucky,Woodford County,15,1342,650,692
Kentucky,Woodford County,16,835,373,462
Kentucky,Woodford County,17,564,238,326
Kentucky,Woodford County,18,464,154,310
Louisiana,Acadia Parish,0,62190,30342,31848
Louisiana,Acadia Parish,1,4373,2259,2114
Louisiana,Acadia Parish,2,4410,2230,2180
Louisiana,Acadia Parish,3,4619,2422,2197
Louisiana,Acadia Parish,4,4115,2133,1982
Louisiana,Acadia Parish,5,3663,1876,1787
Louisiana,Acadia Parish,6,4443,2209,2234
Louisiana,Acadia Parish,7,3838,1875,1963
Louisiana,Acadia Parish,8,3977,1919,2058
Louisiana,Acadia Parish,9,3454,1655,1799
Louisiana,Acadia Parish,10,3577,1706,1871
Louisiana,Acadia Parish,11,3984,1917,2067
Louisiana,Acadia Parish,12,4272,2083,2189
Louisiana,Acadia Parish,13,3974,1912,2062
Louisiana,Acadia Parish,14,3132,1517,1615
Louisiana,Acadia Parish,15,2376,1048,1328
Louisiana,Acadia Parish,16,1692,771,921
Louisiana,Acadia Parish,17,1150,473,677
Louisiana,Acadia Parish,18,1141,337,804
Louisiana,Allen Parish,0,25605,14516,11089
Louisiana,Allen Parish,1,1518,778,740
Louisiana,Allen Parish,2,1574,845,729
Louisiana,Allen Parish,3,1601,808,793
Louisiana,Allen Parish,4,1492,782,710
Louisiana,Allen Parish,5,1569,974,595
Louisiana,Allen Parish,6,2054,1337,717
Louisiana,Allen Parish,7,1980,1365,615
Louisiana,Allen Parish,8,1848,1198,650
Louisiana,Allen Parish,9,1700,1078,622
Louisiana,Allen Parish,10,1718,1070,648
Louisiana,Allen Parish,11,1630,931,699
Louisiana,Allen Parish,12,1639,889,750
Louisiana,Allen Parish,13,1438,748,690
Louisiana,Allen Parish,14,1235,613,622
Louisiana,Allen Parish,15,973,434,539
Louisiana,Allen Parish,16,709,306,403
Louisiana,Allen Parish,17,490,205,285
Louisiana,Allen Parish,18,437,155,282
Louisiana,Ascension Parish,0,124672,61555,63117
Louisiana,Ascension Parish,1,8851,4493,4358
Louisiana,Ascension Parish,2,9249,4791,4458
Louisiana,Ascension Parish,3,9642,4966,4676
Louisiana,Ascension Parish,4,8564,4417,4147
Louisiana,Ascension Parish,5,7074,3671,3403
Louisiana,Ascension Parish,6,8394,4103,4291
Louisiana,Ascension Parish,7,8985,4439,4546
Louisiana,Ascension Parish,8,9397,4602,4795
Louisiana,Ascension Parish,9,8200,3933,4267
Louisiana,Ascension Parish,10,8647,4215,4432
Louisiana,Ascension Parish,11,8312,4085,4227
Louisiana,Ascension Parish,12,7831,3895,3936
Louisiana,Ascension Parish,13,6792,3307,3485
Louisiana,Ascension Parish,14,5327,2539,2788
Louisiana,Ascension Parish,15,3946,1889,2057
Louisiana,Ascension Parish,16,2739,1187,1552
Louisiana,Ascension Parish,17,1448,596,852
Louisiana,Ascension Parish,18,1274,427,847
Louisiana,Assumption Parish,0,22300,10819,11481
Louisiana,Assumption Parish,1,1249,613,636
Louisiana,Assumption Parish,2,1259,629,630
Louisiana,Assumption Parish,3,1420,724,696
Louisiana,Assumption Parish,4,1351,688,663
Louisiana,Assumption Parish,5,1309,668,641
Louisiana,Assumption Parish,6,1525,753,772
Louisiana,Assumption Parish,7,1297,630,667
Louisiana,Assumption Parish,8,1355,647,708
Louisiana,Assumption Parish,9,1260,599,661
Louisiana,Assumption Parish,10,1407,656,751
Louisiana,Assumption Parish,11,1577,759,818
Louisiana,Assumption Parish,12,1696,807,889
Louisiana,Assumption Parish,13,1575,766,809
Louisiana,Assumption Parish,14,1336,648,688
Louisiana,Assumption Parish,15,1029,507,522
Louisiana,Assumption Parish,16,752,367,385
Louisiana,Assumption Parish,17,429,191,238
Louisiana,Assumption Parish,18,474,167,307
Louisiana,Avoyelles Parish,0,40462,20408,20054
Louisiana,Avoyelles Parish,1,2691,1409,1282
Louisiana,Avoyelles Parish,2,2657,1400,1257
Louisiana,Avoyelles Parish,3,2629,1367,1262
Louisiana,Avoyelles Parish,4,2500,1297,1203
Louisiana,Avoyelles Parish,5,2366,1294,1072
Louisiana,Avoyelles Parish,6,2906,1548,1358
Louisiana,Avoyelles Parish,7,2635,1392,1243
Louisiana,Avoyelles Parish,8,2643,1429,1214
Louisiana,Avoyelles Parish,9,2374,1238,1136
Louisiana,Avoyelles Parish,10,2367,1206,1161
Louisiana,Avoyelles Parish,11,2606,1336,1270
Louisiana,Avoyelles Parish,12,2705,1319,1386
Louisiana,Avoyelles Parish,13,2533,1199,1334
Louisiana,Avoyelles Parish,14,2201,1040,1161
Louisiana,Avoyelles Parish,15,1712,785,927
Louisiana,Avoyelles Parish,16,1186,516,670
Louisiana,Avoyelles Parish,17,921,369,552
Louisiana,Avoyelles Parish,18,830,264,566
Louisiana,Beauregard Parish,0,37253,18888,18365
Louisiana,Beauregard Parish,1,2517,1284,1233
Louisiana,Beauregard Parish,2,2535,1309,1226
Louisiana,Beauregard Parish,3,2544,1313,1231
Louisiana,Beauregard Parish,4,2439,1284,1155
Louisiana,Beauregard Parish,5,2271,1245,1026
Louisiana,Beauregard Parish,6,2634,1470,1164
Louisiana,Beauregard Parish,7,2446,1344,1102
Louisiana,Beauregard Parish,8,2368,1217,1151
Louisiana,Beauregard Parish,9,2336,1207,1129
Louisiana,Beauregard Parish,10,2338,1162,1176
Louisiana,Beauregard Parish,11,2262,1132,1130
Louisiana,Beauregard Parish,12,2466,1213,1253
Louisiana,Beauregard Parish,13,2226,1073,1153
Louisiana,Beauregard Parish,14,1983,912,1071
Louisiana,Beauregard Parish,15,1543,705,838
Louisiana,Beauregard Parish,16,1062,475,587
Louisiana,Beauregard Parish,17,709,328,381
Louisiana,Beauregard Parish,18,574,215,359
Louisiana,Bienville Parish,0,13308,6381,6927
Louisiana,Bienville Parish,1,780,384,396
Louisiana,Bienville Parish,2,803,410,393
Louisiana,Bienville Parish,3,865,435,430
Louisiana,Bienville Parish,4,793,388,405
Louisiana,Bienville Parish,5,700,372,328
Louisiana,Bienville Parish,6,843,408,435
Louisiana,Bienville Parish,7,788,379,409
Louisiana,Bienville Parish,8,722,346,376
Louisiana,Bienville Parish,9,657,314,343
Louisiana,Bienville Parish,10,754,380,374
Louisiana,Bienville Parish,11,883,430,453
Louisiana,Bienville Parish,12,1053,511,542
Louisiana,Bienville Parish,13,882,432,450
Louisiana,Bienville Parish,14,804,389,415
Louisiana,Bienville Parish,15,667,305,362
Louisiana,Bienville Parish,16,573,245,328
Louisiana,Bienville Parish,17,321,129,192
Louisiana,Bienville Parish,18,420,124,296
Louisiana,Bossier Parish,0,127185,62919,64266
Louisiana,Bossier Parish,1,8802,4489,4313
Louisiana,Bossier Parish,2,8856,4550,4306
Louisiana,Bossier Parish,3,8853,4552,4301
Louisiana,Bossier Parish,4,8085,4301,3784
Louisiana,Bossier Parish,5,8269,4540,3729
Louisiana,Bossier Parish,6,9687,4880,4807
Louisiana,Bossier Parish,7,9748,4805,4943
Louisiana,Bossier Parish,8,9285,4640,4645
Louisiana,Bossier Parish,9,7734,3858,3876
Louisiana,Bossier Parish,10,7507,3690,3817
Louisiana,Bossier Parish,11,7058,3425,3633
Louisiana,Bossier Parish,12,7849,3835,4014
Louisiana,Bossier Parish,13,7212,3351,3861
Louisiana,Bossier Parish,14,5931,2776,3155
Louisiana,Bossier Parish,15,4561,2057,2504
Louisiana,Bossier Parish,16,3297,1428,1869
Louisiana,Bossier Parish,17,2326,983,1343
Louisiana,Bossier Parish,18,2125,759,1366
Louisiana,Caddo Parish,0,242922,114969,127953
Louisiana,Caddo Parish,1,16147,8090,8057
Louisiana,Caddo Parish,2,16255,8220,8035
Louisiana,Caddo Parish,3,15785,7962,7823
Louisiana,Caddo Parish,4,15065,7576,7489
Louisiana,Caddo Parish,5,14539,7157,7382
Louisiana,Caddo Parish,6,17525,8524,9001
Louisiana,Caddo Parish,7,16161,7755,8406
Louisiana,Caddo Parish,8,15743,7603,8140
Louisiana,Caddo Parish,9,13640,6305,7335
Louisiana,Caddo Parish,10,14135,6590,7545
Louisiana,Caddo Parish,11,13980,6674,7306
Louisiana,Caddo Parish,12,16309,7617,8692
Louisiana,Caddo Parish,13,16032,7294,8738
Louisiana,Caddo Parish,14,13802,6223,7579
Louisiana,Caddo Parish,15,10305,4631,5674
Louisiana,Caddo Parish,16,7246,3054,4192
Louisiana,Caddo Parish,17,4873,1880,2993
Louisiana,Caddo Parish,18,5380,1814,3566
Louisiana,Calcasieu Parish,0,203112,99313,103799
Louisiana,Calcasieu Parish,1,14511,7475,7036
Louisiana,Calcasieu Parish,2,13952,7198,6754
Louisiana,Calcasieu Parish,3,14022,7098,6924
Louisiana,Calcasieu Parish,4,12912,6682,6230
Louisiana,Calcasieu Parish,5,12921,6420,6501
Louisiana,Calcasieu Parish,6,15874,7919,7955
Louisiana,Calcasieu Parish,7,14150,6922,7228
Louisiana,Calcasieu Parish,8,13536,6729,6807
Louisiana,Calcasieu Parish,9,11431,5634,5797
Louisiana,Calcasieu Parish,10,11755,5796,5959
Louisiana,Calcasieu Parish,11,11905,5719,6186
Louisiana,Calcasieu Parish,12,13406,6413,6993
Louisiana,Calcasieu Parish,13,12680,6017,6663
Louisiana,Calcasieu Parish,14,10092,4802,5290
Louisiana,Calcasieu Parish,15,7658,3465,4193
Louisiana,Calcasieu Parish,16,5358,2298,3060
Louisiana,Calcasieu Parish,17,3735,1538,2197
Louisiana,Calcasieu Parish,18,3214,1188,2026
Louisiana,Caldwell Parish,0,9960,5124,4836
Louisiana,Caldwell Parish,1,621,341,280
Louisiana,Caldwell Parish,2,596,297,299
Louisiana,Caldwell Parish,3,667,352,315
Louisiana,Caldwell Parish,4,618,317,301
Louisiana,Caldwell Parish,5,551,325,226
Louisiana,Caldwell Parish,6,684,389,295
Louisiana,Caldwell Parish,7,622,340,282
Louisiana,Caldwell Parish,8,599,319,280
Louisiana,Caldwell Parish,9,624,340,284
Louisiana,Caldwell Parish,10,669,350,319
Louisiana,Caldwell Parish,11,603,302,301
Louisiana,Caldwell Parish,12,673,350,323
Louisiana,Caldwell Parish,13,664,323,341
Louisiana,Caldwell Parish,14,561,288,273
Louisiana,Caldwell Parish,15,474,213,261
Louisiana,Caldwell Parish,16,330,131,199
Louisiana,Caldwell Parish,17,219,96,123
Louisiana,Caldwell Parish,18,185,51,134
Louisiana,Cameron Parish,0,6968,3468,3500
Louisiana,Cameron Parish,1,359,190,169
Louisiana,Cameron Parish,2,441,227,214
Louisiana,Cameron Parish,3,442,207,235
Louisiana,Cameron Parish,4,445,231,214
Louisiana,Cameron Parish,5,409,198,211
Louisiana,Cameron Parish,6,487,253,234
Louisiana,Cameron Parish,7,395,211,184
Louisiana,Cameron Parish,8,461,221,240
Louisiana,Cameron Parish,9,365,196,169
Louisiana,Cameron Parish,10,399,195,204
Louisiana,Cameron Parish,11,525,275,250
Louisiana,Cameron Parish,12,612,289,323
Louisiana,Cameron Parish,13,479,243,236
Louisiana,Cameron Parish,14,359,174,185
Louisiana,Cameron Parish,15,317,152,165
Louisiana,Cameron Parish,16,221,110,111
Louisiana,Cameron Parish,17,131,52,79
Louisiana,Cameron Parish,18,121,44,77
Louisiana,Catahoula Parish,0,9608,5078,4530
Louisiana,Catahoula Parish,1,549,258,291
Louisiana,Catahoula Parish,2,567,294,273
Louisiana,Catahoula Parish,3,605,289,316
Louisiana,Catahoula Parish,4,533,302,231
Louisiana,Catahoula Parish,5,583,359,224
Louisiana,Catahoula Parish,6,784,482,302
Louisiana,Catahoula Parish,7,604,382,222
Louisiana,Catahoula Parish,8,678,371,307
Louisiana,Catahoula Parish,9,539,307,232
Louisiana,Catahoula Parish,10,571,314,257
Louisiana,Catahoula Parish,11,559,285,274
Louisiana,Catahoula Parish,12,664,336,328
Louisiana,Catahoula Parish,13,693,338,355
Louisiana,Catahoula Parish,14,568,281,287
Louisiana,Catahoula Parish,15,421,196,225
Louisiana,Catahoula Parish,16,318,144,174
Louisiana,Catahoula Parish,17,208,83,125
Louisiana,Catahoula Parish,18,164,57,107
Louisiana,Claiborne Parish,0,15944,9028,6916
Louisiana,Claiborne Parish,1,852,420,432
Louisiana,Claiborne Parish,2,790,367,423
Louisiana,Claiborne Parish,3,780,411,369
Louisiana,Claiborne Parish,4,745,400,345
Louisiana,Claiborne Parish,5,1014,642,372
Louisiana,Claiborne Parish,6,1341,988,353
Louisiana,Claiborne Parish,7,1136,793,343
Louisiana,Claiborne Parish,8,987,631,356
Louisiana,Claiborne Parish,9,998,659,339
Louisiana,Claiborne Parish,10,1002,581,421
Louisiana,Claiborne Parish,11,1056,601,455
Louisiana,Claiborne Parish,12,1089,597,492
Louisiana,Claiborne Parish,13,1108,561,547
Louisiana,Claiborne Parish,14,922,458,464
Louisiana,Claiborne Parish,15,795,391,404
Louisiana,Claiborne Parish,16,512,230,282
Louisiana,Claiborne Parish,17,420,168,252
Louisiana,Claiborne Parish,18,397,130,267
Louisiana,Concordia Parish,0,19572,9931,9641
Louisiana,Concordia Parish,1,1242,641,601
Louisiana,Concordia Parish,2,1316,685,631
Louisiana,Concordia Parish,3,1327,666,661
Louisiana,Concordia Parish,4,1256,681,575
Louisiana,Concordia Parish,5,1290,757,533
Louisiana,Concordia Parish,6,1407,847,560
Louisiana,Concordia Parish,7,1272,711,561
Louisiana,Concordia Parish,8,1200,629,571
Louisiana,Concordia Parish,9,1057,569,488
Louisiana,Concordia Parish,10,1105,568,537
Louisiana,Concordia Parish,11,1051,487,564
Louisiana,Concordia Parish,12,1316,605,711
Louisiana,Concordia Parish,13,1354,644,710
Louisiana,Concordia Parish,14,1108,488,620
Louisiana,Concordia Parish,15,837,363,474
Louisiana,Concordia Parish,16,597,258,339
Louisiana,Concordia Parish,17,442,184,258
Louisiana,Concordia Parish,18,395,148,247
Louisiana,De Soto Parish,0,27436,13232,14204
Louisiana,De Soto Parish,1,1687,852,835
Louisiana,De Soto Parish,2,1811,940,871
Louisiana,De Soto Parish,3,1970,1038,932
Louisiana,De Soto Parish,4,1710,879,831
Louisiana,De Soto Parish,5,1468,734,734
Louisiana,De Soto Parish,6,1678,811,867
Louisiana,De Soto Parish,7,1664,799,865
Louisiana,De Soto Parish,8,1747,830,917
Louisiana,De Soto Parish,9,1586,741,845
Louisiana,De Soto Parish,10,1691,817,874
Louisiana,De Soto Parish,11,1735,848,887
Louisiana,De Soto Parish,12,1906,914,992
Louisiana,De Soto Parish,13,1885,897,988
Louisiana,De Soto Parish,14,1562,698,864
Louisiana,De Soto Parish,15,1320,602,718
Louisiana,De Soto Parish,16,875,386,489
Louisiana,De Soto Parish,17,606,243,363
Louisiana,De Soto Parish,18,535,203,332
Louisiana,East Baton Rouge Parish,0,440956,210609,230347
Louisiana,East Baton Rouge Parish,1,28827,14405,14422
Louisiana,East Baton Rouge Parish,2,27782,14164,13618
Louisiana,East Baton Rouge Parish,3,26960,13649,13311
Louisiana,East Baton Rouge Parish,4,31019,15236,15783
Louisiana,East Baton Rouge Parish,5,45913,22442,23471
Louisiana,East Baton Rouge Parish,6,34798,17440,17358
Louisiana,East Baton Rouge Parish,7,29614,14682,14932
Louisiana,East Baton Rouge Parish,8,29257,14233,15024
Louisiana,East Baton Rouge Parish,9,23638,11274,12364
Louisiana,East Baton Rouge Parish,10,23711,11151,12560
Louisiana,East Baton Rouge Parish,11,24409,11473,12936
Louisiana,East Baton Rouge Parish,12,26665,12248,14417
Louisiana,East Baton Rouge Parish,13,25835,11713,14122
Louisiana,East Baton Rouge Parish,14,21902,9780,12122
Louisiana,East Baton Rouge Parish,15,16257,7258,8999
Louisiana,East Baton Rouge Parish,16,10397,4414,5983
Louisiana,East Baton Rouge Parish,17,6905,2761,4144
Louisiana,East Baton Rouge Parish,18,7067,2286,4781
Louisiana,East Carroll Parish,0,7037,3811,3226
Louisiana,East Carroll Parish,1,529,262,267
Louisiana,East Carroll Parish,2,482,238,244
Louisiana,East Carroll Parish,3,461,233,228
Louisiana,East Carroll Parish,4,415,215,200
Louisiana,East Carroll Parish,5,516,318,198
Louisiana,East Carroll Parish,6,633,414,219
Louisiana,East Carroll Parish,7,438,292,146
Louisiana,East Carroll Parish,8,425,249,176
Louisiana,East Carroll Parish,9,415,253,162
Louisiana,East Carroll Parish,10,386,221,165
Louisiana,East Carroll Parish,11,405,218,187
Louisiana,East Carroll Parish,12,478,261,217
Louisiana,East Carroll Parish,13,415,208,207
Louisiana,East Carroll Parish,14,342,168,174
Louisiana,East Carroll Parish,15,246,105,141
Louisiana,East Carroll Parish,16,197,70,127
Louisiana,East Carroll Parish,17,136,54,82
Louisiana,East Carroll Parish,18,118,32,86
Louisiana,East Feliciana Parish,0,19305,10486,8819
Louisiana,East Feliciana Parish,1,943,494,449
Louisiana,East Feliciana Parish,2,958,480,478
Louisiana,East Feliciana Parish,3,1011,503,508
Louisiana,East Feliciana Parish,4,1029,571,458
Louisiana,East Feliciana Parish,5,1184,720,464
Louisiana,East Feliciana Parish,6,1282,749,533
Louisiana,East Feliciana Parish,7,1220,741,479
Louisiana,East Feliciana Parish,8,1263,747,516
Louisiana,East Feliciana Parish,9,1186,705,481
Louisiana,East Feliciana Parish,10,1315,782,533
Louisiana,East Feliciana Parish,11,1403,779,624
Louisiana,East Feliciana Parish,12,1571,799,772
Louisiana,East Feliciana Parish,13,1519,769,750
Louisiana,East Feliciana Parish,14,1198,575,623
Louisiana,East Feliciana Parish,15,928,457,471
Louisiana,East Feliciana Parish,16,605,276,329
Louisiana,East Feliciana Parish,17,399,193,206
Louisiana,East Feliciana Parish,18,291,146,145
Louisiana,Evangeline Parish,0,33443,17001,16442
Louisiana,Evangeline Parish,1,2350,1169,1181
Louisiana,Evangeline Parish,2,2330,1180,1150
Louisiana,Evangeline Parish,3,2350,1189,1161
Louisiana,Evangeline Parish,4,2218,1174,1044
Louisiana,Evangeline Parish,5,2282,1355,927
Louisiana,Evangeline Parish,6,2496,1382,1114
Louisiana,Evangeline Parish,7,2109,1145,964
Louisiana,Evangeline Parish,8,2090,1090,1000
Louisiana,Evangeline Parish,9,1820,954,866
Louisiana,Evangeline Parish,10,1943,993,950
Louisiana,Evangeline Parish,11,2080,1018,1062
Louisiana,Evangeline Parish,12,2275,1106,1169
Louisiana,Evangeline Parish,13,1973,956,1017
Louisiana,Evangeline Parish,14,1635,795,840
Louisiana,Evangeline Parish,15,1317,592,725
Louisiana,Evangeline Parish,16,1005,452,553
Louisiana,Evangeline Parish,17,629,262,367
Louisiana,Evangeline Parish,18,541,189,352
Louisiana,Franklin Parish,0,20156,9752,10404
Louisiana,Franklin Parish,1,1446,753,693
Louisiana,Franklin Parish,2,1427,688,739
Louisiana,Franklin Parish,3,1428,732,696
Louisiana,Franklin Parish,4,1290,667,623
Louisiana,Franklin Parish,5,1137,604,533
Louisiana,Franklin Parish,6,1308,662,646
Louisiana,Franklin Parish,7,1175,560,615
Louisiana,Franklin Parish,8,1220,623,597
Louisiana,Franklin Parish,9,1123,549,574
Louisiana,Franklin Parish,10,1076,511,565
Louisiana,Franklin Parish,11,1194,557,637
Louisiana,Franklin Parish,12,1377,648,729
Louisiana,Franklin Parish,13,1350,686,664
Louisiana,Franklin Parish,14,1099,521,578
Louisiana,Franklin Parish,15,876,385,491
Louisiana,Franklin Parish,16,660,281,379
Louisiana,Franklin Parish,17,509,199,310
Louisiana,Franklin Parish,18,461,126,335
Louisiana,Grant Parish,0,22482,12576,9906
Louisiana,Grant Parish,1,1329,671,658
Louisiana,Grant Parish,2,1292,675,617
Louisiana,Grant Parish,3,1356,697,659
Louisiana,Grant Parish,4,1221,670,551
Louisiana,Grant Parish,5,1310,758,552
Louisiana,Grant Parish,6,1881,1228,653
Louisiana,Grant Parish,7,1946,1353,593
Louisiana,Grant Parish,8,1783,1120,663
Louisiana,Grant Parish,9,1470,903,567
Louisiana,Grant Parish,10,1409,815,594
Louisiana,Grant Parish,11,1364,728,636
Louisiana,Grant Parish,12,1451,745,706
Louisiana,Grant Parish,13,1250,599,651
Louisiana,Grant Parish,14,1122,575,547
Louisiana,Grant Parish,15,954,439,515
Louisiana,Grant Parish,16,624,293,331
Louisiana,Grant Parish,17,403,183,220
Louisiana,Grant Parish,18,317,124,193
Louisiana,Iberia Parish,0,70941,34708,36233
Louisiana,Iberia Parish,1,5179,2573,2606
Louisiana,Iberia Parish,2,4972,2563,2409
Louisiana,Iberia Parish,3,5183,2632,2551
Louisiana,Iberia Parish,4,4727,2427,2300
Louisiana,Iberia Parish,5,4359,2198,2161
Louisiana,Iberia Parish,6,4861,2393,2468
Louisiana,Iberia Parish,7,4447,2237,2210
Louisiana,Iberia Parish,8,4317,2134,2183
Louisiana,Iberia Parish,9,3820,1822,1998
Louisiana,Iberia Parish,10,4017,1956,2061
Louisiana,Iberia Parish,11,4600,2170,2430
Louisiana,Iberia Parish,12,5072,2458,2614
Louisiana,Iberia Parish,13,4759,2318,2441
Louisiana,Iberia Parish,14,3493,1711,1782
Louisiana,Iberia Parish,15,2767,1325,1442
Louisiana,Iberia Parish,16,1924,803,1121
Louisiana,Iberia Parish,17,1311,567,744
Louisiana,Iberia Parish,18,1133,421,712
Louisiana,Iberville Parish,0,32721,16553,16168
Louisiana,Iberville Parish,1,1816,914,902
Louisiana,Iberville Parish,2,1902,989,913
Louisiana,Iberville Parish,3,1844,932,912
Louisiana,Iberville Parish,4,1964,1047,917
Louisiana,Iberville Parish,5,1999,1088,911
Louisiana,Iberville Parish,6,2581,1363,1218
Louisiana,Iberville Parish,7,2339,1255,1084
Louisiana,Iberville Parish,8,2279,1194,1085
Louisiana,Iberville Parish,9,1987,987,1000
Louisiana,Iberville Parish,10,2143,1106,1037
Louisiana,Iberville Parish,11,2263,1178,1085
Louisiana,Iberville Parish,12,2350,1217,1133
Louisiana,Iberville Parish,13,2073,999,1074
Louisiana,Iberville Parish,14,1712,825,887
Louisiana,Iberville Parish,15,1358,618,740
Louisiana,Iberville Parish,16,915,402,513
Louisiana,Iberville Parish,17,601,240,361
Louisiana,Iberville Parish,18,595,199,396
Louisiana,Jackson Parish,0,15902,8158,7744
Louisiana,Jackson Parish,1,873,473,400
Louisiana,Jackson Parish,2,991,511,480
Louisiana,Jackson Parish,3,1012,530,482
Louisiana,Jackson Parish,4,909,507,402
Louisiana,Jackson Parish,5,911,493,418
Louisiana,Jackson Parish,6,1067,642,425
Louisiana,Jackson Parish,7,1064,580,484
Louisiana,Jackson Parish,8,948,497,451
Louisiana,Jackson Parish,9,927,475,452
Louisiana,Jackson Parish,10,948,529,419
Louisiana,Jackson Parish,11,988,498,490
Louisiana,Jackson Parish,12,1140,560,580
Louisiana,Jackson Parish,13,958,453,505
Louisiana,Jackson Parish,14,954,459,495
Louisiana,Jackson Parish,15,778,343,435
Louisiana,Jackson Parish,16,623,290,333
Louisiana,Jackson Parish,17,423,186,237
Louisiana,Jackson Parish,18,388,132,256
Louisiana,Jefferson Parish,0,434051,210118,223933
Louisiana,Jefferson Parish,1,28335,14712,13623
Louisiana,Jefferson Parish,2,26024,13225,12799
Louisiana,Jefferson Parish,3,26033,13219,12814
Louisiana,Jefferson Parish,4,23440,12064,11376
Louisiana,Jefferson Parish,5,24269,12108,12161
Louisiana,Jefferson Parish,6,31698,15345,16353
Louisiana,Jefferson Parish,7,31205,15461,15744
Louisiana,Jefferson Parish,8,29046,14275,14771
Louisiana,Jefferson Parish,9,25276,12499,12777
Louisiana,Jefferson Parish,10,25834,12639,13195
Louisiana,Jefferson Parish,11,28284,13615,14669
Louisiana,Jefferson Parish,12,30770,14708,16062
Louisiana,Jefferson Parish,13,29507,14039,15468
Louisiana,Jefferson Parish,14,24751,11491,13260
Louisiana,Jefferson Parish,15,19172,8719,10453
Louisiana,Jefferson Parish,16,12921,5550,7371
Louisiana,Jefferson Parish,17,8268,3380,4888
Louisiana,Jefferson Parish,18,9218,3069,6149
Louisiana,Jefferson Davis Parish,0,31582,15468,16114
Louisiana,Jefferson Davis Parish,1,2194,1137,1057
Louisiana,Jefferson Davis Parish,2,2212,1176,1036
Louisiana,Jefferson Davis Parish,3,2346,1155,1191
Louisiana,Jefferson Davis Parish,4,2083,1114,969
Louisiana,Jefferson Davis Parish,5,1855,953,902
Louisiana,Jefferson Davis Parish,6,2056,1021,1035
Louisiana,Jefferson Davis Parish,7,1931,945,986
Louisiana,Jefferson Davis Parish,8,1970,993,977
Louisiana,Jefferson Davis Parish,9,1739,821,918
Louisiana,Jefferson Davis Parish,10,1835,884,951
Louisiana,Jefferson Davis Parish,11,1940,916,1024
Louisiana,Jefferson Davis Parish,12,2251,1061,1190
Louisiana,Jefferson Davis Parish,13,2011,1001,1010
Louisiana,Jefferson Davis Parish,14,1608,738,870
Louisiana,Jefferson Davis Parish,15,1247,543,704
Louisiana,Jefferson Davis Parish,16,974,444,530
Louisiana,Jefferson Davis Parish,17,701,293,408
Louisiana,Jefferson Davis Parish,18,629,273,356
Louisiana,Lafayette Parish,0,242782,118148,124634
Louisiana,Lafayette Parish,1,16466,8421,8045
Louisiana,Lafayette Parish,2,15985,7989,7996
Louisiana,Lafayette Parish,3,15857,8056,7801
Louisiana,Lafayette Parish,4,15028,7609,7419
Louisiana,Lafayette Parish,5,16043,7855,8188
Louisiana,Lafayette Parish,6,20123,9968,10155
Louisiana,Lafayette Parish,7,19317,9774,9543
Louisiana,Lafayette Parish,8,17943,8927,9016
Louisiana,Lafayette Parish,9,14689,7375,7314
Louisiana,Lafayette Parish,10,14457,7015,7442
Louisiana,Lafayette Parish,11,14330,6857,7473
Louisiana,Lafayette Parish,12,15889,7441,8448
Louisiana,Lafayette Parish,13,14588,6801,7787
Louisiana,Lafayette Parish,14,11474,5378,6096
Louisiana,Lafayette Parish,15,8018,3796,4222
Louisiana,Lafayette Parish,16,5321,2248,3073
Louisiana,Lafayette Parish,17,3594,1436,2158
Louisiana,Lafayette Parish,18,3660,1202,2458
Louisiana,Lafourche Parish,0,98115,48123,49992
Louisiana,Lafourche Parish,1,6281,3208,3073
Louisiana,Lafourche Parish,2,6403,3240,3163
Louisiana,Lafourche Parish,3,6425,3266,3159
Louisiana,Lafourche Parish,4,6140,3051,3089
Louisiana,Lafourche Parish,5,5772,2925,2847
Louisiana,Lafourche Parish,6,7301,3562,3739
Louisiana,Lafourche Parish,7,6669,3417,3252
Louisiana,Lafourche Parish,8,6476,3231,3245
Louisiana,Lafourche Parish,9,5590,2777,2813
Louisiana,Lafourche Parish,10,5815,2850,2965
Louisiana,Lafourche Parish,11,6903,3394,3509
Louisiana,Lafourche Parish,12,7040,3430,3610
Louisiana,Lafourche Parish,13,6132,3060,3072
Louisiana,Lafourche Parish,14,4769,2276,2493
Louisiana,Lafourche Parish,15,3882,1772,2110
Louisiana,Lafourche Parish,16,2862,1270,1592
Louisiana,Lafourche Parish,17,1860,777,1083
Louisiana,Lafourche Parish,18,1795,617,1178
Louisiana,LaSalle Parish,0,14917,7732,7185
Louisiana,LaSalle Parish,1,911,447,464
Louisiana,LaSalle Parish,2,927,482,445
Louisiana,LaSalle Parish,3,993,505,488
Louisiana,LaSalle Parish,4,926,489,437
Louisiana,LaSalle Parish,5,910,524,386
Louisiana,LaSalle Parish,6,1132,681,451
Louisiana,LaSalle Parish,7,985,552,433
Louisiana,LaSalle Parish,8,1063,587,476
Louisiana,LaSalle Parish,9,929,545,384
Louisiana,LaSalle Parish,10,899,487,412
Louisiana,LaSalle Parish,11,868,431,437
Louisiana,LaSalle Parish,12,926,441,485
Louisiana,LaSalle Parish,13,924,443,481
Louisiana,LaSalle Parish,14,806,388,418
Louisiana,LaSalle Parish,15,647,288,359
Louisiana,LaSalle Parish,16,471,218,253
Louisiana,LaSalle Parish,17,320,127,193
Louisiana,LaSalle Parish,18,280,97,183
Louisiana,Lincoln Parish,0,47196,22948,24248
Louisiana,Lincoln Parish,1,2720,1350,1370
Louisiana,Lincoln Parish,2,2592,1335,1257
Louisiana,Lincoln Parish,3,2528,1284,1244
Louisiana,Lincoln Parish,4,4963,2442,2521
Louisiana,Lincoln Parish,5,8513,4328,4185
Louisiana,Lincoln Parish,6,3235,1648,1587
Louisiana,Lincoln Parish,7,2598,1287,1311
Louisiana,Lincoln Parish,8,2631,1272,1359
Louisiana,Lincoln Parish,9,2062,1032,1030
Louisiana,Lincoln Parish,10,2144,1030,1114
Louisiana,Lincoln Parish,11,2151,1012,1139
Louisiana,Lincoln Parish,12,2379,1131,1248
Louisiana,Lincoln Parish,13,2284,1081,1203
Louisiana,Lincoln Parish,14,2018,940,1078
Louisiana,Lincoln Parish,15,1578,703,875
Louisiana,Lincoln Parish,16,1115,478,637
Louisiana,Lincoln Parish,17,803,320,483
Louisiana,Lincoln Parish,18,882,275,607
Louisiana,Livingston Parish,0,139567,68810,70757
Louisiana,Livingston Parish,1,9578,4875,4703
Louisiana,Livingston Parish,2,9721,4837,4884
Louisiana,Livingston Parish,3,10378,5349,5029
Louisiana,Livingston Parish,4,9184,4755,4429
Louisiana,Livingston Parish,5,7786,3958,3828
Louisiana,Livingston Parish,6,10124,5015,5109
Louisiana,Livingston Parish,7,9876,4839,5037
Louisiana,Livingston Parish,8,10395,5051,5344
Louisiana,Livingston Parish,9,9206,4573,4633
Louisiana,Livingston Parish,10,9506,4737,4769
Louisiana,Livingston Parish,11,8801,4413,4388
Louisiana,Livingston Parish,12,8797,4367,4430
Louisiana,Livingston Parish,13,7793,3737,4056
Louisiana,Livingston Parish,14,6412,3037,3375
Louisiana,Livingston Parish,15,5142,2322,2820
Louisiana,Livingston Parish,16,3536,1587,1949
Louisiana,Livingston Parish,17,1837,768,1069
Louisiana,Livingston Parish,18,1495,590,905
Louisiana,Madison Parish,0,11161,5540,5621
Louisiana,Madison Parish,1,766,376,390
Louisiana,Madison Parish,2,745,396,349
Louisiana,Madison Parish,3,718,356,362
Louisiana,Madison Parish,4,640,313,327
Louisiana,Madison Parish,5,769,429,340
Louisiana,Madison Parish,6,1018,573,445
Louisiana,Madison Parish,7,875,496,379
Louisiana,Madison Parish,8,662,304,358
Louisiana,Madison Parish,9,601,253,348
Louisiana,Madison Parish,10,754,372,382
Louisiana,Madison Parish,11,669,326,343
Louisiana,Madison Parish,12,647,297,350
Louisiana,Madison Parish,13,691,321,370
Louisiana,Madison Parish,14,558,256,302
Louisiana,Madison Parish,15,387,197,190
Louisiana,Madison Parish,16,290,128,162
Louisiana,Madison Parish,17,164,68,96
Louisiana,Madison Parish,18,207,79,128
Louisiana,Morehouse Parish,0,25398,12212,13186
Louisiana,Morehouse Parish,1,1756,921,835
Louisiana,Morehouse Parish,2,1678,879,799
Louisiana,Morehouse Parish,3,1685,837,848
Louisiana,Morehouse Parish,4,1566,789,777
Louisiana,Morehouse Parish,5,1418,738,680
Louisiana,Morehouse Parish,6,1710,890,820
Louisiana,Morehouse Parish,7,1414,697,717
Louisiana,Morehouse Parish,8,1498,706,792
Louisiana,Morehouse Parish,9,1412,684,728
Louisiana,Morehouse Parish,10,1459,716,743
Louisiana,Morehouse Parish,11,1554,701,853
Louisiana,Morehouse Parish,12,1656,737,919
Louisiana,Morehouse Parish,13,1829,846,983
Louisiana,Morehouse Parish,14,1608,778,830
Louisiana,Morehouse Parish,15,1205,526,679
Louisiana,Morehouse Parish,16,773,356,417
Louisiana,Morehouse Parish,17,579,206,373
Louisiana,Morehouse Parish,18,598,205,393
Louisiana,Natchitoches Parish,0,38659,18589,20070
Louisiana,Natchitoches Parish,1,2482,1277,1205
Louisiana,Natchitoches Parish,2,2521,1305,1216
Louisiana,Natchitoches Parish,3,2508,1330,1178
Louisiana,Natchitoches Parish,4,3447,1599,1848
Louisiana,Natchitoches Parish,5,4437,2166,2271
Louisiana,Natchitoches Parish,6,2521,1271,1250
Louisiana,Natchitoches Parish,7,1957,943,1014
Louisiana,Natchitoches Parish,8,2128,1035,1093
Louisiana,Natchitoches Parish,9,1874,905,969
Louisiana,Natchitoches Parish,10,1946,917,1029
Louisiana,Natchitoches Parish,11,2085,1017,1068
Louisiana,Natchitoches Parish,12,2170,1007,1163
Louisiana,Natchitoches Parish,13,2168,969,1199
Louisiana,Natchitoches Parish,14,2031,948,1083
Louisiana,Natchitoches Parish,15,1666,768,898
Louisiana,Natchitoches Parish,16,1196,534,662
Louisiana,Natchitoches Parish,17,775,323,452
Louisiana,Natchitoches Parish,18,747,275,472
Louisiana,Orleans Parish,0,391006,185068,205938
Louisiana,Orleans Parish,1,23087,11849,11238
Louisiana,Orleans Parish,2,21420,10774,10646
Louisiana,Orleans Parish,3,21574,10777,10797
Louisiana,Orleans Parish,4,21504,10581,10923
Louisiana,Orleans Parish,5,24177,11623,12554
Louisiana,Orleans Parish,6,34045,15986,18059
Louisiana,Orleans Parish,7,35788,16752,19036
Louisiana,Orleans Parish,8,29945,14324,15621
Louisiana,Orleans Parish,9,23393,11193,12200
Louisiana,Orleans Parish,10,22622,10896,11726
Louisiana,Orleans Parish,11,23975,11361,12614
Louisiana,Orleans Parish,12,25822,12064,13758
Louisiana,Orleans Parish,13,25894,12144,13750
Louisiana,Orleans Parish,14,21313,9711,11602
Louisiana,Orleans Parish,15,14576,6549,8027
Louisiana,Orleans Parish,16,9156,3914,5242
Louisiana,Orleans Parish,17,6091,2366,3725
Louisiana,Orleans Parish,18,6624,2204,4420
Louisiana,Ouachita Parish,0,154475,74050,80425
Louisiana,Ouachita Parish,1,10646,5385,5261
Louisiana,Ouachita Parish,2,10660,5405,5255
Louisiana,Ouachita Parish,3,10611,5391,5220
Louisiana,Ouachita Parish,4,10783,5496,5287
Louisiana,Ouachita Parish,5,10492,5177,5315
Louisiana,Ouachita Parish,6,11789,5755,6034
Louisiana,Ouachita Parish,7,10276,4941,5335
Louisiana,Ouachita Parish,8,9946,4740,5206
Louisiana,Ouachita Parish,9,9079,4399,4680
Louisiana,Ouachita Parish,10,9221,4421,4800
Louisiana,Ouachita Parish,11,9040,4234,4806
Louisiana,Ouachita Parish,12,9847,4746,5101
Louisiana,Ouachita Parish,13,9238,4325,4913
Louisiana,Ouachita Parish,14,7558,3376,4182
Louisiana,Ouachita Parish,15,5730,2546,3184
Louisiana,Ouachita Parish,16,4074,1694,2380
Louisiana,Ouachita Parish,17,2753,1061,1692
Louisiana,Ouachita Parish,18,2732,958,1774
Louisiana,Plaquemines Parish,0,23410,11805,11605
Louisiana,Plaquemines Parish,1,1589,836,753
Louisiana,Plaquemines Parish,2,1682,882,800
Louisiana,Plaquemines Parish,3,1760,913,847
Louisiana,Plaquemines Parish,4,1572,811,761
Louisiana,Plaquemines Parish,5,1466,814,652
Louisiana,Plaquemines Parish,6,1561,786,775
Louisiana,Plaquemines Parish,7,1511,742,769
Louisiana,Plaquemines Parish,8,1618,787,831
Louisiana,Plaquemines Parish,9,1451,736,715
Louisiana,Plaquemines Parish,10,1536,733,803
Louisiana,Plaquemines Parish,11,1580,807,773
Louisiana,Plaquemines Parish,12,1606,837,769
Louisiana,Plaquemines Parish,13,1335,675,660
Louisiana,Plaquemines Parish,14,1060,528,532
Louisiana,Plaquemines Parish,15,782,368,414
Louisiana,Plaquemines Parish,16,576,274,302
Louisiana,Plaquemines Parish,17,392,178,214
Louisiana,Plaquemines Parish,18,333,98,235
Louisiana,Pointe Coupee Parish,0,21940,10543,11397
Louisiana,Pointe Coupee Parish,1,1348,695,653
Louisiana,Pointe Coupee Parish,2,1251,623,628
Louisiana,Pointe Coupee Parish,3,1350,675,675
Louisiana,Pointe Coupee Parish,4,1311,689,622
Louisiana,Pointe Coupee Parish,5,1287,634,653
Louisiana,Pointe Coupee Parish,6,1295,638,657
Louisiana,Pointe Coupee Parish,7,1154,565,589
Louisiana,Pointe Coupee Parish,8,1277,649,628
Louisiana,Pointe Coupee Parish,9,1120,527,593
Louisiana,Pointe Coupee Parish,10,1201,556,645
Louisiana,Pointe Coupee Parish,11,1444,717,727
Louisiana,Pointe Coupee Parish,12,1737,810,927
Louisiana,Pointe Coupee Parish,13,1649,772,877
Louisiana,Pointe Coupee Parish,14,1471,696,775
Louisiana,Pointe Coupee Parish,15,1213,516,697
Louisiana,Pointe Coupee Parish,16,778,352,426
Louisiana,Pointe Coupee Parish,17,545,226,319
Louisiana,Pointe Coupee Parish,18,509,203,306
Louisiana,Rapides Parish,0,130562,63168,67394
Louisiana,Rapides Parish,1,8902,4562,4340
Louisiana,Rapides Parish,2,8756,4487,4269
Louisiana,Rapides Parish,3,9201,4707,4494
Louisiana,Rapides Parish,4,8693,4416,4277
Louisiana,Rapides Parish,5,8043,4127,3916
Louisiana,Rapides Parish,6,8737,4379,4358
Louisiana,Rapides Parish,7,8295,4102,4193
Louisiana,Rapides Parish,8,8328,4011,4317
Louisiana,Rapides Parish,9,7457,3580,3877
Louisiana,Rapides Parish,10,7577,3682,3895
Louisiana,Rapides Parish,11,8242,3846,4396
Louisiana,Rapides Parish,12,8825,4243,4582
Louisiana,Rapides Parish,13,8131,3836,4295
Louisiana,Rapides Parish,14,6826,3091,3735
Louisiana,Rapides Parish,15,5444,2474,2970
Louisiana,Rapides Parish,16,3978,1725,2253
Louisiana,Rapides Parish,17,2604,1051,1553
Louisiana,Rapides Parish,18,2523,849,1674
Louisiana,Red River Parish,0,8477,4078,4399
Louisiana,Red River Parish,1,516,280,236
Louisiana,Red River Parish,2,559,291,268
Louisiana,Red River Parish,3,587,292,295
Louisiana,Red River Parish,4,492,250,242
Louisiana,Red River Parish,5,464,233,231
Louisiana,Red River Parish,6,534,271,263
Louisiana,Red River Parish,7,465,226,239
Louisiana,Red River Parish,8,436,210,226
Louisiana,Red River Parish,9,462,239,223
Louisiana,Red River Parish,10,520,256,264
Louisiana,Red River Parish,11,567,274,293
Louisiana,Red River Parish,12,665,325,340
Louisiana,Red River Parish,13,591,259,332
Louisiana,Red River Parish,14,492,224,268
Louisiana,Red River Parish,15,417,178,239
Louisiana,Red River Parish,16,340,146,194
Louisiana,Red River Parish,17,184,83,101
Louisiana,Red River Parish,18,186,41,145
Louisiana,Richland Parish,0,20192,9852,10340
Louisiana,Richland Parish,1,1233,663,570
Louisiana,Richland Parish,2,1317,705,612
Louisiana,Richland Parish,3,1337,689,648
Louisiana,Richland Parish,4,1326,685,641
Louisiana,Richland Parish,5,1160,625,535
Louisiana,Richland Parish,6,1406,698,708
Louisiana,Richland Parish,7,1263,617,646
Louisiana,Richland Parish,8,1257,584,673
Louisiana,Richland Parish,9,1241,592,649
Louisiana,Richland Parish,10,1106,521,585
Louisiana,Richland Parish,11,1232,598,634
Louisiana,Richland Parish,12,1369,636,733
Louisiana,Richland Parish,13,1401,653,748
Louisiana,Richland Parish,14,1165,548,617
Louisiana,Richland Parish,15,916,463,453
Louisiana,Richland Parish,16,640,283,357
Louisiana,Richland Parish,17,423,159,264
Louisiana,Richland Parish,18,400,133,267
Louisiana,Sabine Parish,0,24032,11862,12170
Louisiana,Sabine Parish,1,1464,761,703
Louisiana,Sabine Parish,2,1557,761,796
Louisiana,Sabine Parish,3,1677,867,810
Louisiana,Sabine Parish,4,1489,788,701
Louisiana,Sabine Parish,5,1188,577,611
Louisiana,Sabine Parish,6,1477,743,734
Louisiana,Sabine Parish,7,1364,688,676
Louisiana,Sabine Parish,8,1374,649,725
Louisiana,Sabine Parish,9,1307,635,672
Louisiana,Sabine Parish,10,1342,634,708
Louisiana,Sabine Parish,11,1551,803,748
Louisiana,Sabine Parish,12,1615,800,815
Louisiana,Sabine Parish,13,1647,801,846
Louisiana,Sabine Parish,14,1584,772,812
Louisiana,Sabine Parish,15,1317,643,674
Louisiana,Sabine Parish,16,943,459,484
Louisiana,Sabine Parish,17,583,295,288
Louisiana,Sabine Parish,18,553,186,367
Louisiana,St. Bernard Parish,0,46721,22896,23825
Louisiana,St. Bernard Parish,1,3308,1651,1657
Louisiana,St. Bernard Parish,2,3698,1895,1803
Louisiana,St. Bernard Parish,3,3541,1877,1664
Louisiana,St. Bernard Parish,4,2881,1473,1408
Louisiana,St. Bernard Parish,5,2568,1286,1282
Louisiana,St. Bernard Parish,6,3838,1823,2015
Louisiana,St. Bernard Parish,7,3875,1811,2064
Louisiana,St. Bernard Parish,8,3476,1681,1795
Louisiana,St. Bernard Parish,9,2854,1345,1509
Louisiana,St. Bernard Parish,10,2631,1286,1345
Louisiana,St. Bernard Parish,11,2837,1422,1415
Louisiana,St. Bernard Parish,12,3092,1523,1569
Louisiana,St. Bernard Parish,13,2782,1366,1416
Louisiana,St. Bernard Parish,14,2006,984,1022
Louisiana,St. Bernard Parish,15,1351,637,714
Louisiana,St. Bernard Parish,16,873,412,461
Louisiana,St. Bernard Parish,17,543,229,314
Louisiana,St. Bernard Parish,18,567,195,372
Louisiana,St. Charles Parish,0,52879,25940,26939
Louisiana,St. Charles Parish,1,3347,1721,1626
Louisiana,St. Charles Parish,2,3522,1779,1743
Louisiana,St. Charles Parish,3,3847,1975,1872
Louisiana,St. Charles Parish,4,3458,1782,1676
Louisiana,St. Charles Parish,5,3176,1581,1595
Louisiana,St. Charles Parish,6,3417,1725,1692
Louisiana,St. Charles Parish,7,3379,1645,1734
Louisiana,St. Charles Parish,8,3574,1733,1841
Louisiana,St. Charles Parish,9,3279,1539,1740
Louisiana,St. Charles Parish,10,3357,1637,1720
Louisiana,St. Charles Parish,11,3806,1817,1989
Louisiana,St. Charles Parish,12,4077,1973,2104
Louisiana,St. Charles Parish,13,3466,1743,1723
Louisiana,St. Charles Parish,14,2674,1286,1388
Louisiana,St. Charles Parish,15,1783,846,937
Louisiana,St. Charles Parish,16,1191,543,648
Louisiana,St. Charles Parish,17,796,312,484
Louisiana,St. Charles Parish,18,730,303,427
Louisiana,St. Helena Parish,0,10262,4947,5315
Louisiana,St. Helena Parish,1,560,290,270
Louisiana,St. Helena Parish,2,617,288,329
Louisiana,St. Helena Parish,3,619,315,304
Louisiana,St. Helena Parish,4,568,294,274
Louisiana,St. Helena Parish,5,590,305,285
Louisiana,St. Helena Parish,6,780,393,387
Louisiana,St. Helena Parish,7,661,310,351
Louisiana,St. Helena Parish,8,607,316,291
Louisiana,St. Helena Parish,9,475,219,256
Louisiana,St. Helena Parish,10,635,290,345
Louisiana,St. Helena Parish,11,649,315,334
Louisiana,St. Helena Parish,12,774,381,393
Louisiana,St. Helena Parish,13,681,323,358
Louisiana,St. Helena Parish,14,689,340,349
Louisiana,St. Helena Parish,15,507,214,293
Louisiana,St. Helena Parish,16,345,139,206
Louisiana,St. Helena Parish,17,294,128,166
Louisiana,St. Helena Parish,18,211,87,124
Louisiana,St. James Parish,0,21037,10161,10876
Louisiana,St. James Parish,1,1223,633,590
Louisiana,St. James Parish,2,1320,653,667
Louisiana,St. James Parish,3,1373,712,661
Louisiana,St. James Parish,4,1281,663,618
Louisiana,St. James Parish,5,1318,662,656
Louisiana,St. James Parish,6,1454,726,728
Louisiana,St. James Parish,7,1335,660,675
Louisiana,St. James Parish,8,1338,630,708
Louisiana,St. James Parish,9,1063,526,537
Louisiana,St. James Parish,10,1153,529,624
Louisiana,St. James Parish,11,1505,706,799
Louisiana,St. James Parish,12,1602,796,806
Louisiana,St. James Parish,13,1462,701,761
Louisiana,St. James Parish,14,1208,575,633
Louisiana,St. James Parish,15,900,390,510
Louisiana,St. James Parish,16,647,277,370
Louisiana,St. James Parish,17,494,184,310
Louisiana,St. James Parish,18,361,138,223
Louisiana,St. John the Baptist Parish,0,43184,21066,22118
Louisiana,St. John the Baptist Parish,1,2767,1420,1347
Louisiana,St. John the Baptist Parish,2,2815,1454,1361
Louisiana,St. John the Baptist Parish,3,3187,1600,1587
Louisiana,St. John the Baptist Parish,4,2935,1470,1465
Louisiana,St. John the Baptist Parish,5,2723,1401,1322
Louisiana,St. John the Baptist Parish,6,2988,1525,1463
Louisiana,St. John the Baptist Parish,7,2765,1368,1397
Louisiana,St. John the Baptist Parish,8,2771,1275,1496
Louisiana,St. John the Baptist Parish,9,2500,1184,1316
Louisiana,St. John the Baptist Parish,10,2595,1187,1408
Louisiana,St. John the Baptist Parish,11,2989,1398,1591
Louisiana,St. John the Baptist Parish,12,3201,1519,1682
Louisiana,St. John the Baptist Parish,13,2804,1405,1399
Louisiana,St. John the Baptist Parish,14,2222,1057,1165
Louisiana,St. John the Baptist Parish,15,1643,794,849
Louisiana,St. John the Baptist Parish,16,1083,493,590
Louisiana,St. John the Baptist Parish,17,624,281,343
Louisiana,St. John the Baptist Parish,18,572,235,337
Louisiana,St. Landry Parish,0,82764,39950,42814
Louisiana,St. Landry Parish,1,6305,3243,3062
Louisiana,St. Landry Parish,2,6145,3118,3027
Louisiana,St. Landry Parish,3,6172,3175,2997
Louisiana,St. Landry Parish,4,5601,2951,2650
Louisiana,St. Landry Parish,5,4795,2363,2432
Louisiana,St. Landry Parish,6,5493,2653,2840
Louisiana,St. Landry Parish,7,4978,2448,2530
Louisiana,St. Landry Parish,8,4976,2323,2653
Louisiana,St. Landry Parish,9,4327,2066,2261
Louisiana,St. Landry Parish,10,4606,2220,2386
Louisiana,St. Landry Parish,11,5018,2375,2643
Louisiana,St. Landry Parish,12,5710,2677,3033
Louisiana,St. Landry Parish,13,5310,2557,2753
Louisiana,St. Landry Parish,14,4462,2082,2380
Louisiana,St. Landry Parish,15,3330,1497,1833
Louisiana,St. Landry Parish,16,2393,1054,1339
Louisiana,St. Landry Parish,17,1644,664,980
Louisiana,St. Landry Parish,18,1499,484,1015
Louisiana,St. Martin Parish,0,53621,26359,27262
Louisiana,St. Martin Parish,1,3610,1762,1848
Louisiana,St. Martin Parish,2,3524,1827,1697
Louisiana,St. Martin Parish,3,3696,1863,1833
Louisiana,St. Martin Parish,4,3315,1738,1577
Louisiana,St. Martin Parish,5,3130,1584,1546
Louisiana,St. Martin Parish,6,3947,2002,1945
Louisiana,St. Martin Parish,7,3557,1811,1746
Louisiana,St. Martin Parish,8,3465,1698,1767
Louisiana,St. Martin Parish,9,3061,1522,1539
Louisiana,St. Martin Parish,10,3176,1539,1637
Louisiana,St. Martin Parish,11,3604,1707,1897
Louisiana,St. Martin Parish,12,3914,1898,2016
Louisiana,St. Martin Parish,13,3565,1711,1854
Louisiana,St. Martin Parish,14,2753,1317,1436
Louisiana,St. Martin Parish,15,2112,1001,1111
Louisiana,St. Martin Parish,16,1485,661,824
Louisiana,St. Martin Parish,17,898,403,495
Louisiana,St. Martin Parish,18,809,315,494
Louisiana,St. Mary Parish,0,49774,24545,25229
Louisiana,St. Mary Parish,1,3404,1769,1635
Louisiana,St. Mary Parish,2,3258,1692,1566
Louisiana,St. Mary Parish,3,3269,1641,1628
Louisiana,St. Mary Parish,4,3029,1525,1504
Louisiana,St. Mary Parish,5,2874,1438,1436
Louisiana,St. Mary Parish,6,3507,1798,1709
Louisiana,St. Mary Parish,7,2935,1485,1450
Louisiana,St. Mary Parish,8,2887,1376,1511
Louisiana,St. Mary Parish,9,2658,1336,1322
Louisiana,St. Mary Parish,10,3029,1513,1516
Louisiana,St. Mary Parish,11,3412,1632,1780
Louisiana,St. Mary Parish,12,3835,1889,1946
Louisiana,St. Mary Parish,13,3435,1708,1727
Louisiana,St. Mary Parish,14,2597,1280,1317
Louisiana,St. Mary Parish,15,2119,976,1143
Louisiana,St. Mary Parish,16,1537,697,840
Louisiana,St. Mary Parish,17,1026,446,580
Louisiana,St. Mary Parish,18,963,344,619
Louisiana,St. Tammany Parish,0,258111,125280,132831
Louisiana,St. Tammany Parish,1,15851,8024,7827
Louisiana,St. Tammany Parish,2,16159,8221,7938
Louisiana,St. Tammany Parish,3,18700,9550,9150
Louisiana,St. Tammany Parish,4,16915,8656,8259
Louisiana,St. Tammany Parish,5,13886,7080,6806
Louisiana,St. Tammany Parish,6,14392,7074,7318
Louisiana,St. Tammany Parish,7,15274,7342,7932
Louisiana,St. Tammany Parish,8,16961,8137,8824
Louisiana,St. Tammany Parish,9,15745,7660,8085
Louisiana,St. Tammany Parish,10,16779,8024,8755
Louisiana,St. Tammany Parish,11,17373,8413,8960
Louisiana,St. Tammany Parish,12,18677,8987,9690
Louisiana,St. Tammany Parish,13,17705,8336,9369
Louisiana,St. Tammany Parish,14,14984,7185,7799
Louisiana,St. Tammany Parish,15,11940,5533,6407
Louisiana,St. Tammany Parish,16,7712,3513,4199
Louisiana,St. Tammany Parish,17,4598,1968,2630
Louisiana,St. Tammany Parish,18,4460,1577,2883
Louisiana,Tangipahoa Parish,0,133777,64790,68987
Louisiana,Tangipahoa Parish,1,9646,4774,4872
Louisiana,Tangipahoa Parish,2,9099,4662,4437
Louisiana,Tangipahoa Parish,3,9006,4597,4409
Louisiana,Tangipahoa Parish,4,9024,4470,4554
Louisiana,Tangipahoa Parish,5,9192,4538,4654
Louisiana,Tangipahoa Parish,6,10659,5114,5545
Louisiana,Tangipahoa Parish,7,9221,4603,4618
Louisiana,Tangipahoa Parish,8,8830,4381,4449
Louisiana,Tangipahoa Parish,9,7674,3750,3924
Louisiana,Tangipahoa Parish,10,7569,3656,3913
Louisiana,Tangipahoa Parish,11,7921,3740,4181
Louisiana,Tangipahoa Parish,12,8416,4052,4364
Louisiana,Tangipahoa Parish,13,8290,3869,4421
Louisiana,Tangipahoa Parish,14,6814,3134,3680
Louisiana,Tangipahoa Parish,15,5231,2511,2720
Louisiana,Tangipahoa Parish,16,3284,1472,1812
Louisiana,Tangipahoa Parish,17,2046,816,1230
Louisiana,Tangipahoa Parish,18,1855,651,1204
Louisiana,Tensas Parish,0,4462,2158,2304
Louisiana,Tensas Parish,1,261,134,127
Louisiana,Tensas Parish,2,297,146,151
Louisiana,Tensas Parish,3,288,158,130
Louisiana,Tensas Parish,4,269,144,125
Louisiana,Tensas Parish,5,228,110,118
Louisiana,Tensas Parish,6,200,110,90
Louisiana,Tensas Parish,7,205,83,122
Louisiana,Tensas Parish,8,215,109,106
Louisiana,Tensas Parish,9,213,99,114
Louisiana,Tensas Parish,10,213,109,104
Louisiana,Tensas Parish,11,266,127,139
Louisiana,Tensas Parish,12,367,172,195
Louisiana,Tensas Parish,13,351,174,177
Louisiana,Tensas Parish,14,369,166,203
Louisiana,Tensas Parish,15,282,133,149
Louisiana,Tensas Parish,16,196,93,103
Louisiana,Tensas Parish,17,112,53,59
Louisiana,Tensas Parish,18,130,38,92
Louisiana,Terrebonne Parish,0,111021,54649,56372
Louisiana,Terrebonne Parish,1,7695,3931,3764
Louisiana,Terrebonne Parish,2,7714,3963,3751
Louisiana,Terrebonne Parish,3,7965,4096,3869
Louisiana,Terrebonne Parish,4,7168,3633,3535
Louisiana,Terrebonne Parish,5,6548,3352,3196
Louisiana,Terrebonne Parish,6,8087,4018,4069
Louisiana,Terrebonne Parish,7,7508,3731,3777
Louisiana,Terrebonne Parish,8,7646,3707,3939
Louisiana,Terrebonne Parish,9,6391,3198,3193
Louisiana,Terrebonne Parish,10,6508,3163,3345
Louisiana,Terrebonne Parish,11,7315,3618,3697
Louisiana,Terrebonne Parish,12,7760,3783,3977
Louisiana,Terrebonne Parish,13,6732,3325,3407
Louisiana,Terrebonne Parish,14,5404,2534,2870
Louisiana,Terrebonne Parish,15,4120,1924,2196
Louisiana,Terrebonne Parish,16,3009,1298,1711
Louisiana,Terrebonne Parish,17,1784,732,1052
Louisiana,Terrebonne Parish,18,1667,643,1024
Louisiana,Union Parish,0,22330,11056,11274
Louisiana,Union Parish,1,1314,678,636
Louisiana,Union Parish,2,1301,666,635
Louisiana,Union Parish,3,1406,712,694
Louisiana,Union Parish,4,1338,701,637
Louisiana,Union Parish,5,1196,599,597
Louisiana,Union Parish,6,1356,690,666
Louisiana,Union Parish,7,1239,613,626
Louisiana,Union Parish,8,1289,621,668
Louisiana,Union Parish,9,1158,615,543
Louisiana,Union Parish,10,1296,629,667
Louisiana,Union Parish,11,1433,719,714
Louisiana,Union Parish,12,1673,803,870
Louisiana,Union Parish,13,1741,842,899
Louisiana,Union Parish,14,1455,719,736
Louisiana,Union Parish,15,1198,607,591
Louisiana,Union Parish,16,849,396,453
Louisiana,Union Parish,17,555,233,322
Louisiana,Union Parish,18,533,213,320
Louisiana,Vermilion Parish,0,59830,28974,30856
Louisiana,Vermilion Parish,1,3929,2013,1916
Louisiana,Vermilion Parish,2,4194,2111,2083
Louisiana,Vermilion Parish,3,4446,2260,2186
Louisiana,Vermilion Parish,4,4081,2093,1988
Louisiana,Vermilion Parish,5,3258,1604,1654
Louisiana,Vermilion Parish,6,3983,1941,2042
Louisiana,Vermilion Parish,7,3714,1760,1954
Louisiana,Vermilion Parish,8,3988,1901,2087
Louisiana,Vermilion Parish,9,3551,1749,1802
Louisiana,Vermilion Parish,10,3533,1689,1844
Louisiana,Vermilion Parish,11,3844,1886,1958
Louisiana,Vermilion Parish,12,4278,2037,2241
Louisiana,Vermilion Parish,13,3919,1905,2014
Louisiana,Vermilion Parish,14,2982,1423,1559
Louisiana,Vermilion Parish,15,2190,1011,1179
Louisiana,Vermilion Parish,16,1616,694,922
Louisiana,Vermilion Parish,17,1175,495,680
Louisiana,Vermilion Parish,18,1149,402,747
Louisiana,Vernon Parish,0,48860,26045,22815
Louisiana,Vernon Parish,1,3975,2001,1974
Louisiana,Vernon Parish,2,3434,1776,1658
Louisiana,Vernon Parish,3,3038,1543,1495
Louisiana,Vernon Parish,4,3068,1715,1353
Louisiana,Vernon Parish,5,5607,3690,1917
Louisiana,Vernon Parish,6,4765,2759,2006
Louisiana,Vernon Parish,7,3706,1985,1721
Louisiana,Vernon Parish,8,3402,1819,1583
Louisiana,Vernon Parish,9,2628,1412,1216
Louisiana,Vernon Parish,10,2478,1284,1194
Louisiana,Vernon Parish,11,2336,1159,1177
Louisiana,Vernon Parish,12,2333,1162,1171
Louisiana,Vernon Parish,13,2131,1069,1062
Louisiana,Vernon Parish,14,1879,868,1011
Louisiana,Vernon Parish,15,1649,750,899
Louisiana,Vernon Parish,16,1127,504,623
Louisiana,Vernon Parish,17,730,304,426
Louisiana,Vernon Parish,18,574,245,329
Louisiana,Washington Parish,0,46582,23027,23555
Louisiana,Washington Parish,1,3115,1577,1538
Louisiana,Washington Parish,2,2977,1512,1465
Louisiana,Washington Parish,3,3178,1671,1507
Louisiana,Washington Parish,4,3029,1583,1446
Louisiana,Washington Parish,5,2662,1376,1286
Louisiana,Washington Parish,6,2964,1476,1488
Louisiana,Washington Parish,7,2772,1424,1348
Louisiana,Washington Parish,8,2902,1469,1433
Louisiana,Washington Parish,9,2701,1339,1362
Louisiana,Washington Parish,10,2711,1360,1351
Louisiana,Washington Parish,11,2748,1421,1327
Louisiana,Washington Parish,12,3240,1554,1686
Louisiana,Washington Parish,13,3228,1536,1692
Louisiana,Washington Parish,14,2718,1272,1446
Louisiana,Washington Parish,15,2254,1071,1183
Louisiana,Washington Parish,16,1524,677,847
Louisiana,Washington Parish,17,975,368,607
Louisiana,Washington Parish,18,884,341,543
Louisiana,Webster Parish,0,38798,18861,19937
Louisiana,Webster Parish,1,2411,1216,1195
Louisiana,Webster Parish,2,2394,1254,1140
Louisiana,Webster Parish,3,2477,1248,1229
Louisiana,Webster Parish,4,2323,1249,1074
Louisiana,Webster Parish,5,2254,1154,1100
Louisiana,Webster Parish,6,2462,1249,1213
Louisiana,Webster Parish,7,2287,1137,1150
Louisiana,Webster Parish,8,2296,1148,1148
Louisiana,Webster Parish,9,2021,958,1063
Louisiana,Webster Parish,10,2332,1140,1192
Louisiana,Webster Parish,11,2481,1240,1241
Louisiana,Webster Parish,12,2790,1331,1459
Louisiana,Webster Parish,13,2604,1263,1341
Louisiana,Webster Parish,14,2308,1080,1228
Louisiana,Webster Parish,15,1927,885,1042
Louisiana,Webster Parish,16,1476,614,862
Louisiana,Webster Parish,17,1018,387,631
Louisiana,Webster Parish,18,937,308,629
Louisiana,West Baton Rouge Parish,0,26427,13047,13380
Louisiana,West Baton Rouge Parish,1,1874,977,897
Louisiana,West Baton Rouge Parish,2,1747,885,862
Louisiana,West Baton Rouge Parish,3,1838,920,918
Louisiana,West Baton Rouge Parish,4,1533,779,754
Louisiana,West Baton Rouge Parish,5,1556,803,753
Louisiana,West Baton Rouge Parish,6,1986,1010,976
Louisiana,West Baton Rouge Parish,7,2117,1082,1035
Louisiana,West Baton Rouge Parish,8,1981,1018,963
Louisiana,West Baton Rouge Parish,9,1418,687,731
Louisiana,West Baton Rouge Parish,10,1518,748,770
Louisiana,West Baton Rouge Parish,11,1746,810,936
Louisiana,West Baton Rouge Parish,12,1821,904,917
Louisiana,West Baton Rouge Parish,13,1685,791,894
Louisiana,West Baton Rouge Parish,14,1268,619,649
Louisiana,West Baton Rouge Parish,15,881,444,437
Louisiana,West Baton Rouge Parish,16,622,251,371
Louisiana,West Baton Rouge Parish,17,447,186,261
Louisiana,West Baton Rouge Parish,18,389,133,256
Louisiana,West Carroll Parish,0,10982,5588,5394
Louisiana,West Carroll Parish,1,623,323,300
Louisiana,West Carroll Parish,2,658,350,308
Louisiana,West Carroll Parish,3,803,432,371
Louisiana,West Carroll Parish,4,711,407,304
Louisiana,West Carroll Parish,5,655,368,287
Louisiana,West Carroll Parish,6,675,359,316
Louisiana,West Carroll Parish,7,621,323,298
Louisiana,West Carroll Parish,8,689,370,319
Louisiana,West Carroll Parish,9,681,355,326
Louisiana,West Carroll Parish,10,615,307,308
Louisiana,West Carroll Parish,11,665,333,332
Louisiana,West Carroll Parish,12,791,385,406
Louisiana,West Carroll Parish,13,705,357,348
Louisiana,West Carroll Parish,14,616,300,316
Louisiana,West Carroll Parish,15,525,241,284
Louisiana,West Carroll Parish,16,434,189,245
Louisiana,West Carroll Parish,17,291,114,177
Louisiana,West Carroll Parish,18,224,75,149
Louisiana,West Feliciana Parish,0,15460,10106,5354
Louisiana,West Feliciana Parish,1,631,311,320
Louisiana,West Feliciana Parish,2,698,323,375
Louisiana,West Feliciana Parish,3,752,403,349
Louisiana,West Feliciana Parish,4,681,353,328
Louisiana,West Feliciana Parish,5,630,377,253
Louisiana,West Feliciana Parish,6,890,623,267
Louisiana,West Feliciana Parish,7,1273,979,294
Louisiana,West Feliciana Parish,8,1407,1097,310
Louisiana,West Feliciana Parish,9,1336,1051,285
Louisiana,West Feliciana Parish,10,1433,1101,332
Louisiana,West Feliciana Parish,11,1287,925,362
Louisiana,West Feliciana Parish,12,1164,800,364
Louisiana,West Feliciana Parish,13,955,564,391
Louisiana,West Feliciana Parish,14,777,450,327
Louisiana,West Feliciana Parish,15,674,346,328
Louisiana,West Feliciana Parish,16,390,197,193
Louisiana,West Feliciana Parish,17,215,94,121
Louisiana,West Feliciana Parish,18,267,112,155
Louisiana,Winn Parish,0,14134,7575,6559
Louisiana,Winn Parish,1,855,436,419
Louisiana,Winn Parish,2,779,397,382
Louisiana,Winn Parish,3,813,405,408
Louisiana,Winn Parish,4,803,414,389
Louisiana,Winn Parish,5,806,445,361
Louisiana,Winn Parish,6,1041,652,389
Louisiana,Winn Parish,7,925,597,328
Louisiana,Winn Parish,8,866,499,367
Louisiana,Winn Parish,9,876,515,361
Louisiana,Winn Parish,10,915,531,384
Louisiana,Winn Parish,11,977,555,422
Louisiana,Winn Parish,12,942,511,431
Louisiana,Winn Parish,13,910,459,451
Louisiana,Winn Parish,14,816,388,428
Louisiana,Winn Parish,15,691,318,373
Louisiana,Winn Parish,16,480,213,267
Louisiana,Winn Parish,17,318,144,174
Louisiana,Winn Parish,18,321,96,225
Maine,Androscoggin County,0,107679,52706,54973
Maine,Androscoggin County,1,6274,3192,3082
Maine,Androscoggin County,2,6749,3418,3331
Maine,Androscoggin County,3,6536,3325,3211
Maine,Androscoggin County,4,6495,3316,3179
Maine,Androscoggin County,5,6272,3162,3110
Maine,Androscoggin County,6,6609,3339,3270
Maine,Androscoggin County,7,6766,3249,3517
Maine,Androscoggin County,8,6724,3244,3480
Maine,Androscoggin County,9,5997,2970,3027
Maine,Androscoggin County,10,6953,3444,3509
Maine,Androscoggin County,11,7687,3774,3913
Maine,Androscoggin County,12,7972,3998,3974
Maine,Androscoggin County,13,7554,3660,3894
Maine,Androscoggin County,14,6213,3006,3207
Maine,Androscoggin County,15,4937,2341,2596
Maine,Androscoggin County,16,3223,1441,1782
Maine,Androscoggin County,17,2286,967,1319
Maine,Androscoggin County,18,2432,860,1572
Maine,Aroostook County,0,67111,33186,33925
Maine,Aroostook County,1,3234,1666,1568
Maine,Aroostook County,2,3245,1653,1592
Maine,Aroostook County,3,3468,1790,1678
Maine,Aroostook County,4,3793,2025,1768
Maine,Aroostook County,5,3524,1838,1686
Maine,Aroostook County,6,3335,1700,1635
Maine,Aroostook County,7,3200,1619,1581
Maine,Aroostook County,8,3414,1686,1728
Maine,Aroostook County,9,3569,1804,1765
Maine,Aroostook County,10,4131,2023,2108
Maine,Aroostook County,11,4818,2394,2424
Maine,Aroostook County,12,5450,2740,2710
Maine,Aroostook County,13,5734,2842,2892
Maine,Aroostook County,14,5116,2536,2580
Maine,Aroostook County,15,4074,2009,2065
Maine,Aroostook County,16,2846,1276,1570
Maine,Aroostook County,17,2051,887,1164
Maine,Aroostook County,18,2109,698,1411
Maine,Cumberland County,0,293557,142464,151093
Maine,Cumberland County,1,14283,7438,6845
Maine,Cumberland County,2,14681,7370,7311
Maine,Cumberland County,3,15922,8132,7790
Maine,Cumberland County,4,17307,8892,8415
Maine,Cumberland County,5,17840,8924,8916
Maine,Cumberland County,6,20100,10041,10059
Maine,Cumberland County,7,20066,10085,9981
Maine,Cumberland County,8,18825,9439,9386
Maine,Cumberland County,9,17268,8525,8743
Maine,Cumberland County,10,19507,9525,9982
Maine,Cumberland County,11,20484,9853,10631
Maine,Cumberland County,12,22100,10524,11576
Maine,Cumberland County,13,21013,9979,11034
Maine,Cumberland County,14,17971,8342,9629
Maine,Cumberland County,15,13927,6585,7342
Maine,Cumberland County,16,9150,4048,5102
Maine,Cumberland County,17,6150,2498,3652
Maine,Cumberland County,18,6963,2264,4699
Maine,Franklin County,0,29897,14676,15221
Maine,Franklin County,1,1247,651,596
Maine,Franklin County,2,1456,747,709
Maine,Franklin County,3,1608,827,781
Maine,Franklin County,4,1921,909,1012
Maine,Franklin County,5,1877,889,988
Maine,Franklin County,6,1626,810,816
Maine,Franklin County,7,1592,801,791
Maine,Franklin County,8,1474,724,750
Maine,Franklin County,9,1539,731,808
Maine,Franklin County,10,1728,874,854
Maine,Franklin County,11,2104,991,1113
Maine,Franklin County,12,2507,1271,1236
Maine,Franklin County,13,2513,1218,1295
Maine,Franklin County,14,2230,1079,1151
Maine,Franklin County,15,1766,888,878
Maine,Franklin County,16,1232,613,619
Maine,Franklin County,17,774,378,396
Maine,Franklin County,18,703,275,428
Maine,Hancock County,0,54811,26549,28262
Maine,Hancock County,1,2391,1218,1173
Maine,Hancock County,2,2518,1271,1247
Maine,Hancock County,3,2784,1418,1366
Maine,Hancock County,4,2727,1432,1295
Maine,Hancock County,5,2546,1304,1242
Maine,Hancock County,6,3022,1545,1477
Maine,Hancock County,7,3046,1441,1605
Maine,Hancock County,8,2856,1422,1434
Maine,Hancock County,9,2846,1386,1460
Maine,Hancock County,10,3418,1652,1766
Maine,Hancock County,11,3724,1805,1919
Maine,Hancock County,12,4554,2149,2405
Maine,Hancock County,13,4890,2355,2535
Maine,Hancock County,14,4533,2126,2407
Maine,Hancock County,15,3652,1775,1877
Maine,Hancock County,16,2344,1104,1240
Maine,Hancock County,17,1417,628,789
Maine,Hancock County,18,1543,518,1025
Maine,Kennebec County,0,122083,59519,62564
Maine,Kennebec County,1,6052,3144,2908
Maine,Kennebec County,2,6474,3287,3187
Maine,Kennebec County,3,6761,3440,3321
Maine,Kennebec County,4,7217,3572,3645
Maine,Kennebec County,5,7145,3605,3540
Maine,Kennebec County,6,7137,3621,3516
Maine,Kennebec County,7,7002,3486,3516
Maine,Kennebec County,8,7172,3501,3671
Maine,Kennebec County,9,6644,3279,3365
Maine,Kennebec County,10,7864,3839,4025
Maine,Kennebec County,11,8806,4287,4519
Maine,Kennebec County,12,9983,4753,5230
Maine,Kennebec County,13,9476,4622,4854
Maine,Kennebec County,14,8213,3934,4279
Maine,Kennebec County,15,6194,2983,3211
Maine,Kennebec County,16,4117,1888,2229
Maine,Kennebec County,17,2835,1187,1648
Maine,Kennebec County,18,2991,1091,1900
Maine,Knox County,0,39771,19617,20154
Maine,Knox County,1,1768,915,853
Maine,Knox County,2,1916,1004,912
Maine,Knox County,3,2116,1100,1016
Maine,Knox County,4,1920,1007,913
Maine,Knox County,5,1918,987,931
Maine,Knox County,6,1997,1084,913
Maine,Knox County,7,2175,1175,1000
Maine,Knox County,8,2146,1085,1061
Maine,Knox County,9,2184,1132,1052
Maine,Knox County,10,2421,1210,1211
Maine,Knox County,11,2604,1307,1297
Maine,Knox County,12,3124,1479,1645
Maine,Knox County,13,3425,1596,1829
Maine,Knox County,14,3285,1507,1778
Maine,Knox County,15,2664,1281,1383
Maine,Knox County,16,1714,785,929
Maine,Knox County,17,1163,510,653
Maine,Knox County,18,1231,453,778
Maine,Lincoln County,0,34342,16852,17490
Maine,Lincoln County,1,1436,736,700
Maine,Lincoln County,2,1544,810,734
Maine,Lincoln County,3,1697,875,822
Maine,Lincoln County,4,1644,922,722
Maine,Lincoln County,5,1618,831,787
Maine,Lincoln County,6,1686,884,802
Maine,Lincoln County,7,1666,845,821
Maine,Lincoln County,8,1657,787,870
Maine,Lincoln County,9,1696,829,867
Maine,Lincoln County,10,2111,1049,1062
Maine,Lincoln County,11,2241,1102,1139
Maine,Lincoln County,12,2849,1384,1465
Maine,Lincoln County,13,2979,1411,1568
Maine,Lincoln County,14,2995,1393,1602
Maine,Lincoln County,15,2615,1265,1350
Maine,Lincoln County,16,1733,827,906
Maine,Lincoln County,17,1083,497,586
Maine,Lincoln County,18,1092,405,687
Maine,Oxford County,0,57618,28505,29113
Maine,Oxford County,1,2613,1326,1287
Maine,Oxford County,2,2783,1425,1358
Maine,Oxford County,3,3161,1617,1544
Maine,Oxford County,4,3225,1726,1499
Maine,Oxford County,5,2653,1368,1285
Maine,Oxford County,6,3030,1541,1489
Maine,Oxford County,7,2997,1470,1527
Maine,Oxford County,8,3300,1604,1696
Maine,Oxford County,9,3224,1620,1604
Maine,Oxford County,10,3678,1748,1930
Maine,Oxford County,11,4247,2083,2164
Maine,Oxford County,12,5189,2603,2586
Maine,Oxford County,13,5035,2443,2592
Maine,Oxford County,14,4324,2172,2152
Maine,Oxford County,15,3159,1581,1578
Maine,Oxford County,16,2200,1051,1149
Maine,Oxford County,17,1413,613,800
Maine,Oxford County,18,1387,514,873
Maine,Penobscot County,0,151096,74754,76342
Maine,Penobscot County,1,7135,3661,3474
Maine,Penobscot County,2,7284,3781,3503
Maine,Penobscot County,3,8025,4174,3851
Maine,Penobscot County,4,10031,5214,4817
Maine,Penobscot County,5,10354,5476,4878
Maine,Penobscot County,6,10499,5397,5102
Maine,Penobscot County,7,9448,4868,4580
Maine,Penobscot County,8,8893,4368,4525
Maine,Penobscot County,9,8276,4044,4232
Maine,Penobscot County,10,9474,4656,4818
Maine,Penobscot County,11,10506,5116,5390
Maine,Penobscot County,12,11850,5824,6026
Maine,Penobscot County,13,11117,5384,5733
Maine,Penobscot County,14,9478,4572,4906
Maine,Penobscot County,15,6986,3301,3685
Maine,Penobscot County,16,4771,2194,2577
Maine,Penobscot County,17,3383,1403,1980
Maine,Penobscot County,18,3586,1321,2265
Maine,Piscataquis County,0,16800,8378,8422
Maine,Piscataquis County,1,741,382,359
Maine,Piscataquis County,2,712,339,373
Maine,Piscataquis County,3,819,406,413
Maine,Piscataquis County,4,863,460,403
Maine,Piscataquis County,5,694,350,344
Maine,Piscataquis County,6,721,365,356
Maine,Piscataquis County,7,732,364,368
Maine,Piscataquis County,8,814,392,422
Maine,Piscataquis County,9,866,408,458
Maine,Piscataquis County,10,1010,511,499
Maine,Piscataquis County,11,1201,586,615
Maine,Piscataquis County,12,1513,752,761
Maine,Piscataquis County,13,1625,794,831
Maine,Piscataquis County,14,1474,750,724
Maine,Piscataquis County,15,1263,670,593
Maine,Piscataquis County,16,776,421,355
Maine,Piscataquis County,17,448,190,258
Maine,Piscataquis County,18,528,238,290
Maine,Sagadahoc County,0,35634,17314,18320
Maine,Sagadahoc County,1,1780,894,886
Maine,Sagadahoc County,2,1839,955,884
Maine,Sagadahoc County,3,1991,1012,979
Maine,Sagadahoc County,4,1830,952,878
Maine,Sagadahoc County,5,1589,787,802
Maine,Sagadahoc County,6,1966,974,992
Maine,Sagadahoc County,7,2123,1043,1080
Maine,Sagadahoc County,8,2085,1034,1051
Maine,Sagadahoc County,9,1960,937,1023
Maine,Sagadahoc County,10,2340,1144,1196
Maine,Sagadahoc County,11,2458,1202,1256
Maine,Sagadahoc County,12,2954,1414,1540
Maine,Sagadahoc County,13,2838,1347,1491
Maine,Sagadahoc County,14,2526,1217,1309
Maine,Sagadahoc County,15,2182,1013,1169
Maine,Sagadahoc County,16,1434,680,754
Maine,Sagadahoc County,17,924,429,495
Maine,Sagadahoc County,18,815,280,535
Maine,Somerset County,0,50592,25163,25429
Maine,Somerset County,1,2361,1247,1114
Maine,Somerset County,2,2483,1269,1214
Maine,Somerset County,3,2870,1491,1379
Maine,Somerset County,4,2911,1436,1475
Maine,Somerset County,5,2517,1319,1198
Maine,Somerset County,6,2794,1464,1330
Maine,Somerset County,7,2700,1348,1352
Maine,Somerset County,8,2770,1318,1452
Maine,Somerset County,9,2920,1450,1470
Maine,Somerset County,10,3444,1706,1738
Maine,Somerset County,11,3881,1911,1970
Maine,Somerset County,12,4243,2105,2138
Maine,Somerset County,13,4168,2071,2097
Maine,Somerset County,14,3559,1769,1790
Maine,Somerset County,15,2822,1432,1390
Maine,Somerset County,16,1944,941,1003
Maine,Somerset County,17,1131,483,648
Maine,Somerset County,18,1074,403,671
Maine,Waldo County,0,39694,19517,20177
Maine,Waldo County,1,1767,933,834
Maine,Waldo County,2,2038,1041,997
Maine,Waldo County,3,2241,1135,1106
Maine,Waldo County,4,2146,1127,1019
Maine,Waldo County,5,1947,993,954
Maine,Waldo County,6,2084,1057,1027
Maine,Waldo County,7,2202,1094,1108
Maine,Waldo County,8,2336,1126,1210
Maine,Waldo County,9,2305,1182,1123
Maine,Waldo County,10,2436,1204,1232
Maine,Waldo County,11,2706,1315,1391
Maine,Waldo County,12,3129,1469,1660
Maine,Waldo County,13,3432,1632,1800
Maine,Waldo County,14,3158,1520,1638
Maine,Waldo County,15,2481,1219,1262
Maine,Waldo County,16,1476,708,768
Maine,Waldo County,17,921,424,497
Maine,Waldo County,18,889,338,551
Maine,Washington County,0,31490,15567,15923
Maine,Washington County,1,1499,809,690
Maine,Washington County,2,1585,811,774
Maine,Washington County,3,1793,892,901
Maine,Washington County,4,1758,906,852
Maine,Washington County,5,1607,830,777
Maine,Washington County,6,1533,793,740
Maine,Washington County,7,1492,749,743
Maine,Washington County,8,1624,802,822
Maine,Washington County,9,1635,792,843
Maine,Washington County,10,1871,952,919
Maine,Washington County,11,2052,1004,1048
Maine,Washington County,12,2595,1262,1333
Maine,Washington County,13,2759,1351,1408
Maine,Washington County,14,2496,1254,1242
Maine,Washington County,15,2067,1039,1028
Maine,Washington County,16,1434,666,768
Maine,Washington County,17,885,376,509
Maine,Washington County,18,805,279,526
Maine,York County,0,206229,100606,105623
Maine,York County,1,9701,4977,4724
Maine,York County,2,10289,5397,4892
Maine,York County,3,11443,5899,5544
Maine,York County,4,11603,5887,5716
Maine,York County,5,10923,5613,5310
Maine,York County,6,12502,6254,6248
Maine,York County,7,12492,6336,6156
Maine,York County,8,12073,5920,6153
Maine,York County,9,11291,5546,5745
Maine,York County,10,13324,6518,6806
Maine,York County,11,14944,7387,7557
Maine,York County,12,17140,8247,8893
Maine,York County,13,16271,7708,8563
Maine,York County,14,14156,6694,7462
Maine,York County,15,10851,5133,5718
Maine,York County,16,7191,3258,3933
Maine,York County,17,4764,2016,2748
Maine,York County,18,5271,1816,3455
Maryland,Allegany County,0,70975,36998,33977
Maryland,Allegany County,1,3208,1660,1548
Maryland,Allegany County,2,3410,1746,1664
Maryland,Allegany County,3,3465,1822,1643
Maryland,Allegany County,4,4869,2490,2379
Maryland,Allegany County,5,6028,3232,2796
Maryland,Allegany County,6,4775,2833,1942
Maryland,Allegany County,7,4404,2703,1701
Maryland,Allegany County,8,4208,2465,1743
Maryland,Allegany County,9,3907,2229,1678
Maryland,Allegany County,10,4395,2365,2030
Maryland,Allegany County,11,4510,2390,2120
Maryland,Allegany County,12,4770,2358,2412
Maryland,Allegany County,13,4626,2351,2275
Maryland,Allegany County,14,4092,1959,2133
Maryland,Allegany County,15,3687,1672,2015
Maryland,Allegany County,16,2758,1252,1506
Maryland,Allegany County,17,1932,798,1134
Maryland,Allegany County,18,1931,673,1258
Maryland,Anne Arundel County,0,576031,285333,290698
Maryland,Anne Arundel County,1,35416,18094,17322
Maryland,Anne Arundel County,2,36164,18386,17778
Maryland,Anne Arundel County,3,35691,18291,17400
Maryland,Anne Arundel County,4,34142,17924,16218
Maryland,Anne Arundel County,5,36788,20486,16302
Maryland,Anne Arundel County,6,39898,20515,19383
Maryland,Anne Arundel County,7,41989,20905,21084
Maryland,Anne Arundel County,8,40843,20479,20364
Maryland,Anne Arundel County,9,35623,17737,17886
Maryland,Anne Arundel County,10,37749,18465,19284
Maryland,Anne Arundel County,11,40573,19635,20938
Maryland,Anne Arundel County,12,41285,19859,21426
Maryland,Anne Arundel County,13,35320,16978,18342
Maryland,Anne Arundel County,14,27612,12845,14767
Maryland,Anne Arundel County,15,22718,10402,12316
Maryland,Anne Arundel County,16,15491,7017,8474
Maryland,Anne Arundel County,17,9116,3862,5254
Maryland,Anne Arundel County,18,9613,3453,6160
Maryland,Baltimore County,0,828431,392710,435721
Maryland,Baltimore County,1,48780,24833,23947
Maryland,Baltimore County,2,49363,25216,24147
Maryland,Baltimore County,3,50734,25680,25054
Maryland,Baltimore County,4,52490,26404,26086
Maryland,Baltimore County,5,50138,24893,25245
Maryland,Baltimore County,6,57159,27954,29205
Maryland,Baltimore County,7,56872,27272,29600
Maryland,Baltimore County,8,53524,25350,28174
Maryland,Baltimore County,9,47684,22502,25182
Maryland,Baltimore County,10,51056,23992,27064
Maryland,Baltimore County,11,54483,25742,28741
Maryland,Baltimore County,12,58482,27533,30949
Maryland,Baltimore County,13,55356,25595,29761
Maryland,Baltimore County,14,45050,20339,24711
Maryland,Baltimore County,15,34359,15258,19101
Maryland,Baltimore County,16,23611,9935,13676
Maryland,Baltimore County,17,16723,6592,10131
Maryland,Baltimore County,18,22567,7620,14947
Maryland,Calvert County,0,92003,45613,46390
Maryland,Calvert County,1,4944,2534,2410
Maryland,Calvert County,2,5733,3000,2733
Maryland,Calvert County,3,6438,3280,3158
Maryland,Calvert County,4,6367,3226,3141
Maryland,Calvert County,5,5451,2892,2559
Maryland,Calvert County,6,5199,2706,2493
Maryland,Calvert County,7,5413,2701,2712
Maryland,Calvert County,8,5919,2923,2996
Maryland,Calvert County,9,5098,2470,2628
Maryland,Calvert County,10,6256,2983,3273
Maryland,Calvert County,11,7562,3761,3801
Maryland,Calvert County,12,7760,3814,3946
Maryland,Calvert County,13,6176,3016,3160
Maryland,Calvert County,14,4498,2223,2275
Maryland,Calvert County,15,3724,1783,1941
Maryland,Calvert County,16,2481,1186,1295
Maryland,Calvert County,17,1406,603,803
Maryland,Calvert County,18,1578,512,1066
Maryland,Caroline County,0,33304,16326,16978
Maryland,Caroline County,1,2013,1034,979
Maryland,Caroline County,2,2183,1119,1064
Maryland,Caroline County,3,2335,1158,1177
Maryland,Caroline County,4,2077,1037,1040
Maryland,Caroline County,5,1799,907,892
Maryland,Caroline County,6,2176,1090,1086
Maryland,Caroline County,7,2097,1064,1033
Maryland,Caroline County,8,1967,965,1002
Maryland,Caroline County,9,1947,929,1018
Maryland,Caroline County,10,2187,1117,1070
Maryland,Caroline County,11,2294,1120,1174
Maryland,Caroline County,12,2520,1220,1300
Maryland,Caroline County,13,2299,1126,1173
Maryland,Caroline County,14,1725,803,922
Maryland,Caroline County,15,1463,709,754
Maryland,Caroline County,16,990,451,539
Maryland,Caroline County,17,618,282,336
Maryland,Caroline County,18,614,195,419
Maryland,Carroll County,0,168429,83295,85134
Maryland,Carroll County,1,9185,4793,4392
Maryland,Carroll County,2,9597,4917,4680
Maryland,Carroll County,3,10630,5402,5228
Maryland,Carroll County,4,11327,5850,5477
Maryland,Carroll County,5,9872,5009,4863
Maryland,Carroll County,6,9545,4996,4549
Maryland,Carroll County,7,10047,5189,4858
Maryland,Carroll County,8,9993,4966,5027
Maryland,Carroll County,9,9193,4574,4619
Maryland,Carroll County,10,11630,5731,5899
Maryland,Carroll County,11,13696,6652,7044
Maryland,Carroll County,12,14019,6977,7042
Maryland,Carroll County,13,11317,5613,5704
Maryland,Carroll County,14,8978,4335,4643
Maryland,Carroll County,15,7419,3455,3964
Maryland,Carroll County,16,5224,2298,2926
Maryland,Carroll County,17,3168,1293,1875
Maryland,Carroll County,18,3589,1245,2344
Maryland,Cecil County,0,102826,51039,51787
Maryland,Cecil County,1,5825,2943,2882
Maryland,Cecil County,2,6284,3271,3013
Maryland,Cecil County,3,6848,3510,3338
Maryland,Cecil County,4,6639,3481,3158
Maryland,Cecil County,5,5837,2983,2854
Maryland,Cecil County,6,6825,3414,3411
Maryland,Cecil County,7,6277,3121,3156
Maryland,Cecil County,8,6121,3034,3087
Maryland,Cecil County,9,5883,2869,3014
Maryland,Cecil County,10,6960,3405,3555
Maryland,Cecil County,11,7886,3899,3987
Maryland,Cecil County,12,8112,4052,4060
Maryland,Cecil County,13,7143,3550,3593
Maryland,Cecil County,14,5663,2699,2964
Maryland,Cecil County,15,4383,2106,2277
Maryland,Cecil County,16,2807,1356,1451
Maryland,Cecil County,17,1739,782,957
Maryland,Cecil County,18,1594,564,1030
Maryland,Charles County,0,161503,77776,83727
Maryland,Charles County,1,9612,4899,4713
Maryland,Charles County,2,10594,5457,5137
Maryland,Charles County,3,11449,5808,5641
Maryland,Charles County,4,10977,5610,5367
Maryland,Charles County,5,10043,5163,4880
Maryland,Charles County,6,10591,5303,5288
Maryland,Charles County,7,10404,4984,5420
Maryland,Charles County,8,10488,4907,5581
Maryland,Charles County,9,10211,4672,5539
Maryland,Charles County,10,12341,5689,6652
Maryland,Charles County,11,13122,6206,6916
Maryland,Charles County,12,12153,5878,6275
Maryland,Charles County,13,9320,4390,4930
Maryland,Charles County,14,6996,3188,3808
Maryland,Charles County,15,5352,2412,2940
Maryland,Charles County,16,3625,1592,2033
Maryland,Charles County,17,2210,928,1282
Maryland,Charles County,18,2015,690,1325
Maryland,Dorchester County,0,31998,15211,16787
Maryland,Dorchester County,1,1748,931,817
Maryland,Dorchester County,2,1832,929,903
Maryland,Dorchester County,3,1983,996,987
Maryland,Dorchester County,4,1732,933,799
Maryland,Dorchester County,5,1595,792,803
Maryland,Dorchester County,6,2083,980,1103
Maryland,Dorchester County,7,1817,831,986
Maryland,Dorchester County,8,1637,741,896
Maryland,Dorchester County,9,1644,741,903
Maryland,Dorchester County,10,1862,854,1008
Maryland,Dorchester County,11,2175,1045,1130
Maryland,Dorchester County,12,2520,1191,1329
Maryland,Dorchester County,13,2459,1148,1311
Maryland,Dorchester County,14,2132,983,1149
Maryland,Dorchester County,15,1833,876,957
Maryland,Dorchester County,16,1287,588,699
Maryland,Dorchester County,17,800,336,464
Maryland,Dorchester County,18,859,316,543
Maryland,Frederick County,0,255648,126126,129522
Maryland,Frederick County,1,15082,7716,7366
Maryland,Frederick County,2,16101,8220,7881
Maryland,Frederick County,3,17347,8899,8448
Maryland,Frederick County,4,17165,8781,8384
Maryland,Frederick County,5,15410,7917,7493
Maryland,Frederick County,6,15597,7972,7625
Maryland,Frederick County,7,16988,8533,8455
Maryland,Frederick County,8,17270,8564,8706
Maryland,Frederick County,9,15923,7860,8063
Maryland,Frederick County,10,18109,8936,9173
Maryland,Frederick County,11,19079,9447,9632
Maryland,Frederick County,12,19001,9350,9651
Maryland,Frederick County,13,15604,7580,8024
Maryland,Frederick County,14,12210,5806,6404
Maryland,Frederick County,15,9574,4519,5055
Maryland,Frederick County,16,6432,2831,3601
Maryland,Frederick County,17,4036,1727,2309
Maryland,Frederick County,18,4720,1468,3252
Maryland,Garrett County,0,29163,14389,14774
Maryland,Garrett County,1,1452,716,736
Maryland,Garrett County,2,1332,672,660
Maryland,Garrett County,3,1587,828,759
Maryland,Garrett County,4,1637,920,717
Maryland,Garrett County,5,1526,777,749
Maryland,Garrett County,6,1805,935,870
Maryland,Garrett County,7,1463,725,738
Maryland,Garrett County,8,1620,801,819
Maryland,Garrett County,9,1582,809,773
Maryland,Garrett County,10,1911,866,1045
Maryland,Garrett County,11,2039,1044,995
Maryland,Garrett County,12,2346,1142,1204
Maryland,Garrett County,13,2339,1131,1208
Maryland,Garrett County,14,2014,990,1024
Maryland,Garrett County,15,1759,856,903
Maryland,Garrett County,16,1226,598,628
Maryland,Garrett County,17,760,341,419
Maryland,Garrett County,18,765,238,527
Maryland,Harford County,0,253956,124388,129568
Maryland,Harford County,1,14330,7350,6980
Maryland,Harford County,2,15230,7759,7471
Maryland,Harford County,3,16440,8485,7955
Maryland,Harford County,4,16215,8618,7597
Maryland,Harford County,5,14960,7643,7317
Maryland,Harford County,6,15495,7892,7603
Maryland,Harford County,7,16172,8063,8109
Maryland,Harford County,8,16368,8018,8350
Maryland,Harford County,9,15034,7320,7714
Maryland,Harford County,10,17047,8194,8853
Maryland,Harford County,11,19030,9257,9773
Maryland,Harford County,12,19620,9548,10072
Maryland,Harford County,13,16887,8127,8760
Maryland,Harford County,14,13567,6408,7159
Maryland,Harford County,15,10930,5021,5909
Maryland,Harford County,16,7504,3313,4191
Maryland,Harford County,17,4573,1898,2675
Maryland,Harford County,18,4554,1474,3080
Maryland,Howard County,0,323196,158137,165059
Maryland,Howard County,1,19181,9900,9281
Maryland,Howard County,2,21742,11043,10699
Maryland,Howard County,3,23399,12040,11359
Maryland,Howard County,4,21805,11211,10594
Maryland,Howard County,5,18442,9551,8891
Maryland,Howard County,6,19125,9752,9373
Maryland,Howard County,7,20137,9655,10482
Maryland,Howard County,8,23597,11231,12366
Maryland,Howard County,9,22238,10680,11558
Maryland,Howard County,10,23169,11083,12086
Maryland,Howard County,11,23527,11401,12126
Maryland,Howard County,12,23086,11243,11843
Maryland,Howard County,13,19119,9298,9821
Maryland,Howard County,14,15091,7142,7949
Maryland,Howard County,15,12188,5580,6608
Maryland,Howard County,16,7943,3523,4420
Maryland,Howard County,17,4812,2072,2740
Maryland,Howard County,18,4595,1732,2863
Maryland,Kent County,0,19383,9242,10141
Maryland,Kent County,1,789,388,401
Maryland,Kent County,2,828,401,427
Maryland,Kent County,3,907,455,452
Maryland,Kent County,4,1373,668,705
Maryland,Kent County,5,1388,650,738
Maryland,Kent County,6,1063,553,510
Maryland,Kent County,7,1012,516,496
Maryland,Kent County,8,899,452,447
Maryland,Kent County,9,801,396,405
Maryland,Kent County,10,925,466,459
Maryland,Kent County,11,1211,584,627
Maryland,Kent County,12,1495,700,795
Maryland,Kent County,13,1515,681,834
Maryland,Kent County,14,1423,653,770
Maryland,Kent County,15,1380,647,733
Maryland,Kent County,16,1026,489,537
Maryland,Kent County,17,630,284,346
Maryland,Kent County,18,718,259,459
Maryland,Montgomery County,0,1052567,508919,543648
Maryland,Montgomery County,1,65806,33516,32290
Maryland,Montgomery County,2,67435,34723,32712
Maryland,Montgomery County,3,69549,35634,33915
Maryland,Montgomery County,4,64202,32797,31405
Maryland,Montgomery County,5,59609,30169,29440
Maryland,Montgomery County,6,63759,31978,31781
Maryland,Montgomery County,7,69968,34208,35760
Maryland,Montgomery County,8,74831,36436,38395
Maryland,Montgomery County,9,69955,33681,36274
Maryland,Montgomery County,10,73111,35044,38067
Maryland,Montgomery County,11,72723,34654,38069
Maryland,Montgomery County,12,72809,34567,38242
Maryland,Montgomery County,13,65294,30906,34388
Maryland,Montgomery County,14,52500,24183,28317
Maryland,Montgomery County,15,40161,18156,22005
Maryland,Montgomery County,16,27871,11997,15874
Maryland,Montgomery County,17,18681,7799,10882
Maryland,Montgomery County,18,24303,8471,15832
Maryland,Prince George's County,0,909308,437746,471562
Maryland,Prince George's County,1,59457,30333,29124
Maryland,Prince George's County,2,56927,28785,28142
Maryland,Prince George's County,3,54416,27679,26737
Maryland,Prince George's County,4,58112,29647,28465
Maryland,Prince George's County,5,60937,30768,30169
Maryland,Prince George's County,6,68526,34789,33737
Maryland,Prince George's County,7,64614,32075,32539
Maryland,Prince George's County,8,64263,31910,32353
Maryland,Prince George's County,9,57736,28363,29373
Maryland,Prince George's County,10,61749,29509,32240
Maryland,Prince George's County,11,63919,29734,34185
Maryland,Prince George's County,12,63955,29645,34310
Maryland,Prince George's County,13,54097,24518,29579
Maryland,Prince George's County,14,44268,19070,25198
Maryland,Prince George's County,15,31714,13519,18195
Maryland,Prince George's County,16,20482,8596,11886
Maryland,Prince George's County,17,12307,4923,7384
Maryland,Prince George's County,18,11829,3883,7946
Maryland,Queen Anne's County,0,50251,24945,25306
Maryland,Queen Anne's County,1,2545,1301,1244
Maryland,Queen Anne's County,2,2956,1547,1409
Maryland,Queen Anne's County,3,3260,1637,1623
Maryland,Queen Anne's County,4,3125,1592,1533
Maryland,Queen Anne's County,5,2601,1387,1214
Maryland,Queen Anne's County,6,2650,1332,1318
Maryland,Queen Anne's County,7,2632,1341,1291
Maryland,Queen Anne's County,8,2786,1336,1450
Maryland,Queen Anne's County,9,2672,1302,1370
Maryland,Queen Anne's County,10,3431,1686,1745
Maryland,Queen Anne's County,11,4227,2104,2123
Maryland,Queen Anne's County,12,4211,2120,2091
Maryland,Queen Anne's County,13,3693,1813,1880
Maryland,Queen Anne's County,14,2914,1439,1475
Maryland,Queen Anne's County,15,2705,1254,1451
Maryland,Queen Anne's County,16,1889,905,984
Maryland,Queen Anne's County,17,966,442,524
Maryland,Queen Anne's County,18,988,407,581
Maryland,St. Mary's County,0,112664,56159,56505
Maryland,St. Mary's County,1,7162,3663,3499
Maryland,St. Mary's County,2,7554,3827,3727
Maryland,St. Mary's County,3,7857,3953,3904
Maryland,St. Mary's County,4,7743,3868,3875
Maryland,St. Mary's County,5,7297,3717,3580
Maryland,St. Mary's County,6,7964,4109,3855
Maryland,St. Mary's County,7,7923,3986,3937
Maryland,St. Mary's County,8,7381,3701,3680
Maryland,St. Mary's County,9,6627,3309,3318
Maryland,St. Mary's County,10,7361,3599,3762
Maryland,St. Mary's County,11,8378,4133,4245
Maryland,St. Mary's County,12,8231,4193,4038
Maryland,St. Mary's County,13,6456,3242,3214
Maryland,St. Mary's County,14,4894,2305,2589
Maryland,St. Mary's County,15,3844,1843,2001
Maryland,St. Mary's County,16,2675,1266,1409
Maryland,St. Mary's County,17,1692,766,926
Maryland,St. Mary's County,18,1625,679,946
Maryland,Somerset County,0,25675,13878,11797
Maryland,Somerset County,1,1248,653,595
Maryland,Somerset County,2,1265,643,622
Maryland,Somerset County,3,1155,588,567
Maryland,Somerset County,4,1999,987,1012
Maryland,Somerset County,5,3019,1699,1320
Maryland,Somerset County,6,1879,1173,706
Maryland,Somerset County,7,1544,981,563
Maryland,Somerset County,8,1478,898,580
Maryland,Somerset County,9,1420,865,555
Maryland,Somerset County,10,1429,844,585
Maryland,Somerset County,11,1515,818,697
Maryland,Somerset County,12,1737,899,838
Maryland,Somerset County,13,1635,808,827
Maryland,Somerset County,14,1475,737,738
Maryland,Somerset County,15,1050,524,526
Maryland,Somerset County,16,761,362,399
Maryland,Somerset County,17,541,232,309
Maryland,Somerset County,18,525,167,358
Maryland,Talbot County,0,36968,17461,19507
Maryland,Talbot County,1,1714,871,843
Maryland,Talbot County,2,1858,938,920
Maryland,Talbot County,3,1964,990,974
Maryland,Talbot County,4,1817,949,868
Maryland,Talbot County,5,1577,778,799
Maryland,Talbot County,6,1886,946,940
Maryland,Talbot County,7,1768,849,919
Maryland,Talbot County,8,1826,907,919
Maryland,Talbot County,9,1618,759,859
Maryland,Talbot County,10,2054,984,1070
Maryland,Talbot County,11,2397,1088,1309
Maryland,Talbot County,12,2761,1308,1453
Maryland,Talbot County,13,2924,1299,1625
Maryland,Talbot County,14,2866,1253,1613
Maryland,Talbot County,15,2761,1270,1491
Maryland,Talbot County,16,2242,1025,1217
Maryland,Talbot County,17,1399,649,750
Maryland,Talbot County,18,1536,598,938
Maryland,Washington County,0,150926,76833,74093
Maryland,Washington County,1,8584,4368,4216
Maryland,Washington County,2,9032,4615,4417
Maryland,Washington County,3,9478,4862,4616
Maryland,Washington County,4,9216,4811,4405
Maryland,Washington County,5,8871,4996,3875
Maryland,Washington County,6,10184,5601,4583
Maryland,Washington County,7,9611,5117,4494
Maryland,Washington County,8,9374,4975,4399
Maryland,Washington County,9,8895,4796,4099
Maryland,Washington County,10,10602,5611,4991
Maryland,Washington County,11,10775,5454,5321
Maryland,Washington County,12,10660,5343,5317
Maryland,Washington County,13,9638,4771,4867
Maryland,Washington County,14,8116,3883,4233
Maryland,Washington County,15,6402,2980,3422
Maryland,Washington County,16,4662,2046,2616
Maryland,Washington County,17,3210,1298,1912
Maryland,Washington County,18,3616,1306,2310
Maryland,Wicomico County,0,103195,48895,54300
Maryland,Wicomico County,1,6255,3109,3146
Maryland,Wicomico County,2,6176,3187,2989
Maryland,Wicomico County,3,6362,3206,3156
Maryland,Wicomico County,4,9221,4405,4816
Maryland,Wicomico County,5,10033,4688,5345
Maryland,Wicomico County,6,6812,3248,3564
Maryland,Wicomico County,7,5614,2761,2853
Maryland,Wicomico County,8,5920,2829,3091
Maryland,Wicomico County,9,5364,2552,2812
Maryland,Wicomico County,10,5785,2786,2999
Maryland,Wicomico County,11,6155,2905,3250
Maryland,Wicomico County,12,6602,3051,3551
Maryland,Wicomico County,13,6498,3028,3470
Maryland,Wicomico County,14,5285,2485,2800
Maryland,Wicomico County,15,4333,1941,2392
Maryland,Wicomico County,16,2979,1319,1660
Maryland,Wicomico County,17,1813,702,1111
Maryland,Wicomico County,18,1988,693,1295
Maryland,Worcester County,0,51823,25127,26696
Maryland,Worcester County,1,2176,1115,1061
Maryland,Worcester County,2,2469,1248,1221
Maryland,Worcester County,3,2623,1346,1277
Maryland,Worcester County,4,2545,1298,1247
Maryland,Worcester County,5,2544,1297,1247
Maryland,Worcester County,6,2769,1402,1367
Maryland,Worcester County,7,2598,1279,1319
Maryland,Worcester County,8,2419,1216,1203
Maryland,Worcester County,9,2400,1161,1239
Maryland,Worcester County,10,2974,1473,1501
Maryland,Worcester County,11,3529,1676,1853
Maryland,Worcester County,12,4170,2009,2161
Maryland,Worcester County,13,4186,1979,2207
Maryland,Worcester County,14,4229,1999,2230
Maryland,Worcester County,15,3879,1822,2057
Maryland,Worcester County,16,2756,1304,1452
Maryland,Worcester County,17,1938,908,1030
Maryland,Worcester County,18,1619,595,1024
Maryland,Baltimore city,0,602495,282375,320120
Maryland,Baltimore city,1,37992,19458,18534
Maryland,Baltimore city,2,34379,17277,17102
Maryland,Baltimore city,3,32589,16523,16066
Maryland,Baltimore city,4,34709,16896,17813
Maryland,Baltimore city,5,40785,19499,21286
Maryland,Baltimore city,6,60669,29044,31625
Maryland,Baltimore city,7,54814,26271,28543
Maryland,Baltimore city,8,42670,20092,22578
Maryland,Baltimore city,9,32944,15642,17302
Maryland,Baltimore city,10,33248,15713,17535
Maryland,Baltimore city,11,36781,17411,19370
Maryland,Baltimore city,12,40008,18275,21733
Maryland,Baltimore city,13,36520,16227,20293
Maryland,Baltimore city,14,29680,12928,16752
Maryland,Baltimore city,15,20556,8646,11910
Maryland,Baltimore city,16,14128,5662,8466
Maryland,Baltimore city,17,9361,3463,5898
Maryland,Baltimore city,18,10662,3348,7314
Massachusetts,Barnstable County,0,213413,102092,111321
Massachusetts,Barnstable County,1,7852,4030,3822
Massachusetts,Barnstable County,2,8426,4293,4133
Massachusetts,Barnstable County,3,9599,4837,4762
Massachusetts,Barnstable County,4,10302,5519,4783
Massachusetts,Barnstable County,5,10880,5986,4894
Massachusetts,Barnstable County,6,9918,5152,4766
Massachusetts,Barnstable County,7,9170,4585,4585
Massachusetts,Barnstable County,8,9639,4930,4709
Massachusetts,Barnstable County,9,8951,4346,4605
Massachusetts,Barnstable County,10,11443,5426,6017
Massachusetts,Barnstable County,11,14367,6741,7626
Massachusetts,Barnstable County,12,18134,8524,9610
Massachusetts,Barnstable County,13,19433,8857,10576
Massachusetts,Barnstable County,14,19676,9028,10648
Massachusetts,Barnstable County,15,17400,8062,9338
Massachusetts,Barnstable County,16,11906,5306,6600
Massachusetts,Barnstable County,17,7677,3335,4342
Massachusetts,Barnstable County,18,8640,3135,5505
Massachusetts,Berkshire County,0,126348,61187,65161
Massachusetts,Berkshire County,1,5292,2727,2565
Massachusetts,Berkshire County,2,5603,2892,2711
Massachusetts,Berkshire County,3,6273,3131,3142
Massachusetts,Berkshire County,4,7752,3858,3894
Massachusetts,Berkshire County,5,8424,4239,4185
Massachusetts,Berkshire County,6,6846,3524,3322
Massachusetts,Berkshire County,7,6728,3407,3321
Massachusetts,Berkshire County,8,6852,3389,3463
Massachusetts,Berkshire County,9,6245,3117,3128
Massachusetts,Berkshire County,10,7483,3611,3872
Massachusetts,Berkshire County,11,8936,4360,4576
Massachusetts,Berkshire County,12,10347,5008,5339
Massachusetts,Berkshire County,13,10169,4777,5392
Massachusetts,Berkshire County,14,9178,4361,4817
Massachusetts,Berkshire County,15,7415,3538,3877
Massachusetts,Berkshire County,16,5090,2260,2830
Massachusetts,Berkshire County,17,3432,1514,1918
Massachusetts,Berkshire County,18,4283,1474,2809
Massachusetts,Bristol County,0,564022,273143,290879
Massachusetts,Bristol County,1,29376,14892,14484
Massachusetts,Bristol County,2,31768,16172,15596
Massachusetts,Bristol County,3,33980,17283,16697
Massachusetts,Bristol County,4,35564,18060,17504
Massachusetts,Bristol County,5,36761,18602,18159
Massachusetts,Bristol County,6,37127,18620,18507
Massachusetts,Bristol County,7,36001,17711,18290
Massachusetts,Bristol County,8,34901,17110,17791
Massachusetts,Bristol County,9,33504,16335,17169
Massachusetts,Bristol County,10,38461,18582,19879
Massachusetts,Bristol County,11,41833,20528,21305
Massachusetts,Bristol County,12,41951,20195,21756
Massachusetts,Bristol County,13,37331,17967,19364
Massachusetts,Bristol County,14,30227,14153,16074
Massachusetts,Bristol County,15,24407,11133,13274
Massachusetts,Bristol County,16,16112,6989,9123
Massachusetts,Bristol County,17,11021,4486,6535
Massachusetts,Bristol County,18,13697,4325,9372
Massachusetts,Dukes County,0,17352,8557,8795
Massachusetts,Dukes County,1,816,403,413
Massachusetts,Dukes County,2,848,437,411
Massachusetts,Dukes County,3,860,454,406
Massachusetts,Dukes County,4,807,415,392
Massachusetts,Dukes County,5,835,429,406
Massachusetts,Dukes County,6,875,462,413
Massachusetts,Dukes County,7,989,501,488
Massachusetts,Dukes County,8,982,495,487
Massachusetts,Dukes County,9,965,500,465
Massachusetts,Dukes County,10,1072,542,530
Massachusetts,Dukes County,11,1234,606,628
Massachusetts,Dukes County,12,1422,703,719
Massachusetts,Dukes County,13,1428,684,744
Massachusetts,Dukes County,14,1490,674,816
Massachusetts,Dukes County,15,1210,585,625
Massachusetts,Dukes County,16,720,342,378
Massachusetts,Dukes County,17,371,167,204
Massachusetts,Dukes County,18,428,158,270
Massachusetts,Essex County,0,790638,381264,409374
Massachusetts,Essex County,1,44361,22713,21648
Massachusetts,Essex County,2,45664,23454,22210
Massachusetts,Essex County,3,47846,24412,23434
Massachusetts,Essex County,4,52006,26420,25586
Massachusetts,Essex County,5,51386,25982,25404
Massachusetts,Essex County,6,49493,25029,24464
Massachusetts,Essex County,7,48996,24174,24822
Massachusetts,Essex County,8,48873,23638,25235
Massachusetts,Essex County,9,45450,21942,23508
Massachusetts,Essex County,10,51660,24550,27110
Massachusetts,Essex County,11,57113,27171,29942
Massachusetts,Essex County,12,59372,28418,30954
Massachusetts,Essex County,13,53622,25400,28222
Massachusetts,Essex County,14,43810,20395,23415
Massachusetts,Essex County,15,33837,15362,18475
Massachusetts,Essex County,16,22444,9731,12713
Massachusetts,Essex County,17,15496,6210,9286
Massachusetts,Essex County,18,19209,6263,12946
Massachusetts,Franklin County,0,70963,34435,36528
Massachusetts,Franklin County,1,3108,1575,1533
Massachusetts,Franklin County,2,3389,1714,1675
Massachusetts,Franklin County,3,3601,1845,1756
Massachusetts,Franklin County,4,3568,1865,1703
Massachusetts,Franklin County,5,3662,1827,1835
Massachusetts,Franklin County,6,4170,2103,2067
Massachusetts,Franklin County,7,4321,2209,2112
Massachusetts,Franklin County,8,4341,2181,2160
Massachusetts,Franklin County,9,3942,1917,2025
Massachusetts,Franklin County,10,4451,2143,2308
Massachusetts,Franklin County,11,4770,2289,2481
Massachusetts,Franklin County,12,5832,2780,3052
Massachusetts,Franklin County,13,6184,2932,3252
Massachusetts,Franklin County,14,5759,2701,3058
Massachusetts,Franklin County,15,4169,2007,2162
Massachusetts,Franklin County,16,2405,1134,1271
Massachusetts,Franklin County,17,1473,607,866
Massachusetts,Franklin County,18,1818,606,1212
Massachusetts,Hampden County,0,470406,227388,243018
Massachusetts,Hampden County,1,25624,13294,12330
Massachusetts,Hampden County,2,27638,14186,13452
Massachusetts,Hampden County,3,29386,15162,14224
Massachusetts,Hampden County,4,32908,16817,16091
Massachusetts,Hampden County,5,34438,17465,16973
Massachusetts,Hampden County,6,32674,16728,15946
Massachusetts,Hampden County,7,30374,14962,15412
Massachusetts,Hampden County,8,28169,13426,14743
Massachusetts,Hampden County,9,25887,12074,13813
Massachusetts,Hampden County,10,28867,13594,15273
Massachusetts,Hampden County,11,31122,14866,16256
Massachusetts,Hampden County,12,33231,15923,17308
Massachusetts,Hampden County,13,31039,14948,16091
Massachusetts,Hampden County,14,25298,11777,13521
Massachusetts,Hampden County,15,19691,9006,10685
Massachusetts,Hampden County,16,13355,5776,7579
Massachusetts,Hampden County,17,9084,3651,5433
Massachusetts,Hampden County,18,11621,3733,7888
Massachusetts,Hampshire County,0,161355,75345,86010
Massachusetts,Hampshire County,1,5450,2856,2594
Massachusetts,Hampshire County,2,6302,3199,3103
Massachusetts,Hampshire County,3,7066,3598,3468
Massachusetts,Hampshire County,4,17824,7695,10129
Massachusetts,Hampshire County,5,24495,11085,13410
Massachusetts,Hampshire County,6,8924,4439,4485
Massachusetts,Hampshire County,7,8151,4075,4076
Massachusetts,Hampshire County,8,8163,3889,4274
Massachusetts,Hampshire County,9,7486,3555,3931
Massachusetts,Hampshire County,10,8600,4112,4488
Massachusetts,Hampshire County,11,9730,4655,5075
Massachusetts,Hampshire County,12,10777,5043,5734
Massachusetts,Hampshire County,13,10579,4881,5698
Massachusetts,Hampshire County,14,9616,4437,5179
Massachusetts,Hampshire County,15,7263,3417,3846
Massachusetts,Hampshire County,16,4457,2008,2449
Massachusetts,Hampshire County,17,2879,1181,1698
Massachusetts,Hampshire County,18,3593,1220,2373
Massachusetts,Middlesex County,0,1614714,790488,824226
Massachusetts,Middlesex County,1,85768,43807,41961
Massachusetts,Middlesex County,2,87446,44610,42836
Massachusetts,Middlesex County,3,89258,45488,43770
Massachusetts,Middlesex County,4,103339,52642,50697
Massachusetts,Middlesex County,5,113633,57287,56346
Massachusetts,Middlesex County,6,126294,64467,61827
Massachusetts,Middlesex County,7,124898,62922,61976
Massachusetts,Middlesex County,8,111856,55999,55857
Massachusetts,Middlesex County,9,100171,49296,50875
Massachusetts,Middlesex County,10,105915,51842,54073
Massachusetts,Middlesex County,11,110678,53978,56700
Massachusetts,Middlesex County,12,110979,54372,56607
Massachusetts,Middlesex County,13,98091,47032,51059
Massachusetts,Middlesex County,14,78734,36681,42053
Massachusetts,Middlesex County,15,60843,27637,33206
Massachusetts,Middlesex County,16,41868,18047,23821
Massachusetts,Middlesex County,17,29444,12095,17349
Massachusetts,Middlesex County,18,35499,12286,23213
Massachusetts,Nantucket County,0,11327,5769,5558
Massachusetts,Nantucket County,1,728,370,358
Massachusetts,Nantucket County,2,663,345,318
Massachusetts,Nantucket County,3,670,298,372
Massachusetts,Nantucket County,4,510,261,249
Massachusetts,Nantucket County,5,596,290,306
Massachusetts,Nantucket County,6,737,365,372
Massachusetts,Nantucket County,7,869,450,419
Massachusetts,Nantucket County,8,871,469,402
Massachusetts,Nantucket County,9,830,489,341
Massachusetts,Nantucket County,10,877,477,400
Massachusetts,Nantucket County,11,800,419,381
Massachusetts,Nantucket County,12,785,396,389
Massachusetts,Nantucket County,13,711,334,377
Massachusetts,Nantucket County,14,604,296,308
Massachusetts,Nantucket County,15,407,205,202
Massachusetts,Nantucket County,16,262,120,142
Massachusetts,Nantucket County,17,188,98,90
Massachusetts,Nantucket County,18,219,87,132
Massachusetts,Norfolk County,0,705388,339234,366154
Massachusetts,Norfolk County,1,37729,19183,18546
Massachusetts,Norfolk County,2,39563,20224,19339
Massachusetts,Norfolk County,3,42875,21640,21235
Massachusetts,Norfolk County,4,45549,23019,22530
Massachusetts,Norfolk County,5,43826,21322,22504
Massachusetts,Norfolk County,6,44486,21995,22491
Massachusetts,Norfolk County,7,46310,22675,23635
Massachusetts,Norfolk County,8,45590,22335,23255
Massachusetts,Norfolk County,9,43215,21120,22095
Massachusetts,Norfolk County,10,47639,23026,24613
Massachusetts,Norfolk County,11,51369,24808,26561
Massachusetts,Norfolk County,12,52259,25297,26962
Massachusetts,Norfolk County,13,46096,21947,24149
Massachusetts,Norfolk County,14,37201,17321,19880
Massachusetts,Norfolk County,15,28815,12931,15884
Massachusetts,Norfolk County,16,20108,8520,11588
Massachusetts,Norfolk County,17,14532,5832,8700
Massachusetts,Norfolk County,18,18226,6039,12187
Massachusetts,Plymouth County,0,518132,251872,266260
Massachusetts,Plymouth County,1,27491,14031,13460
Massachusetts,Plymouth County,2,29244,15020,14224
Massachusetts,Plymouth County,3,32733,16905,15828
Massachusetts,Plymouth County,4,34202,17322,16880
Massachusetts,Plymouth County,5,31435,15778,15657
Massachusetts,Plymouth County,6,28323,14569,13754
Massachusetts,Plymouth County,7,28729,14087,14642
Massachusetts,Plymouth County,8,29778,14672,15106
Massachusetts,Plymouth County,9,29484,14499,14985
Massachusetts,Plymouth County,10,35920,17318,18602
Massachusetts,Plymouth County,11,39812,19255,20557
Massachusetts,Plymouth County,12,40436,19658,20778
Massachusetts,Plymouth County,13,36681,17405,19276
Massachusetts,Plymouth County,14,30659,14351,16308
Massachusetts,Plymouth County,15,25046,11439,13607
Massachusetts,Plymouth County,16,16586,7489,9097
Massachusetts,Plymouth County,17,10166,4265,5901
Massachusetts,Plymouth County,18,11407,3809,7598
Massachusetts,Suffolk County,0,807252,390083,417169
Massachusetts,Suffolk County,1,41899,21220,20679
Massachusetts,Suffolk County,2,36103,18315,17788
Massachusetts,Suffolk County,3,34443,17413,17030
Massachusetts,Suffolk County,4,54683,26236,28447
Massachusetts,Suffolk County,5,77219,36943,40276
Massachusetts,Suffolk County,6,103854,51199,52655
Massachusetts,Suffolk County,7,85281,42589,42692
Massachusetts,Suffolk County,8,58775,29560,29215
Massachusetts,Suffolk County,9,45400,22546,22854
Massachusetts,Suffolk County,10,44489,21794,22695
Massachusetts,Suffolk County,11,44519,21720,22799
Massachusetts,Suffolk County,12,44078,21292,22786
Massachusetts,Suffolk County,13,39858,18580,21278
Massachusetts,Suffolk County,14,31964,14659,17305
Massachusetts,Suffolk County,15,23585,10163,13422
Massachusetts,Suffolk County,16,16217,6867,9350
Massachusetts,Suffolk County,17,11537,4567,6970
Massachusetts,Suffolk County,18,13348,4420,8928
Massachusetts,Worcester County,0,830839,409671,421168
Massachusetts,Worcester County,1,44667,23028,21639
Massachusetts,Worcester County,2,47353,24260,23093
Massachusetts,Worcester County,3,50552,25897,24655
Massachusetts,Worcester County,4,56392,28637,27755
Massachusetts,Worcester County,5,56477,28553,27924
Massachusetts,Worcester County,6,54139,27924,26215
Massachusetts,Worcester County,7,54236,27154,27082
Massachusetts,Worcester County,8,51291,25663,25628
Massachusetts,Worcester County,9,49041,24062,24979
Massachusetts,Worcester County,10,56916,28044,28872
Massachusetts,Worcester County,11,61455,30350,31105
Massachusetts,Worcester County,12,62871,31070,31801
Massachusetts,Worcester County,13,55471,27269,28202
Massachusetts,Worcester County,14,43034,20769,22265
Massachusetts,Worcester County,15,32491,15283,17208
Massachusetts,Worcester County,16,21807,9683,12124
Massachusetts,Worcester County,17,14782,6072,8710
Massachusetts,Worcester County,18,17864,5953,11911
Michigan,Alcona County,0,10362,5224,5138
Michigan,Alcona County,1,314,157,157
Michigan,Alcona County,2,356,166,190
Michigan,Alcona County,3,378,186,192
Michigan,Alcona County,4,392,220,172
Michigan,Alcona County,5,378,204,174
Michigan,Alcona County,6,390,222,168
Michigan,Alcona County,7,326,156,170
Michigan,Alcona County,8,404,199,205
Michigan,Alcona County,9,386,197,189
Michigan,Alcona County,10,515,252,263
Michigan,Alcona County,11,710,362,348
Michigan,Alcona County,12,925,444,481
Michigan,Alcona County,13,1175,597,578
Michigan,Alcona County,14,1068,542,526
Michigan,Alcona County,15,957,490,467
Michigan,Alcona County,16,857,453,404
Michigan,Alcona County,17,470,231,239
Michigan,Alcona County,18,361,146,215
Michigan,Alger County,0,9097,5033,4064
Michigan,Alger County,1,333,171,162
Michigan,Alger County,2,354,173,181
Michigan,Alger County,3,394,196,198
Michigan,Alger County,4,449,232,217
Michigan,Alger County,5,483,347,136
Michigan,Alger County,6,505,347,158
Michigan,Alger County,7,513,346,167
Michigan,Alger County,8,537,344,193
Michigan,Alger County,9,487,291,196
Michigan,Alger County,10,492,292,200
Michigan,Alger County,11,608,319,289
Michigan,Alger County,12,767,389,378
Michigan,Alger County,13,840,424,416
Michigan,Alger County,14,803,419,384
Michigan,Alger County,15,595,319,276
Michigan,Alger County,16,422,211,211
Michigan,Alger County,17,273,127,146
Michigan,Alger County,18,242,86,156
Michigan,Allegan County,0,117327,58615,58712
Michigan,Allegan County,1,7283,3732,3551
Michigan,Allegan County,2,7896,3974,3922
Michigan,Allegan County,3,8315,4311,4004
Michigan,Allegan County,4,7577,3893,3684
Michigan,Allegan County,5,6490,3348,3142
Michigan,Allegan County,6,7055,3606,3449
Michigan,Allegan County,7,6923,3448,3475
Michigan,Allegan County,8,7152,3595,3557
Michigan,Allegan County,9,6763,3395,3368
Michigan,Allegan County,10,7452,3743,3709
Michigan,Allegan County,11,7979,4026,3953
Michigan,Allegan County,12,8837,4436,4401
Michigan,Allegan County,13,8191,4082,4109
Michigan,Allegan County,14,6866,3342,3524
Michigan,Allegan County,15,4947,2431,2516
Michigan,Allegan County,16,3505,1624,1881
Michigan,Allegan County,17,2092,941,1151
Michigan,Allegan County,18,2004,688,1316
Michigan,Alpena County,0,28360,13976,14384
Michigan,Alpena County,1,1348,650,698
Michigan,Alpena County,2,1409,746,663
Michigan,Alpena County,3,1513,753,760
Michigan,Alpena County,4,1564,824,740
Michigan,Alpena County,5,1379,713,666
Michigan,Alpena County,6,1586,829,757
Michigan,Alpena County,7,1403,743,660
Michigan,Alpena County,8,1604,826,778
Michigan,Alpena County,9,1470,720,750
Michigan,Alpena County,10,1628,793,835
Michigan,Alpena County,11,1923,951,972
Michigan,Alpena County,12,2400,1178,1222
Michigan,Alpena County,13,2486,1222,1264
Michigan,Alpena County,14,2044,992,1052
Michigan,Alpena County,15,1617,794,823
Michigan,Alpena County,16,1236,570,666
Michigan,Alpena County,17,853,367,486
Michigan,Alpena County,18,897,305,592
Michigan,Antrim County,0,23365,11617,11748
Michigan,Antrim County,1,1076,526,550
Michigan,Antrim County,2,1041,571,470
Michigan,Antrim County,3,1305,652,653
Michigan,Antrim County,4,1232,619,613
Michigan,Antrim County,5,1079,559,520
Michigan,Antrim County,6,1104,586,518
Michigan,Antrim County,7,1065,520,545
Michigan,Antrim County,8,1063,534,529
Michigan,Antrim County,9,1038,553,485
Michigan,Antrim County,10,1251,623,628
Michigan,Antrim County,11,1589,764,825
Michigan,Antrim County,12,1965,962,1003
Michigan,Antrim County,13,2215,1083,1132
Michigan,Antrim County,14,2019,1018,1001
Michigan,Antrim County,15,1664,807,857
Michigan,Antrim County,16,1214,614,600
Michigan,Antrim County,17,770,366,404
Michigan,Antrim County,18,675,260,415
Michigan,Arenac County,0,15041,7584,7457
Michigan,Arenac County,1,721,369,352
Michigan,Arenac County,2,704,368,336
Michigan,Arenac County,3,808,388,420
Michigan,Arenac County,4,757,398,359
Michigan,Arenac County,5,696,371,325
Michigan,Arenac County,6,791,419,372
Michigan,Arenac County,7,692,326,366
Michigan,Arenac County,8,791,408,383
Michigan,Arenac County,9,720,360,360
Michigan,Arenac County,10,848,444,404
Michigan,Arenac County,11,970,475,495
Michigan,Arenac County,12,1366,675,691
Michigan,Arenac County,13,1430,749,681
Michigan,Arenac County,14,1280,647,633
Michigan,Arenac County,15,948,477,471
Michigan,Arenac County,16,699,345,354
Michigan,Arenac County,17,439,212,227
Michigan,Arenac County,18,381,153,228
Michigan,Baraga County,0,8320,4586,3734
Michigan,Baraga County,1,328,149,179
Michigan,Baraga County,2,405,198,207
Michigan,Baraga County,3,451,228,223
Michigan,Baraga County,4,457,250,207
Michigan,Baraga County,5,492,317,175
Michigan,Baraga County,6,514,360,154
Michigan,Baraga County,7,477,317,160
Michigan,Baraga County,8,503,331,172
Michigan,Baraga County,9,462,276,186
Michigan,Baraga County,10,542,280,262
Michigan,Baraga County,11,579,303,276
Michigan,Baraga County,12,626,351,275
Michigan,Baraga County,13,644,338,306
Michigan,Baraga County,14,620,307,313
Michigan,Baraga County,15,444,228,216
Michigan,Baraga County,16,360,180,180
Michigan,Baraga County,17,203,97,106
Michigan,Baraga County,18,213,76,137
Michigan,Barry County,0,61157,30784,30373
Michigan,Barry County,1,3380,1732,1648
Michigan,Barry County,2,3692,1865,1827
Michigan,Barry County,3,4010,2081,1929
Michigan,Barry County,4,3877,2013,1864
Michigan,Barry County,5,3357,1774,1583
Michigan,Barry County,6,3490,1755,1735
Michigan,Barry County,7,3440,1760,1680
Michigan,Barry County,8,3582,1819,1763
Michigan,Barry County,9,3420,1714,1706
Michigan,Barry County,10,3831,1903,1928
Michigan,Barry County,11,4269,2193,2076
Michigan,Barry County,12,4954,2513,2441
Michigan,Barry County,13,4601,2343,2258
Michigan,Barry County,14,3768,1889,1879
Michigan,Barry County,15,2984,1449,1535
Michigan,Barry County,16,2073,1005,1068
Michigan,Barry County,17,1262,569,693
Michigan,Barry County,18,1167,407,760
Michigan,Bay County,0,103923,51068,52855
Michigan,Bay County,1,5245,2632,2613
Michigan,Bay County,2,5603,2912,2691
Michigan,Bay County,3,6303,3257,3046
Michigan,Bay County,4,6023,3141,2882
Michigan,Bay County,5,5846,2981,2865
Michigan,Bay County,6,6847,3507,3340
Michigan,Bay County,7,5900,3024,2876
Michigan,Bay County,8,6082,3037,3045
Michigan,Bay County,9,5774,2931,2843
Michigan,Bay County,10,6302,3136,3166
Michigan,Bay County,11,6923,3516,3407
Michigan,Bay County,12,8004,3833,4171
Michigan,Bay County,13,7876,3762,4114
Michigan,Bay County,14,6811,3282,3529
Michigan,Bay County,15,5249,2467,2782
Michigan,Bay County,16,3826,1723,2103
Michigan,Bay County,17,2518,1085,1433
Michigan,Bay County,18,2791,842,1949
Michigan,Benzie County,0,17753,8814,8939
Michigan,Benzie County,1,835,451,384
Michigan,Benzie County,2,827,426,401
Michigan,Benzie County,3,952,474,478
Michigan,Benzie County,4,937,497,440
Michigan,Benzie County,5,767,395,372
Michigan,Benzie County,6,919,469,450
Michigan,Benzie County,7,907,459,448
Michigan,Benzie County,8,902,453,449
Michigan,Benzie County,9,845,415,430
Michigan,Benzie County,10,989,487,502
Michigan,Benzie County,11,1146,558,588
Michigan,Benzie County,12,1463,701,762
Michigan,Benzie County,13,1625,803,822
Michigan,Benzie County,14,1422,712,710
Michigan,Benzie County,15,1254,611,643
Michigan,Benzie County,16,860,431,429
Michigan,Benzie County,17,576,265,311
Michigan,Benzie County,18,527,207,320
Michigan,Berrien County,0,154141,75450,78691
Michigan,Berrien County,1,8807,4496,4311
Michigan,Berrien County,2,9309,4749,4560
Michigan,Berrien County,3,9657,4877,4780
Michigan,Berrien County,4,9466,4851,4615
Michigan,Berrien County,5,8852,4493,4359
Michigan,Berrien County,6,9459,4895,4564
Michigan,Berrien County,7,8690,4300,4390
Michigan,Berrien County,8,8997,4381,4616
Michigan,Berrien County,9,8440,4289,4151
Michigan,Berrien County,10,9496,4711,4785
Michigan,Berrien County,11,9956,4891,5065
Michigan,Berrien County,12,11443,5591,5852
Michigan,Berrien County,13,11167,5404,5763
Michigan,Berrien County,14,9731,4564,5167
Michigan,Berrien County,15,7551,3508,4043
Michigan,Berrien County,16,5473,2484,2989
Michigan,Berrien County,17,3659,1547,2112
Michigan,Berrien County,18,3988,1419,2569
Michigan,Branch County,0,43622,22485,21137
Michigan,Branch County,1,2628,1318,1310
Michigan,Branch County,2,2753,1407,1346
Michigan,Branch County,3,2953,1474,1479
Michigan,Branch County,4,2721,1435,1286
Michigan,Branch County,5,2397,1274,1123
Michigan,Branch County,6,2641,1442,1199
Michigan,Branch County,7,2547,1377,1170
Michigan,Branch County,8,2675,1465,1210
Michigan,Branch County,9,2471,1382,1089
Michigan,Branch County,10,2778,1526,1252
Michigan,Branch County,11,2785,1510,1275
Michigan,Branch County,12,3234,1653,1581
Michigan,Branch County,13,3107,1578,1529
Michigan,Branch County,14,2564,1279,1285
Michigan,Branch County,15,2068,984,1084
Michigan,Branch County,16,1485,680,805
Michigan,Branch County,17,992,423,569
Michigan,Branch County,18,823,278,545
Michigan,Calhoun County,0,134487,65817,68670
Michigan,Calhoun County,1,8362,4333,4029
Michigan,Calhoun County,2,8336,4287,4049
Michigan,Calhoun County,3,8723,4436,4287
Michigan,Calhoun County,4,8943,4633,4310
Michigan,Calhoun County,5,8517,4287,4230
Michigan,Calhoun County,6,8764,4351,4413
Michigan,Calhoun County,7,7757,3821,3936
Michigan,Calhoun County,8,8236,4018,4218
Michigan,Calhoun County,9,7458,3703,3755
Michigan,Calhoun County,10,8387,4090,4297
Michigan,Calhoun County,11,8427,4164,4263
Michigan,Calhoun County,12,9555,4716,4839
Michigan,Calhoun County,13,9035,4336,4699
Michigan,Calhoun County,14,7874,3769,4105
Michigan,Calhoun County,15,5822,2729,3093
Michigan,Calhoun County,16,4252,1820,2432
Michigan,Calhoun County,17,2909,1249,1660
Michigan,Calhoun County,18,3130,1075,2055
Michigan,Cass County,0,51653,25919,25734
Michigan,Cass County,1,2508,1283,1225
Michigan,Cass County,2,2902,1526,1376
Michigan,Cass County,3,3240,1702,1538
Michigan,Cass County,4,3200,1597,1603
Michigan,Cass County,5,2825,1484,1341
Michigan,Cass County,6,2724,1431,1293
Michigan,Cass County,7,2592,1334,1258
Michigan,Cass County,8,2908,1453,1455
Michigan,Cass County,9,2723,1348,1375
Michigan,Cass County,10,3372,1705,1667
Michigan,Cass County,11,3695,1829,1866
Michigan,Cass County,12,4050,2077,1973
Michigan,Cass County,13,4052,2002,2050
Michigan,Cass County,14,3719,1820,1899
Michigan,Cass County,15,2962,1457,1505
Michigan,Cass County,16,2062,979,1083
Michigan,Cass County,17,1119,526,593
Michigan,Cass County,18,1000,366,634
Michigan,Charlevoix County,0,26244,12988,13256
Michigan,Charlevoix County,1,1115,545,570
Michigan,Charlevoix County,2,1338,695,643
Michigan,Charlevoix County,3,1519,755,764
Michigan,Charlevoix County,4,1508,768,740
Michigan,Charlevoix County,5,1340,679,661
Michigan,Charlevoix County,6,1308,682,626
Michigan,Charlevoix County,7,1304,684,620
Michigan,Charlevoix County,8,1401,707,694
Michigan,Charlevoix County,9,1245,623,622
Michigan,Charlevoix County,10,1437,705,732
Michigan,Charlevoix County,11,1790,913,877
Michigan,Charlevoix County,12,2221,1089,1132
Michigan,Charlevoix County,13,2319,1112,1207
Michigan,Charlevoix County,14,2078,1008,1070
Michigan,Charlevoix County,15,1704,810,894
Michigan,Charlevoix County,16,1205,601,604
Michigan,Charlevoix County,17,703,342,361
Michigan,Charlevoix County,18,709,270,439
Michigan,Cheboygan County,0,25413,12673,12740
Michigan,Cheboygan County,1,1006,518,488
Michigan,Cheboygan County,2,1037,550,487
Michigan,Cheboygan County,3,1279,661,618
Michigan,Cheboygan County,4,1314,711,603
Michigan,Cheboygan County,5,1231,645,586
Michigan,Cheboygan County,6,1238,649,589
Michigan,Cheboygan County,7,1150,586,564
Michigan,Cheboygan County,8,1214,608,606
Michigan,Cheboygan County,9,1244,598,646
Michigan,Cheboygan County,10,1545,785,760
Michigan,Cheboygan County,11,1721,870,851
Michigan,Cheboygan County,12,2102,1005,1097
Michigan,Cheboygan County,13,2405,1125,1280
Michigan,Cheboygan County,14,2279,1163,1116
Michigan,Cheboygan County,15,1795,885,910
Michigan,Cheboygan County,16,1305,643,662
Michigan,Cheboygan County,17,814,391,423
Michigan,Cheboygan County,18,734,280,454
Michigan,Chippewa County,0,37517,20711,16806
Michigan,Chippewa County,1,1795,882,913
Michigan,Chippewa County,2,1900,968,932
Michigan,Chippewa County,3,1977,1020,957
Michigan,Chippewa County,4,2226,1193,1033
Michigan,Chippewa County,5,3410,1895,1515
Michigan,Chippewa County,6,2536,1563,973
Michigan,Chippewa County,7,2437,1604,833
Michigan,Chippewa County,8,2441,1552,889
Michigan,Chippewa County,9,2265,1399,866
Michigan,Chippewa County,10,2275,1388,887
Michigan,Chippewa County,11,2349,1327,1022
Michigan,Chippewa County,12,2627,1379,1248
Michigan,Chippewa County,13,2537,1277,1260
Michigan,Chippewa County,14,2161,1108,1053
Michigan,Chippewa County,15,1677,850,827
Michigan,Chippewa County,16,1307,602,705
Michigan,Chippewa County,17,821,398,423
Michigan,Chippewa County,18,776,306,470
Michigan,Clare County,0,30757,15375,15382
Michigan,Clare County,1,1653,843,810
Michigan,Clare County,2,1639,832,807
Michigan,Clare County,3,1758,908,850
Michigan,Clare County,4,1628,864,764
Michigan,Clare County,5,1503,795,708
Michigan,Clare County,6,1701,844,857
Michigan,Clare County,7,1519,748,771
Michigan,Clare County,8,1529,782,747
Michigan,Clare County,9,1595,808,787
Michigan,Clare County,10,1721,871,850
Michigan,Clare County,11,2029,1007,1022
Michigan,Clare County,12,2492,1218,1274
Michigan,Clare County,13,2649,1308,1341
Michigan,Clare County,14,2464,1195,1269
Michigan,Clare County,15,1937,947,990
Michigan,Clare County,16,1391,707,684
Michigan,Clare County,17,844,426,418
Michigan,Clare County,18,705,272,433
Michigan,Clinton County,0,79332,39234,40098
Michigan,Clinton County,1,4452,2288,2164
Michigan,Clinton County,2,4754,2374,2380
Michigan,Clinton County,3,5286,2651,2635
Michigan,Clinton County,4,4989,2611,2378
Michigan,Clinton County,5,4913,2524,2389
Michigan,Clinton County,6,4963,2522,2441
Michigan,Clinton County,7,4627,2300,2327
Michigan,Clinton County,8,5031,2512,2519
Michigan,Clinton County,9,4720,2348,2372
Michigan,Clinton County,10,5151,2461,2690
Michigan,Clinton County,11,5724,2817,2907
Michigan,Clinton County,12,5810,2924,2886
Michigan,Clinton County,13,5470,2662,2808
Michigan,Clinton County,14,4559,2198,2361
Michigan,Clinton County,15,3396,1636,1760
Michigan,Clinton County,16,2434,1169,1265
Michigan,Clinton County,17,1528,689,839
Michigan,Clinton County,18,1525,548,977
Michigan,Crawford County,0,13901,7062,6839
Michigan,Crawford County,1,643,325,318
Michigan,Crawford County,2,638,334,304
Michigan,Crawford County,3,728,386,342
Michigan,Crawford County,4,722,349,373
Michigan,Crawford County,5,610,325,285
Michigan,Crawford County,6,686,341,345
Michigan,Crawford County,7,625,318,307
Michigan,Crawford County,8,705,352,353
Michigan,Crawford County,9,575,274,301
Michigan,Crawford County,10,834,433,401
Michigan,Crawford County,11,994,502,492
Michigan,Crawford County,12,1309,653,656
Michigan,Crawford County,13,1262,662,600
Michigan,Crawford County,14,1152,627,525
Michigan,Crawford County,15,904,439,465
Michigan,Crawford County,16,696,361,335
Michigan,Crawford County,17,437,211,226
Michigan,Crawford County,18,381,170,211
Michigan,Delta County,0,35857,17808,18049
Michigan,Delta County,1,1782,920,862
Michigan,Delta County,2,1967,1006,961
Michigan,Delta County,3,1998,1027,971
Michigan,Delta County,4,2067,1052,1015
Michigan,Delta County,5,1697,871,826
Michigan,Delta County,6,1816,926,890
Michigan,Delta County,7,1685,860,825
Michigan,Delta County,8,1960,990,970
Michigan,Delta County,9,1838,952,886
Michigan,Delta County,10,2074,1060,1014
Michigan,Delta County,11,2332,1155,1177
Michigan,Delta County,12,2873,1455,1418
Michigan,Delta County,13,3103,1520,1583
Michigan,Delta County,14,2877,1397,1480
Michigan,Delta County,15,2039,1030,1009
Michigan,Delta County,16,1454,682,772
Michigan,Delta County,17,1085,497,588
Michigan,Delta County,18,1210,408,802
Michigan,Dickinson County,0,25383,12723,12660
Michigan,Dickinson County,1,1389,712,677
Michigan,Dickinson County,2,1361,692,669
Michigan,Dickinson County,3,1449,760,689
Michigan,Dickinson County,4,1424,710,714
Michigan,Dickinson County,5,1303,739,564
Michigan,Dickinson County,6,1310,683,627
Michigan,Dickinson County,7,1372,703,669
Michigan,Dickinson County,8,1450,719,731
Michigan,Dickinson County,9,1252,647,605
Michigan,Dickinson County,10,1424,704,720
Michigan,Dickinson County,11,1765,915,850
Michigan,Dickinson County,12,2082,987,1095
Michigan,Dickinson County,13,2196,1102,1094
Michigan,Dickinson County,14,1690,883,807
Michigan,Dickinson County,15,1367,659,708
Michigan,Dickinson County,16,970,459,511
Michigan,Dickinson County,17,686,304,382
Michigan,Dickinson County,18,893,345,548
Michigan,Eaton County,0,109826,53971,55855
Michigan,Eaton County,1,5886,3069,2817
Michigan,Eaton County,2,6236,3178,3058
Michigan,Eaton County,3,6334,3242,3092
Michigan,Eaton County,4,6953,3589,3364
Michigan,Eaton County,5,6911,3546,3365
Michigan,Eaton County,6,7300,3749,3551
Michigan,Eaton County,7,6985,3542,3443
Michigan,Eaton County,8,6726,3314,3412
Michigan,Eaton County,9,6099,3030,3069
Michigan,Eaton County,10,6623,3266,3357
Michigan,Eaton County,11,7340,3453,3887
Michigan,Eaton County,12,8163,3948,4215
Michigan,Eaton County,13,7866,3782,4084
Michigan,Eaton County,14,6837,3297,3540
Michigan,Eaton County,15,5437,2557,2880
Michigan,Eaton County,16,3565,1617,1948
Michigan,Eaton County,17,2276,943,1333
Michigan,Eaton County,18,2289,849,1440
Michigan,Emmet County,0,33308,16414,16894
Michigan,Emmet County,1,1587,817,770
Michigan,Emmet County,2,1683,856,827
Michigan,Emmet County,3,1885,994,891
Michigan,Emmet County,4,1963,1011,952
Michigan,Emmet County,5,1831,929,902
Michigan,Emmet County,6,1927,1004,923
Michigan,Emmet County,7,1855,911,944
Michigan,Emmet County,8,1803,890,913
Michigan,Emmet County,9,1807,866,941
Michigan,Emmet County,10,1954,1019,935
Michigan,Emmet County,11,2140,1041,1099
Michigan,Emmet County,12,2598,1263,1335
Michigan,Emmet County,13,2770,1309,1461
Michigan,Emmet County,14,2631,1263,1368
Michigan,Emmet County,15,1823,893,930
Michigan,Emmet County,16,1341,676,665
Michigan,Emmet County,17,806,366,440
Michigan,Emmet County,18,904,306,598
Michigan,Genesee County,0,406892,196242,210650
Michigan,Genesee County,1,23984,12198,11786
Michigan,Genesee County,2,24812,12708,12104
Michigan,Genesee County,3,26338,13557,12781
Michigan,Genesee County,4,26159,13513,12646
Michigan,Genesee County,5,25162,12613,12549
Michigan,Genesee County,6,27507,13479,14028
Michigan,Genesee County,7,22503,10965,11538
Michigan,Genesee County,8,23961,11396,12565
Michigan,Genesee County,9,23208,11136,12072
Michigan,Genesee County,10,26490,12731,13759
Michigan,Genesee County,11,27305,13213,14092
Michigan,Genesee County,12,29595,14010,15585
Michigan,Genesee County,13,28732,13706,15026
Michigan,Genesee County,14,22924,10628,12296
Michigan,Genesee County,15,18199,8294,9905
Michigan,Genesee County,16,12511,5515,6996
Michigan,Genesee County,17,8628,3478,5150
Michigan,Genesee County,18,8874,3102,5772
Michigan,Gladwin County,0,25337,12814,12523
Michigan,Gladwin County,1,1353,668,685
Michigan,Gladwin County,2,1242,701,541
Michigan,Gladwin County,3,1291,678,613
Michigan,Gladwin County,4,1359,692,667
Michigan,Gladwin County,5,1098,578,520
Michigan,Gladwin County,6,1265,666,599
Michigan,Gladwin County,7,1130,597,533
Michigan,Gladwin County,8,1179,616,563
Michigan,Gladwin County,9,1171,584,587
Michigan,Gladwin County,10,1463,722,741
Michigan,Gladwin County,11,1721,877,844
Michigan,Gladwin County,12,2070,1054,1016
Michigan,Gladwin County,13,2226,1087,1139
Michigan,Gladwin County,14,2186,1054,1132
Michigan,Gladwin County,15,1755,917,838
Michigan,Gladwin County,16,1338,657,681
Michigan,Gladwin County,17,827,402,425
Michigan,Gladwin County,18,663,264,399
Michigan,Gogebic County,0,15096,8126,6970
Michigan,Gogebic County,1,596,309,287
Michigan,Gogebic County,2,652,333,319
Michigan,Gogebic County,3,695,359,336
Michigan,Gogebic County,4,712,385,327
Michigan,Gogebic County,5,834,522,312
Michigan,Gogebic County,6,858,510,348
Michigan,Gogebic County,7,801,488,313
Michigan,Gogebic County,8,838,501,337
Michigan,Gogebic County,9,780,469,311
Michigan,Gogebic County,10,886,491,395
Michigan,Gogebic County,11,1002,548,454
Michigan,Gogebic County,12,1245,619,626
Michigan,Gogebic County,13,1291,693,598
Michigan,Gogebic County,14,1232,666,566
Michigan,Gogebic County,15,968,499,469
Michigan,Gogebic County,16,666,327,339
Michigan,Gogebic County,17,450,207,243
Michigan,Gogebic County,18,590,200,390
Michigan,Grand Traverse County,0,92573,45296,47277
Michigan,Grand Traverse County,1,4855,2485,2370
Michigan,Grand Traverse County,2,5044,2627,2417
Michigan,Grand Traverse County,3,5480,2784,2696
Michigan,Grand Traverse County,4,5321,2723,2598
Michigan,Grand Traverse County,5,4973,2540,2433
Michigan,Grand Traverse County,6,5780,2985,2795
Michigan,Grand Traverse County,7,5772,2856,2916
Michigan,Grand Traverse County,8,5850,2954,2896
Michigan,Grand Traverse County,9,5096,2495,2601
Michigan,Grand Traverse County,10,5691,2860,2831
Michigan,Grand Traverse County,11,5889,2867,3022
Michigan,Grand Traverse County,12,7102,3384,3718
Michigan,Grand Traverse County,13,7293,3479,3814
Michigan,Grand Traverse County,14,6354,3097,3257
Michigan,Grand Traverse County,15,4708,2212,2496
Michigan,Grand Traverse County,16,3051,1339,1712
Michigan,Grand Traverse County,17,2020,850,1170
Michigan,Grand Traverse County,18,2294,759,1535
Michigan,Gratiot County,0,40599,21804,18795
Michigan,Gratiot County,1,1940,1056,884
Michigan,Gratiot County,2,2216,1122,1094
Michigan,Gratiot County,3,2294,1164,1130
Michigan,Gratiot County,4,2896,1472,1424
Michigan,Gratiot County,5,3124,1845,1279
Michigan,Gratiot County,6,2822,1732,1090
Michigan,Gratiot County,7,2502,1511,991
Michigan,Gratiot County,8,2650,1550,1100
Michigan,Gratiot County,9,2454,1476,978
Michigan,Gratiot County,10,2590,1496,1094
Michigan,Gratiot County,11,2691,1463,1228
Michigan,Gratiot County,12,2813,1465,1348
Michigan,Gratiot County,13,2501,1269,1232
Michigan,Gratiot County,14,2176,1043,1133
Michigan,Gratiot County,15,1712,834,878
Michigan,Gratiot County,16,1271,558,713
Michigan,Gratiot County,17,855,372,483
Michigan,Gratiot County,18,1092,376,716
Michigan,Hillsdale County,0,45749,22763,22986
Michigan,Hillsdale County,1,2727,1392,1335
Michigan,Hillsdale County,2,2567,1295,1272
Michigan,Hillsdale County,3,2855,1464,1391
Michigan,Hillsdale County,4,3227,1637,1590
Michigan,Hillsdale County,5,2912,1473,1439
Michigan,Hillsdale County,6,2509,1279,1230
Michigan,Hillsdale County,7,2283,1163,1120
Michigan,Hillsdale County,8,2469,1198,1271
Michigan,Hillsdale County,9,2473,1236,1237
Michigan,Hillsdale County,10,2791,1445,1346
Michigan,Hillsdale County,11,2932,1496,1436
Michigan,Hillsdale County,12,3428,1733,1695
Michigan,Hillsdale County,13,3601,1762,1839
Michigan,Hillsdale County,14,2963,1487,1476
Michigan,Hillsdale County,15,2252,1040,1212
Michigan,Hillsdale County,16,1719,867,852
Michigan,Hillsdale County,17,1041,466,575
Michigan,Hillsdale County,18,1000,330,670
Michigan,Houghton County,0,36219,19588,16631
Michigan,Houghton County,1,1845,933,912
Michigan,Houghton County,2,1982,1032,950
Michigan,Houghton County,3,2172,1132,1040
Michigan,Houghton County,4,3677,2202,1475
Michigan,Houghton County,5,5464,3627,1837
Michigan,Houghton County,6,2011,1116,895
Michigan,Houghton County,7,1638,901,737
Michigan,Houghton County,8,1755,890,865
Michigan,Houghton County,9,1653,847,806
Michigan,Houghton County,10,1662,871,791
Michigan,Houghton County,11,1819,897,922
Michigan,Houghton County,12,2073,1048,1025
Michigan,Houghton County,13,2130,1084,1046
Michigan,Houghton County,14,2041,1046,995
Michigan,Houghton County,15,1564,789,775
Michigan,Houghton County,16,1156,537,619
Michigan,Houghton County,17,727,327,400
Michigan,Houghton County,18,850,309,541
Michigan,Huron County,0,31166,15439,15727
Michigan,Huron County,1,1568,784,784
Michigan,Huron County,2,1635,826,809
Michigan,Huron County,3,1696,863,833
Michigan,Huron County,4,1715,868,847
Michigan,Huron County,5,1544,823,721
Michigan,Huron County,6,1517,780,737
Michigan,Huron County,7,1477,761,716
Michigan,Huron County,8,1611,842,769
Michigan,Huron County,9,1396,724,672
Michigan,Huron County,10,1819,896,923
Michigan,Huron County,11,2088,1046,1042
Michigan,Huron County,12,2540,1254,1286
Michigan,Huron County,13,2747,1351,1396
Michigan,Huron County,14,2428,1225,1203
Michigan,Huron County,15,1893,921,972
Michigan,Huron County,16,1486,699,787
Michigan,Huron County,17,999,417,582
Michigan,Huron County,18,1007,359,648
Michigan,Ingham County,0,292735,142571,150164
Michigan,Ingham County,1,16584,8398,8186
Michigan,Ingham County,2,15900,8030,7870
Michigan,Ingham County,3,16001,8182,7819
Michigan,Ingham County,4,25801,12597,13204
Michigan,Ingham County,5,39865,19857,20008
Michigan,Ingham County,6,23569,12018,11551
Michigan,Ingham County,7,18308,9364,8944
Michigan,Ingham County,8,17686,8794,8892
Michigan,Ingham County,9,15105,7412,7693
Michigan,Ingham County,10,15659,7605,8054
Michigan,Ingham County,11,15490,7520,7970
Michigan,Ingham County,12,16728,7944,8784
Michigan,Ingham County,13,16580,7653,8927
Michigan,Ingham County,14,13974,6429,7545
Michigan,Ingham County,15,10037,4612,5425
Michigan,Ingham County,16,6665,2930,3735
Michigan,Ingham County,17,4031,1639,2392
Michigan,Ingham County,18,4752,1587,3165
Michigan,Ionia County,0,64210,34441,29769
Michigan,Ionia County,1,3693,1887,1806
Michigan,Ionia County,2,3882,2002,1880
Michigan,Ionia County,3,4231,2150,2081
Michigan,Ionia County,4,3967,2168,1799
Michigan,Ionia County,5,4418,2687,1731
Michigan,Ionia County,6,4618,2757,1861
Michigan,Ionia County,7,4153,2390,1763
Michigan,Ionia County,8,4269,2421,1848
Michigan,Ionia County,9,4107,2298,1809
Michigan,Ionia County,10,4348,2440,1908
Michigan,Ionia County,11,4361,2348,2013
Michigan,Ionia County,12,4571,2385,2186
Michigan,Ionia County,13,4115,2073,2042
Michigan,Ionia County,14,3310,1664,1646
Michigan,Ionia County,15,2541,1232,1309
Michigan,Ionia County,16,1662,763,899
Michigan,Ionia County,17,1032,426,606
Michigan,Ionia County,18,932,350,582
Michigan,Iosco County,0,25081,12437,12644
Michigan,Iosco County,1,1114,580,534
Michigan,Iosco County,2,1096,546,550
Michigan,Iosco County,3,1167,567,600
Michigan,Iosco County,4,1154,587,567
Michigan,Iosco County,5,1066,568,498
Michigan,Iosco County,6,1241,640,601
Michigan,Iosco County,7,1118,572,546
Michigan,Iosco County,8,1128,580,548
Michigan,Iosco County,9,1075,518,557
Michigan,Iosco County,10,1337,665,672
Michigan,Iosco County,11,1617,823,794
Michigan,Iosco County,12,2110,1005,1105
Michigan,Iosco County,13,2437,1220,1217
Michigan,Iosco County,14,2307,1154,1153
Michigan,Iosco County,15,1888,926,962
Michigan,Iosco County,16,1456,717,739
Michigan,Iosco County,17,961,437,524
Michigan,Iosco County,18,809,332,477
Michigan,Iron County,0,11117,5548,5569
Michigan,Iron County,1,483,240,243
Michigan,Iron County,2,510,254,256
Michigan,Iron County,3,516,253,263
Michigan,Iron County,4,521,276,245
Michigan,Iron County,5,441,216,225
Michigan,Iron County,6,442,236,206
Michigan,Iron County,7,431,209,222
Michigan,Iron County,8,520,263,257
Michigan,Iron County,9,513,273,240
Michigan,Iron County,10,544,282,262
Michigan,Iron County,11,680,334,346
Michigan,Iron County,12,985,486,499
Michigan,Iron County,13,1129,583,546
Michigan,Iron County,14,1076,578,498
Michigan,Iron County,15,805,427,378
Michigan,Iron County,16,572,285,287
Michigan,Iron County,17,389,167,222
Michigan,Iron County,18,560,186,374
Michigan,Isabella County,0,70562,34331,36231
Michigan,Isabella County,1,3257,1666,1591
Michigan,Isabella County,2,3289,1665,1624
Michigan,Isabella County,3,3501,1791,1710
Michigan,Isabella County,4,7819,3500,4319
Michigan,Isabella County,5,13455,6358,7097
Michigan,Isabella County,6,5119,2733,2386
Michigan,Isabella County,7,3724,1936,1788
Michigan,Isabella County,8,3738,1942,1796
Michigan,Isabella County,9,3196,1602,1594
Michigan,Isabella County,10,3326,1664,1662
Michigan,Isabella County,11,3555,1772,1783
Michigan,Isabella County,12,3870,1885,1985
Michigan,Isabella County,13,3804,1796,2008
Michigan,Isabella County,14,3175,1556,1619
Michigan,Isabella County,15,2107,999,1108
Michigan,Isabella County,16,1559,702,857
Michigan,Isabella County,17,1036,446,590
Michigan,Isabella County,18,1032,318,714
Michigan,Jackson County,0,158823,81111,77712
Michigan,Jackson County,1,8967,4581,4386
Michigan,Jackson County,2,9252,4810,4442
Michigan,Jackson County,3,9742,5025,4717
Michigan,Jackson County,4,9972,5165,4807
Michigan,Jackson County,5,9933,5388,4545
Michigan,Jackson County,6,10885,5811,5074
Michigan,Jackson County,7,9296,4945,4351
Michigan,Jackson County,8,9374,5023,4351
Michigan,Jackson County,9,9068,5003,4065
Michigan,Jackson County,10,10346,5419,4927
Michigan,Jackson County,11,10697,5568,5129
Michigan,Jackson County,12,11862,5965,5897
Michigan,Jackson County,13,11147,5436,5711
Michigan,Jackson County,14,9424,4663,4761
Michigan,Jackson County,15,7166,3418,3748
Michigan,Jackson County,16,4906,2243,2663
Michigan,Jackson County,17,3285,1406,1879
Michigan,Jackson County,18,3501,1242,2259
Michigan,Kalamazoo County,0,264870,129661,135209
Michigan,Kalamazoo County,1,15891,8122,7769
Michigan,Kalamazoo County,2,15877,8065,7812
Michigan,Kalamazoo County,3,15966,8164,7802
Michigan,Kalamazoo County,4,18664,9481,9183
Michigan,Kalamazoo County,5,31801,15637,16164
Michigan,Kalamazoo County,6,19736,10105,9631
Michigan,Kalamazoo County,7,16407,8382,8025
Michigan,Kalamazoo County,8,16315,8144,8171
Michigan,Kalamazoo County,9,14387,7108,7279
Michigan,Kalamazoo County,10,14853,7294,7559
Michigan,Kalamazoo County,11,14404,7086,7318
Michigan,Kalamazoo County,12,15643,7571,8072
Michigan,Kalamazoo County,13,15296,7259,8037
Michigan,Kalamazoo County,14,13294,6152,7142
Michigan,Kalamazoo County,15,9816,4538,5278
Michigan,Kalamazoo County,16,6874,2977,3897
Michigan,Kalamazoo County,17,4383,1800,2583
Michigan,Kalamazoo County,18,5263,1776,3487
Michigan,Kalkaska County,0,17824,9146,8678
Michigan,Kalkaska County,1,924,469,455
Michigan,Kalkaska County,2,1045,556,489
Michigan,Kalkaska County,3,1100,547,553
Michigan,Kalkaska County,4,1037,575,462
Michigan,Kalkaska County,5,887,485,402
Michigan,Kalkaska County,6,1023,518,505
Michigan,Kalkaska County,7,1029,526,503
Michigan,Kalkaska County,8,1042,532,510
Michigan,Kalkaska County,9,999,508,491
Michigan,Kalkaska County,10,1065,552,513
Michigan,Kalkaska County,11,1227,641,586
Michigan,Kalkaska County,12,1414,698,716
Michigan,Kalkaska County,13,1405,709,696
Michigan,Kalkaska County,14,1232,654,578
Michigan,Kalkaska County,15,1025,518,507
Michigan,Kalkaska County,16,705,347,358
Michigan,Kalkaska County,17,392,199,193
Michigan,Kalkaska County,18,273,112,161
Michigan,Kent County,0,653786,322336,331450
Michigan,Kent County,1,43941,22405,21536
Michigan,Kent County,2,43409,22454,20955
Michigan,Kent County,3,44231,22682,21549
Michigan,Kent County,4,43138,21843,21295
Michigan,Kent County,5,44977,22534,22443
Michigan,Kent County,6,54840,27637,27203
Michigan,Kent County,7,48678,24267,24411
Michigan,Kent County,8,44389,22230,22159
Michigan,Kent County,9,37701,18651,19050
Michigan,Kent County,10,38752,19267,19485
Michigan,Kent County,11,39495,19603,19892
Michigan,Kent County,12,42244,20689,21555
Michigan,Kent County,13,38695,18613,20082
Michigan,Kent County,14,30807,14688,16119
Michigan,Kent County,15,21532,9877,11655
Michigan,Kent County,16,14839,6530,8309
Michigan,Kent County,17,10158,4142,6016
Michigan,Kent County,18,11960,4224,7736
Michigan,Keweenaw County,0,2113,1085,1028
Michigan,Keweenaw County,1,89,53,36
Michigan,Keweenaw County,2,68,37,31
Michigan,Keweenaw County,3,94,41,53
Michigan,Keweenaw County,4,96,45,51
Michigan,Keweenaw County,5,65,39,26
Michigan,Keweenaw County,6,83,43,40
Michigan,Keweenaw County,7,62,29,33
Michigan,Keweenaw County,8,85,48,37
Michigan,Keweenaw County,9,89,46,43
Michigan,Keweenaw County,10,104,50,54
Michigan,Keweenaw County,11,104,50,54
Michigan,Keweenaw County,12,183,88,95
Michigan,Keweenaw County,13,214,112,102
Michigan,Keweenaw County,14,244,111,133
Michigan,Keweenaw County,15,221,133,88
Michigan,Keweenaw County,16,158,92,66
Michigan,Keweenaw County,17,90,46,44
Michigan,Keweenaw County,18,64,22,42
Michigan,Lake County,0,11881,6041,5840
Michigan,Lake County,1,524,277,247
Michigan,Lake County,2,523,276,247
Michigan,Lake County,3,565,275,290
Michigan,Lake County,4,485,239,246
Michigan,Lake County,5,480,261,219
Michigan,Lake County,6,496,254,242
Michigan,Lake County,7,481,247,234
Michigan,Lake County,8,536,246,290
Michigan,Lake County,9,543,292,251
Michigan,Lake County,10,710,383,327
Michigan,Lake County,11,771,383,388
Michigan,Lake County,12,1094,522,572
Michigan,Lake County,13,1272,624,648
Michigan,Lake County,14,1207,631,576
Michigan,Lake County,15,882,468,414
Michigan,Lake County,16,608,314,294
Michigan,Lake County,17,420,219,201
Michigan,Lake County,18,284,130,154
Michigan,Lapeer County,0,88028,44635,43393
Michigan,Lapeer County,1,4245,2158,2087
Michigan,Lapeer County,2,4813,2499,2314
Michigan,Lapeer County,3,5450,2818,2632
Michigan,Lapeer County,4,5663,2993,2670
Michigan,Lapeer County,5,5075,2659,2416
Michigan,Lapeer County,6,5000,2732,2268
Michigan,Lapeer County,7,4490,2326,2164
Michigan,Lapeer County,8,4941,2511,2430
Michigan,Lapeer County,9,4907,2494,2413
Michigan,Lapeer County,10,5938,2979,2959
Michigan,Lapeer County,11,7065,3575,3490
Michigan,Lapeer County,12,7452,3783,3669
Michigan,Lapeer County,13,7026,3577,3449
Michigan,Lapeer County,14,5574,2774,2800
Michigan,Lapeer County,15,4226,2033,2193
Michigan,Lapeer County,16,2915,1416,1499
Michigan,Lapeer County,17,1738,782,956
Michigan,Lapeer County,18,1510,526,984
Michigan,Leelanau County,0,21764,10748,11016
Michigan,Leelanau County,1,865,446,419
Michigan,Leelanau County,2,956,499,457
Michigan,Leelanau County,3,984,497,487
Michigan,Leelanau County,4,1063,574,489
Michigan,Leelanau County,5,994,488,506
Michigan,Leelanau County,6,937,481,456
Michigan,Leelanau County,7,943,467,476
Michigan,Leelanau County,8,1022,513,509
Michigan,Leelanau County,9,960,489,471
Michigan,Leelanau County,10,1054,555,499
Michigan,Leelanau County,11,1236,583,653
Michigan,Leelanau County,12,1818,838,980
Michigan,Leelanau County,13,2201,1052,1149
Michigan,Leelanau County,14,2232,1089,1143
Michigan,Leelanau County,15,1674,848,826
Michigan,Leelanau County,16,1211,600,611
Michigan,Leelanau County,17,783,387,396
Michigan,Leelanau County,18,831,342,489
Michigan,Lenawee County,0,98266,49663,48603
Michigan,Lenawee County,1,5364,2681,2683
Michigan,Lenawee County,2,5453,2821,2632
Michigan,Lenawee County,3,6043,3140,2903
Michigan,Lenawee County,4,6559,3467,3092
Michigan,Lenawee County,5,6164,3309,2855
Michigan,Lenawee County,6,5939,3178,2761
Michigan,Lenawee County,7,5481,2947,2534
Michigan,Lenawee County,8,5877,3112,2765
Michigan,Lenawee County,9,5641,2952,2689
Michigan,Lenawee County,10,6444,3357,3087
Michigan,Lenawee County,11,6530,3303,3227
Michigan,Lenawee County,12,7057,3508,3549
Michigan,Lenawee County,13,7069,3479,3590
Michigan,Lenawee County,14,6236,3013,3223
Michigan,Lenawee County,15,4866,2307,2559
Michigan,Lenawee County,16,3266,1471,1795
Michigan,Lenawee County,17,2135,857,1278
Michigan,Lenawee County,18,2142,761,1381
Michigan,Livingston County,0,191224,95837,95387
Michigan,Livingston County,1,9709,4987,4722
Michigan,Livingston County,2,10517,5420,5097
Michigan,Livingston County,3,12161,6229,5932
Michigan,Livingston County,4,12741,6629,6112
Michigan,Livingston County,5,11152,5836,5316
Michigan,Livingston County,6,10352,5480,4872
Michigan,Livingston County,7,10337,5229,5108
Michigan,Livingston County,8,10999,5551,5448
Michigan,Livingston County,9,10813,5442,5371
Michigan,Livingston County,10,13473,6670,6803
Michigan,Livingston County,11,15464,7641,7823
Michigan,Livingston County,12,16187,8161,8026
Michigan,Livingston County,13,14399,7123,7276
Michigan,Livingston County,14,11506,5576,5930
Michigan,Livingston County,15,8835,4270,4565
Michigan,Livingston County,16,5953,2906,3047
Michigan,Livingston County,17,3248,1443,1805
Michigan,Livingston County,18,3378,1244,2134
Michigan,Luce County,0,6283,3699,2584
Michigan,Luce County,1,252,131,121
Michigan,Luce County,2,286,146,140
Michigan,Luce County,3,305,171,134
Michigan,Luce County,4,304,180,124
Michigan,Luce County,5,377,251,126
Michigan,Luce County,6,433,297,136
Michigan,Luce County,7,401,283,118
Michigan,Luce County,8,420,286,134
Michigan,Luce County,9,406,274,132
Michigan,Luce County,10,427,277,150
Michigan,Luce County,11,404,246,158
Michigan,Luce County,12,469,266,203
Michigan,Luce County,13,507,263,244
Michigan,Luce County,14,378,200,178
Michigan,Luce County,15,297,166,131
Michigan,Luce County,16,264,108,156
Michigan,Luce County,17,188,90,98
Michigan,Luce County,18,165,64,101
Michigan,Mackinac County,0,10787,5508,5279
Michigan,Mackinac County,1,436,192,244
Michigan,Mackinac County,2,412,227,185
Michigan,Mackinac County,3,498,265,233
Michigan,Mackinac County,4,547,301,246
Michigan,Mackinac County,5,521,296,225
Michigan,Mackinac County,6,542,288,254
Michigan,Mackinac County,7,476,265,211
Michigan,Mackinac County,8,470,240,230
Michigan,Mackinac County,9,518,254,264
Michigan,Mackinac County,10,669,334,335
Michigan,Mackinac County,11,723,392,331
Michigan,Mackinac County,12,941,472,469
Michigan,Mackinac County,13,1009,489,520
Michigan,Mackinac County,14,1008,509,499
Michigan,Mackinac County,15,728,367,361
Michigan,Mackinac County,16,607,324,283
Michigan,Mackinac County,17,360,179,181
Michigan,Mackinac County,18,322,114,208
Michigan,Macomb County,0,874759,425844,448915
Michigan,Macomb County,1,47964,24482,23482
Michigan,Macomb County,2,49186,24997,24189
Michigan,Macomb County,3,53009,27337,25672
Michigan,Macomb County,4,52152,26830,25322
Michigan,Macomb County,5,53249,26930,26319
Michigan,Macomb County,6,63670,32246,31424
Michigan,Macomb County,7,53937,27073,26864
Michigan,Macomb County,8,52781,25811,26970
Michigan,Macomb County,9,51848,25430,26418
Michigan,Macomb County,10,59725,29155,30570
Michigan,Macomb County,11,63006,30588,32418
Michigan,Macomb County,12,65546,31957,33589
Michigan,Macomb County,13,60050,28743,31307
Michigan,Macomb County,14,47836,22518,25318
Michigan,Macomb County,15,36946,16789,20157
Michigan,Macomb County,16,26512,11412,15100
Michigan,Macomb County,17,17564,6932,10632
Michigan,Macomb County,18,19778,6614,13164
Michigan,Manistee County,0,24528,12682,11846
Michigan,Manistee County,1,1068,502,566
Michigan,Manistee County,2,1054,514,540
Michigan,Manistee County,3,1277,645,632
Michigan,Manistee County,4,1322,677,645
Michigan,Manistee County,5,1337,834,503
Michigan,Manistee County,6,1373,844,529
Michigan,Manistee County,7,1196,695,501
Michigan,Manistee County,8,1182,657,525
Michigan,Manistee County,9,1199,666,533
Michigan,Manistee County,10,1366,711,655
Michigan,Manistee County,11,1639,856,783
Michigan,Manistee County,12,1955,940,1015
Michigan,Manistee County,13,2242,1099,1143
Michigan,Manistee County,14,2073,1045,1028
Michigan,Manistee County,15,1617,813,804
Michigan,Manistee County,16,1159,549,610
Michigan,Manistee County,17,747,354,393
Michigan,Manistee County,18,722,281,441
Michigan,Marquette County,0,66516,33344,33172
Michigan,Marquette County,1,3196,1582,1614
Michigan,Marquette County,2,3403,1736,1667
Michigan,Marquette County,3,3425,1756,1669
Michigan,Marquette County,4,4688,2251,2437
Michigan,Marquette County,5,7598,3834,3764
Michigan,Marquette County,6,3997,2086,1911
Michigan,Marquette County,7,3599,1877,1722
Michigan,Marquette County,8,3938,2037,1901
Michigan,Marquette County,9,3371,1730,1641
Michigan,Marquette County,10,3540,1844,1696
Michigan,Marquette County,11,3743,1905,1838
Michigan,Marquette County,12,4480,2194,2286
Michigan,Marquette County,13,4819,2384,2435
Michigan,Marquette County,14,4363,2220,2143
Michigan,Marquette County,15,3159,1590,1569
Michigan,Marquette County,16,2059,1009,1050
Michigan,Marquette County,17,1485,662,823
Michigan,Marquette County,18,1653,647,1006
Michigan,Mason County,0,29100,14447,14653
Michigan,Mason County,1,1499,773,726
Michigan,Mason County,2,1613,835,778
Michigan,Mason County,3,1749,903,846
Michigan,Mason County,4,1599,839,760
Michigan,Mason County,5,1402,774,628
Michigan,Mason County,6,1635,833,802
Michigan,Mason County,7,1480,763,717
Michigan,Mason County,8,1601,790,811
Michigan,Mason County,9,1453,709,744
Michigan,Mason County,10,1599,783,816
Michigan,Mason County,11,1821,901,920
Michigan,Mason County,12,2282,1100,1182
Michigan,Mason County,13,2513,1242,1271
Michigan,Mason County,14,2297,1147,1150
Michigan,Mason County,15,1669,812,857
Michigan,Mason County,16,1274,600,674
Michigan,Mason County,17,822,361,461
Michigan,Mason County,18,792,282,510
Michigan,Mecosta County,0,43545,21849,21696
Michigan,Mecosta County,1,2085,1090,995
Michigan,Mecosta County,2,2154,1083,1071
Michigan,Mecosta County,3,2259,1148,1111
Michigan,Mecosta County,4,4246,2117,2129
Michigan,Mecosta County,5,5408,2952,2456
Michigan,Mecosta County,6,2630,1401,1229
Michigan,Mecosta County,7,2130,1065,1065
Michigan,Mecosta County,8,2081,1067,1014
Michigan,Mecosta County,9,1990,987,1003
Michigan,Mecosta County,10,2179,1085,1094
Michigan,Mecosta County,11,2471,1222,1249
Michigan,Mecosta County,12,3006,1502,1504
Michigan,Mecosta County,13,2931,1414,1517
Michigan,Mecosta County,14,2651,1301,1350
Michigan,Mecosta County,15,2055,1003,1052
Michigan,Mecosta County,16,1582,750,832
Michigan,Mecosta County,17,909,390,519
Michigan,Mecosta County,18,778,272,506
Michigan,Menominee County,0,22983,11696,11287
Michigan,Menominee County,1,1044,563,481
Michigan,Menominee County,2,1084,547,537
Michigan,Menominee County,3,1234,648,586
Michigan,Menominee County,4,1287,675,612
Michigan,Menominee County,5,1064,557,507
Michigan,Menominee County,6,1154,615,539
Michigan,Menominee County,7,1082,575,507
Michigan,Menominee County,8,1212,654,558
Michigan,Menominee County,9,1209,630,579
Michigan,Menominee County,10,1318,678,640
Michigan,Menominee County,11,1663,856,807
Michigan,Menominee County,12,1922,956,966
Michigan,Menominee County,13,2058,1047,1011
Michigan,Menominee County,14,1798,901,897
Michigan,Menominee County,15,1400,697,703
Michigan,Menominee County,16,1005,479,526
Michigan,Menominee County,17,677,322,355
Michigan,Menominee County,18,772,296,476
Michigan,Midland County,0,83209,41035,42174
Michigan,Midland County,1,4486,2277,2209
Michigan,Midland County,2,4725,2488,2237
Michigan,Midland County,3,5123,2564,2559
Michigan,Midland County,4,5400,2836,2564
Michigan,Midland County,5,4850,2464,2386
Michigan,Midland County,6,5231,2685,2546
Michigan,Midland County,7,5119,2651,2468
Michigan,Midland County,8,5059,2527,2532
Michigan,Midland County,9,4752,2354,2398
Michigan,Midland County,10,5074,2493,2581
Michigan,Midland County,11,6042,2997,3045
Michigan,Midland County,12,6331,3150,3181
Michigan,Midland County,13,5741,2801,2940
Michigan,Midland County,14,4803,2267,2536
Michigan,Midland County,15,3543,1627,1916
Michigan,Midland County,16,2739,1211,1528
Michigan,Midland County,17,2009,853,1156
Michigan,Midland County,18,2182,790,1392
Michigan,Missaukee County,0,15113,7682,7431
Michigan,Missaukee County,1,950,497,453
Michigan,Missaukee County,2,961,477,484
Michigan,Missaukee County,3,968,500,468
Michigan,Missaukee County,4,891,481,410
Michigan,Missaukee County,5,787,433,354
Michigan,Missaukee County,6,904,470,434
Michigan,Missaukee County,7,819,418,401
Michigan,Missaukee County,8,830,409,421
Michigan,Missaukee County,9,705,350,355
Michigan,Missaukee County,10,868,450,418
Michigan,Missaukee County,11,995,479,516
Michigan,Missaukee County,12,1156,607,549
Michigan,Missaukee County,13,1180,613,567
Michigan,Missaukee County,14,991,500,491
Michigan,Missaukee County,15,821,416,405
Michigan,Missaukee County,16,569,286,283
Michigan,Missaukee County,17,389,171,218
Michigan,Missaukee County,18,329,125,204
Michigan,Monroe County,0,150439,74251,76188
Michigan,Monroe County,1,7985,4125,3860
Michigan,Monroe County,2,8693,4457,4236
Michigan,Monroe County,3,9356,4690,4666
Michigan,Monroe County,4,9393,4808,4585
Michigan,Monroe County,5,8585,4396,4189
Michigan,Monroe County,6,9313,4757,4556
Michigan,Monroe County,7,8315,4157,4158
Michigan,Monroe County,8,8703,4342,4361
Michigan,Monroe County,9,8765,4305,4460
Michigan,Monroe County,10,9887,4954,4933
Michigan,Monroe County,11,10876,5370,5506
Michigan,Monroe County,12,11971,5948,6023
Michigan,Monroe County,13,11335,5610,5725
Michigan,Monroe County,14,9265,4587,4678
Michigan,Monroe County,15,6718,3194,3524
Michigan,Monroe County,16,4875,2175,2700
Michigan,Monroe County,17,3114,1304,1810
Michigan,Monroe County,18,3290,1072,2218
Michigan,Montcalm County,0,63968,33093,30875
Michigan,Montcalm County,1,3667,1833,1834
Michigan,Montcalm County,2,3960,2031,1929
Michigan,Montcalm County,3,4107,2118,1989
Michigan,Montcalm County,4,3873,2057,1816
Michigan,Montcalm County,5,3721,2086,1635
Michigan,Montcalm County,6,4156,2231,1925
Michigan,Montcalm County,7,3830,2093,1737
Michigan,Montcalm County,8,3946,2100,1846
Michigan,Montcalm County,9,3718,2051,1667
Michigan,Montcalm County,10,4279,2293,1986
Michigan,Montcalm County,11,4345,2290,2055
Michigan,Montcalm County,12,4649,2451,2198
Michigan,Montcalm County,13,4522,2255,2267
Michigan,Montcalm County,14,3733,1824,1909
Michigan,Montcalm County,15,2845,1384,1461
Michigan,Montcalm County,16,2009,949,1060
Michigan,Montcalm County,17,1382,603,779
Michigan,Montcalm County,18,1226,444,782
Michigan,Montmorency County,0,9265,4722,4543
Michigan,Montmorency County,1,335,166,169
Michigan,Montmorency County,2,357,187,170
Michigan,Montmorency County,3,424,229,195
Michigan,Montmorency County,4,425,238,187
Michigan,Montmorency County,5,335,168,167
Michigan,Montmorency County,6,349,184,165
Michigan,Montmorency County,7,358,182,176
Michigan,Montmorency County,8,382,184,198
Michigan,Montmorency County,9,377,202,175
Michigan,Montmorency County,10,478,258,220
Michigan,Montmorency County,11,614,294,320
Michigan,Montmorency County,12,790,374,416
Michigan,Montmorency County,13,1049,531,518
Michigan,Montmorency County,14,1018,539,479
Michigan,Montmorency County,15,745,400,345
Michigan,Montmorency County,16,561,275,286
Michigan,Montmorency County,17,360,191,169
Michigan,Montmorency County,18,308,120,188
Michigan,Muskegon County,0,173588,86240,87348
Michigan,Muskegon County,1,10560,5371,5189
Michigan,Muskegon County,2,11142,5618,5524
Michigan,Muskegon County,3,11372,5790,5582
Michigan,Muskegon County,4,10862,5587,5275
Michigan,Muskegon County,5,10430,5438,4992
Michigan,Muskegon County,6,11952,6246,5706
Michigan,Muskegon County,7,10736,5513,5223
Michigan,Muskegon County,8,10898,5440,5458
Michigan,Muskegon County,9,9988,5091,4897
Michigan,Muskegon County,10,10385,5345,5040
Michigan,Muskegon County,11,10988,5521,5467
Michigan,Muskegon County,12,12575,6123,6452
Michigan,Muskegon County,13,12176,5955,6221
Michigan,Muskegon County,14,10093,4830,5263
Michigan,Muskegon County,15,7568,3522,4046
Michigan,Muskegon County,16,4997,2266,2731
Michigan,Muskegon County,17,3352,1366,1986
Michigan,Muskegon County,18,3514,1218,2296
Michigan,Newaygo County,0,48892,24542,24350
Michigan,Newaygo County,1,2854,1388,1466
Michigan,Newaygo County,2,2889,1503,1386
Michigan,Newaygo County,3,3303,1680,1623
Michigan,Newaygo County,4,2990,1552,1438
Michigan,Newaygo County,5,2572,1356,1216
Michigan,Newaygo County,6,3000,1554,1446
Michigan,Newaygo County,7,2675,1341,1334
Michigan,Newaygo County,8,2697,1327,1370
Michigan,Newaygo County,9,2567,1316,1251
Michigan,Newaygo County,10,2850,1426,1424
Michigan,Newaygo County,11,3344,1640,1704
Michigan,Newaygo County,12,4038,2048,1990
Michigan,Newaygo County,13,3756,1881,1875
Michigan,Newaygo County,14,3155,1601,1554
Michigan,Newaygo County,15,2352,1188,1164
Michigan,Newaygo County,16,1750,820,930
Michigan,Newaygo County,17,1128,560,568
Michigan,Newaygo County,18,972,361,611
Michigan,Oakland County,0,1259201,617094,642107
Michigan,Oakland County,1,68615,35299,33316
Michigan,Oakland County,2,70392,35916,34476
Michigan,Oakland County,3,76077,38798,37279
Michigan,Oakland County,4,76678,39359,37319
Michigan,Oakland County,5,74356,38282,36074
Michigan,Oakland County,6,87139,45541,41598
Michigan,Oakland County,7,80386,40955,39431
Michigan,Oakland County,8,80321,40092,40229
Michigan,Oakland County,9,76825,37818,39007
Michigan,Oakland County,10,87655,42619,45036
Michigan,Oakland County,11,89224,43366,45858
Michigan,Oakland County,12,93481,45305,48176
Michigan,Oakland County,13,86525,41119,45406
Michigan,Oakland County,14,70464,32849,37615
Michigan,Oakland County,15,54178,24740,29438
Michigan,Oakland County,16,36484,16348,20136
Michigan,Oakland County,17,22851,9358,13493
Michigan,Oakland County,18,27550,9330,18220
Michigan,Oceana County,0,26625,13491,13134
Michigan,Oceana County,1,1492,746,746
Michigan,Oceana County,2,1729,839,890
Michigan,Oceana County,3,1809,979,830
Michigan,Oceana County,4,1654,888,766
Michigan,Oceana County,5,1480,793,687
Michigan,Oceana County,6,1442,780,662
Michigan,Oceana County,7,1386,716,670
Michigan,Oceana County,8,1443,717,726
Michigan,Oceana County,9,1368,674,694
Michigan,Oceana County,10,1463,741,722
Michigan,Oceana County,11,1734,897,837
Michigan,Oceana County,12,2097,1081,1016
Michigan,Oceana County,13,2049,995,1054
Michigan,Oceana County,14,1811,899,912
Michigan,Oceana County,15,1405,682,723
Michigan,Oceana County,16,1055,537,518
Michigan,Oceana County,17,658,304,354
Michigan,Oceana County,18,550,223,327
Michigan,Ogemaw County,0,20952,10439,10513
Michigan,Ogemaw County,1,940,482,458
Michigan,Ogemaw County,2,1069,540,529
Michigan,Ogemaw County,3,1140,584,556
Michigan,Ogemaw County,4,1115,554,561
Michigan,Ogemaw County,5,939,509,430
Michigan,Ogemaw County,6,1070,530,540
Michigan,Ogemaw County,7,952,469,483
Michigan,Ogemaw County,8,1043,542,501
Michigan,Ogemaw County,9,964,483,481
Michigan,Ogemaw County,10,1137,564,573
Michigan,Ogemaw County,11,1314,660,654
Michigan,Ogemaw County,12,1812,872,940
Michigan,Ogemaw County,13,2043,1033,1010
Michigan,Ogemaw County,14,1743,873,870
Michigan,Ogemaw County,15,1350,667,683
Michigan,Ogemaw County,16,1122,540,582
Michigan,Ogemaw County,17,629,327,302
Michigan,Ogemaw County,18,570,210,360
Michigan,Ontonagon County,0,5795,2943,2852
Michigan,Ontonagon County,1,154,78,76
Michigan,Ontonagon County,2,177,99,78
Michigan,Ontonagon County,3,257,131,126
Michigan,Ontonagon County,4,236,116,120
Michigan,Ontonagon County,5,190,91,99
Michigan,Ontonagon County,6,145,84,61
Michigan,Ontonagon County,7,169,91,78
Michigan,Ontonagon County,8,210,105,105
Michigan,Ontonagon County,9,221,113,108
Michigan,Ontonagon County,10,319,161,158
Michigan,Ontonagon County,11,414,198,216
Michigan,Ontonagon County,12,572,284,288
Michigan,Ontonagon County,13,634,318,316
Michigan,Ontonagon County,14,678,371,307
Michigan,Ontonagon County,15,533,280,253
Michigan,Ontonagon County,16,405,208,197
Michigan,Ontonagon County,17,290,148,142
Michigan,Ontonagon County,18,191,67,124
Michigan,Osceola County,0,23341,11772,11569
Michigan,Osceola County,1,1251,638,613
Michigan,Osceola County,2,1387,736,651
Michigan,Osceola County,3,1527,806,721
Michigan,Osceola County,4,1529,815,714
Michigan,Osceola County,5,1151,583,568
Michigan,Osceola County,6,1357,708,649
Michigan,Osceola County,7,1233,620,613
Michigan,Osceola County,8,1305,647,658
Michigan,Osceola County,9,1197,597,600
Michigan,Osceola County,10,1342,689,653
Michigan,Osceola County,11,1544,813,731
Michigan,Osceola County,12,1775,897,878
Michigan,Osceola County,13,1796,864,932
Michigan,Osceola County,14,1585,780,805
Michigan,Osceola County,15,1302,661,641
Michigan,Osceola County,16,925,448,477
Michigan,Osceola County,17,651,295,356
Michigan,Osceola County,18,484,175,309
Michigan,Oscoda County,0,8276,4242,4034
Michigan,Oscoda County,1,474,232,242
Michigan,Oscoda County,2,418,230,188
Michigan,Oscoda County,3,442,249,193
Michigan,Oscoda County,4,412,237,175
Michigan,Oscoda County,5,358,175,183
Michigan,Oscoda County,6,373,182,191
Michigan,Oscoda County,7,354,184,170
Michigan,Oscoda County,8,369,181,188
Michigan,Oscoda County,9,324,159,165
Michigan,Oscoda County,10,387,198,189
Michigan,Oscoda County,11,471,243,228
Michigan,Oscoda County,12,785,404,381
Michigan,Oscoda County,13,857,411,446
Michigan,Oscoda County,14,740,389,351
Michigan,Oscoda County,15,576,313,263
Michigan,Oscoda County,16,452,226,226
Michigan,Oscoda County,17,271,146,125
Michigan,Oscoda County,18,213,83,130
Michigan,Otsego County,0,24665,12228,12437
Michigan,Otsego County,1,1313,683,630
Michigan,Otsego County,2,1475,767,708
Michigan,Otsego County,3,1486,748,738
Michigan,Otsego County,4,1482,749,733
Michigan,Otsego County,5,1350,652,698
Michigan,Otsego County,6,1490,768,722
Michigan,Otsego County,7,1308,654,654
Michigan,Otsego County,8,1317,644,673
Michigan,Otsego County,9,1210,594,616
Michigan,Otsego County,10,1491,720,771
Michigan,Otsego County,11,1796,928,868
Michigan,Otsego County,12,1851,900,951
Michigan,Otsego County,13,1883,975,908
Michigan,Otsego County,14,1748,849,899
Michigan,Otsego County,15,1332,655,677
Michigan,Otsego County,16,910,422,488
Michigan,Otsego County,17,627,294,333
Michigan,Otsego County,18,596,226,370
Michigan,Ottawa County,0,290494,143564,146930
Michigan,Ottawa County,1,18047,9369,8678
Michigan,Ottawa County,2,19549,10014,9535
Michigan,Ottawa County,3,20223,10290,9933
Michigan,Ottawa County,4,24112,11682,12430
Michigan,Ottawa County,5,26577,13373,13204
Michigan,Ottawa County,6,18338,9264,9074
Michigan,Ottawa County,7,17094,8652,8442
Michigan,Ottawa County,8,18050,8982,9068
Michigan,Ottawa County,9,16272,8178,8094
Michigan,Ottawa County,10,16438,8231,8207
Michigan,Ottawa County,11,17317,8590,8727
Michigan,Ottawa County,12,18297,9008,9289
Michigan,Ottawa County,13,16688,8185,8503
Michigan,Ottawa County,14,14162,6767,7395
Michigan,Ottawa County,15,10812,5130,5682
Michigan,Ottawa County,16,7803,3592,4211
Michigan,Ottawa County,17,5140,2257,2883
Michigan,Ottawa County,18,5575,2000,3575
Michigan,Presque Isle County,0,12738,6334,6404
Michigan,Presque Isle County,1,521,256,265
Michigan,Presque Isle County,2,523,262,261
Michigan,Presque Isle County,3,582,286,296
Michigan,Presque Isle County,4,619,314,305
Michigan,Presque Isle County,5,534,261,273
Michigan,Presque Isle County,6,498,241,257
Michigan,Presque Isle County,7,468,244,224
Michigan,Presque Isle County,8,568,277,291
Michigan,Presque Isle County,9,571,286,285
Michigan,Presque Isle County,10,662,338,324
Michigan,Presque Isle County,11,760,369,391
Michigan,Presque Isle County,12,1115,548,567
Michigan,Presque Isle County,13,1316,657,659
Michigan,Presque Isle County,14,1314,682,632
Michigan,Presque Isle County,15,958,486,472
Michigan,Presque Isle County,16,747,383,364
Michigan,Presque Isle County,17,460,219,241
Michigan,Presque Isle County,18,522,225,297
Michigan,Roscommon County,0,23884,11957,11927
Michigan,Roscommon County,1,854,437,417
Michigan,Roscommon County,2,954,503,451
Michigan,Roscommon County,3,1071,542,529
Michigan,Roscommon County,4,998,538,460
Michigan,Roscommon County,5,881,451,430
Michigan,Roscommon County,6,970,493,477
Michigan,Roscommon County,7,950,449,501
Michigan,Roscommon County,8,948,492,456
Michigan,Roscommon County,9,934,455,479
Michigan,Roscommon County,10,1241,611,630
Michigan,Roscommon County,11,1509,737,772
Michigan,Roscommon County,12,2103,1040,1063
Michigan,Roscommon County,13,2698,1310,1388
Michigan,Roscommon County,14,2501,1257,1244
Michigan,Roscommon County,15,2125,1124,1001
Michigan,Roscommon County,16,1501,760,741
Michigan,Roscommon County,17,957,460,497
Michigan,Roscommon County,18,689,298,391
Michigan,Saginaw County,0,190800,92674,98126
Michigan,Saginaw County,1,10920,5547,5373
Michigan,Saginaw County,2,10937,5667,5270
Michigan,Saginaw County,3,11519,5884,5635
Michigan,Saginaw County,4,12825,6466,6359
Michigan,Saginaw County,5,12498,6387,6111
Michigan,Saginaw County,6,13128,6656,6472
Michigan,Saginaw County,7,10696,5364,5332
Michigan,Saginaw County,8,10604,5249,5355
Michigan,Saginaw County,9,10157,5034,5123
Michigan,Saginaw County,10,11402,5479,5923
Michigan,Saginaw County,11,12373,6112,6261
Michigan,Saginaw County,12,13626,6529,7097
Michigan,Saginaw County,13,13332,6232,7100
Michigan,Saginaw County,14,11813,5501,6312
Michigan,Saginaw County,15,9046,4168,4878
Michigan,Saginaw County,16,6509,2878,3631
Michigan,Saginaw County,17,4437,1813,2624
Michigan,Saginaw County,18,4978,1708,3270
Michigan,St. Clair County,0,159337,79205,80132
Michigan,St. Clair County,1,8025,4156,3869
Michigan,St. Clair County,2,8738,4463,4275
Michigan,St. Clair County,3,9957,5152,4805
Michigan,St. Clair County,4,9876,5141,4735
Michigan,St. Clair County,5,9006,4717,4289
Michigan,St. Clair County,6,9335,4821,4514
Michigan,St. Clair County,7,8321,4211,4110
Michigan,St. Clair County,8,8834,4349,4485
Michigan,St. Clair County,9,8887,4386,4501
Michigan,St. Clair County,10,10839,5351,5488
Michigan,St. Clair County,11,12234,6145,6089
Michigan,St. Clair County,12,13101,6546,6555
Michigan,St. Clair County,13,12162,6005,6157
Michigan,St. Clair County,14,10102,4930,5172
Michigan,St. Clair County,15,7635,3654,3981
Michigan,St. Clair County,16,5447,2501,2946
Michigan,St. Clair County,17,3349,1429,1920
Michigan,St. Clair County,18,3489,1248,2241
Michigan,St. Joseph County,0,61043,30446,30597
Michigan,St. Joseph County,1,3946,2070,1876
Michigan,St. Joseph County,2,4080,2087,1993
Michigan,St. Joseph County,3,4334,2210,2124
Michigan,St. Joseph County,4,3922,1997,1925
Michigan,St. Joseph County,5,3468,1800,1668
Michigan,St. Joseph County,6,3785,1967,1818
Michigan,St. Joseph County,7,3533,1758,1775
Michigan,St. Joseph County,8,3538,1792,1746
Michigan,St. Joseph County,9,3400,1682,1718
Michigan,St. Joseph County,10,3545,1853,1692
Michigan,St. Joseph County,11,3871,1967,1904
Michigan,St. Joseph County,12,4393,2178,2215
Michigan,St. Joseph County,13,4245,2101,2144
Michigan,St. Joseph County,14,3663,1752,1911
Michigan,St. Joseph County,15,2733,1295,1438
Michigan,St. Joseph County,16,1947,912,1035
Michigan,St. Joseph County,17,1310,560,750
Michigan,St. Joseph County,18,1330,465,865
Michigan,Sanilac County,0,41182,20546,20636
Michigan,Sanilac County,1,2215,1148,1067
Michigan,Sanilac County,2,2378,1196,1182
Michigan,Sanilac County,3,2606,1329,1277
Michigan,Sanilac County,4,2486,1261,1225
Michigan,Sanilac County,5,2191,1159,1032
Michigan,Sanilac County,6,2175,1101,1074
Michigan,Sanilac County,7,2042,1055,987
Michigan,Sanilac County,8,2200,1127,1073
Michigan,Sanilac County,9,2163,1073,1090
Michigan,Sanilac County,10,2447,1216,1231
Michigan,Sanilac County,11,2802,1374,1428
Michigan,Sanilac County,12,3282,1673,1609
Michigan,Sanilac County,13,3376,1674,1702
Michigan,Sanilac County,14,2904,1445,1459
Michigan,Sanilac County,15,2152,1033,1119
Michigan,Sanilac County,16,1662,776,886
Michigan,Sanilac County,17,1149,512,637
Michigan,Sanilac County,18,952,394,558
Michigan,Schoolcraft County,0,8068,3980,4088
Michigan,Schoolcraft County,1,323,159,164
Michigan,Schoolcraft County,2,389,186,203
Michigan,Schoolcraft County,3,410,221,189
Michigan,Schoolcraft County,4,395,212,183
Michigan,Schoolcraft County,5,373,192,181
Michigan,Schoolcraft County,6,335,170,165
Michigan,Schoolcraft County,7,304,154,150
Michigan,Schoolcraft County,8,358,180,178
Michigan,Schoolcraft County,9,395,193,202
Michigan,Schoolcraft County,10,504,250,254
Michigan,Schoolcraft County,11,518,263,255
Michigan,Schoolcraft County,12,784,362,422
Michigan,Schoolcraft County,13,818,399,419
Michigan,Schoolcraft County,14,716,377,339
Michigan,Schoolcraft County,15,533,265,268
Michigan,Schoolcraft County,16,386,198,188
Michigan,Schoolcraft County,17,268,106,162
Michigan,Schoolcraft County,18,259,93,166
Michigan,Shiawassee County,0,68192,33706,34486
Michigan,Shiawassee County,1,3692,1880,1812
Michigan,Shiawassee County,2,3692,1909,1783
Michigan,Shiawassee County,3,4234,2180,2054
Michigan,Shiawassee County,4,4494,2276,2218
Michigan,Shiawassee County,5,4009,2026,1983
Michigan,Shiawassee County,6,4249,2185,2064
Michigan,Shiawassee County,7,3675,1892,1783
Michigan,Shiawassee County,8,3922,1939,1983
Michigan,Shiawassee County,9,3798,1915,1883
Michigan,Shiawassee County,10,4443,2242,2201
Michigan,Shiawassee County,11,4975,2492,2483
Michigan,Shiawassee County,12,5388,2653,2735
Michigan,Shiawassee County,13,5098,2456,2642
Michigan,Shiawassee County,14,4167,1967,2200
Michigan,Shiawassee County,15,3250,1557,1693
Michigan,Shiawassee County,16,2241,1019,1222
Michigan,Shiawassee County,17,1483,634,849
Michigan,Shiawassee County,18,1382,484,898
Michigan,Tuscola County,0,52516,26385,26131
Michigan,Tuscola County,1,2699,1370,1329
Michigan,Tuscola County,2,2760,1444,1316
Michigan,Tuscola County,3,3178,1672,1506
Michigan,Tuscola County,4,3158,1709,1449
Michigan,Tuscola County,5,2841,1450,1391
Michigan,Tuscola County,6,3069,1601,1468
Michigan,Tuscola County,7,2775,1426,1349
Michigan,Tuscola County,8,2975,1504,1471
Michigan,Tuscola County,9,2845,1472,1373
Michigan,Tuscola County,10,3363,1677,1686
Michigan,Tuscola County,11,3712,1848,1864
Michigan,Tuscola County,12,4299,2182,2117
Michigan,Tuscola County,13,4207,2108,2099
Michigan,Tuscola County,14,3372,1634,1738
Michigan,Tuscola County,15,2741,1331,1410
Michigan,Tuscola County,16,2032,934,1098
Michigan,Tuscola County,17,1354,614,740
Michigan,Tuscola County,18,1136,409,727
Michigan,Van Buren County,0,75448,37451,37997
Michigan,Van Buren County,1,4479,2291,2188
Michigan,Van Buren County,2,4789,2458,2331
Michigan,Van Buren County,3,5156,2568,2588
Michigan,Van Buren County,4,4813,2535,2278
Michigan,Van Buren County,5,4188,2153,2035
Michigan,Van Buren County,6,4172,2144,2028
Michigan,Van Buren County,7,4143,2103,2040
Michigan,Van Buren County,8,4554,2251,2303
Michigan,Van Buren County,9,4226,2114,2112
Michigan,Van Buren County,10,4731,2318,2413
Michigan,Van Buren County,11,5002,2471,2531
Michigan,Van Buren County,12,5786,2860,2926
Michigan,Van Buren County,13,5742,2788,2954
Michigan,Van Buren County,14,4868,2375,2493
Michigan,Van Buren County,15,3453,1675,1778
Michigan,Van Buren County,16,2416,1151,1265
Michigan,Van Buren County,17,1433,630,803
Michigan,Van Buren County,18,1497,566,931
Michigan,Washtenaw County,0,370963,184083,186880
Michigan,Washtenaw County,1,18094,9241,8853
Michigan,Washtenaw County,2,18672,9524,9148
Michigan,Washtenaw County,3,19811,10122,9689
Michigan,Washtenaw County,4,33361,16715,16646
Michigan,Washtenaw County,5,48595,24850,23745
Michigan,Washtenaw County,6,30111,15900,14211
Michigan,Washtenaw County,7,23560,12136,11424
Michigan,Washtenaw County,8,22478,11355,11123
Michigan,Washtenaw County,9,19922,9997,9925
Michigan,Washtenaw County,10,21455,10555,10900
Michigan,Washtenaw County,11,21436,10438,10998
Michigan,Washtenaw County,12,21547,10498,11049
Michigan,Washtenaw County,13,20544,9673,10871
Michigan,Washtenaw County,14,17861,8414,9447
Michigan,Washtenaw County,15,13305,6212,7093
Michigan,Washtenaw County,16,8842,4015,4827
Michigan,Washtenaw County,17,5356,2309,3047
Michigan,Washtenaw County,18,6013,2129,3884
Michigan,Wayne County,0,1753893,844609,909284
Michigan,Wayne County,1,114702,58724,55978
Michigan,Wayne County,2,113601,58145,55456
Michigan,Wayne County,3,115104,58549,56555
Michigan,Wayne County,4,111510,56638,54872
Michigan,Wayne County,5,111450,55513,55937
Michigan,Wayne County,6,138845,68450,70395
Michigan,Wayne County,7,110919,54222,56697
Michigan,Wayne County,8,104571,50162,54409
Michigan,Wayne County,9,100762,47448,53314
Michigan,Wayne County,10,114115,55019,59096
Michigan,Wayne County,11,114369,55699,58670
Michigan,Wayne County,12,119575,57696,61879
Michigan,Wayne County,13,113816,53752,60064
Michigan,Wayne County,14,90988,41377,49611
Michigan,Wayne County,15,67414,29942,37472
Michigan,Wayne County,16,45507,19368,26139
Michigan,Wayne County,17,30200,11757,18443
Michigan,Wayne County,18,36445,12148,24297
Michigan,Wexford County,0,33466,16766,16700
Michigan,Wexford County,1,2032,1084,948
Michigan,Wexford County,2,2140,1077,1063
Michigan,Wexford County,3,2302,1133,1169
Michigan,Wexford County,4,1958,997,961
Michigan,Wexford County,5,1765,925,840
Michigan,Wexford County,6,1966,1016,950
Michigan,Wexford County,7,1941,972,969
Michigan,Wexford County,8,1952,989,963
Michigan,Wexford County,9,1760,879,881
Michigan,Wexford County,10,2023,1022,1001
Michigan,Wexford County,11,2213,1134,1079
Michigan,Wexford County,12,2548,1266,1282
Michigan,Wexford County,13,2478,1198,1280
Michigan,Wexford County,14,2075,1033,1042
Michigan,Wexford County,15,1637,840,797
Michigan,Wexford County,16,1208,586,622
Michigan,Wexford County,17,692,314,378
Michigan,Wexford County,18,776,301,475
Minnesota,Aitkin County,0,15902,8034,7868
Minnesota,Aitkin County,1,594,302,292
Minnesota,Aitkin County,2,737,411,326
Minnesota,Aitkin County,3,858,432,426
Minnesota,Aitkin County,4,704,364,340
Minnesota,Aitkin County,5,595,288,307
Minnesota,Aitkin County,6,612,303,309
Minnesota,Aitkin County,7,609,301,308
Minnesota,Aitkin County,8,707,363,344
Minnesota,Aitkin County,9,612,314,298
Minnesota,Aitkin County,10,767,388,379
Minnesota,Aitkin County,11,953,474,479
Minnesota,Aitkin County,12,1361,683,678
Minnesota,Aitkin County,13,1542,785,757
Minnesota,Aitkin County,14,1580,807,773
Minnesota,Aitkin County,15,1398,711,687
Minnesota,Aitkin County,16,1096,558,538
Minnesota,Aitkin County,17,642,328,314
Minnesota,Aitkin County,18,535,222,313
Minnesota,Anoka County,0,353813,176976,176837
Minnesota,Anoka County,1,22201,11299,10902
Minnesota,Anoka County,2,23033,11831,11202
Minnesota,Anoka County,3,24376,12390,11986
Minnesota,Anoka County,4,22278,11475,10803
Minnesota,Anoka County,5,19918,10257,9661
Minnesota,Anoka County,6,22328,11468,10860
Minnesota,Anoka County,7,24415,12400,12015
Minnesota,Anoka County,8,24985,12690,12295
Minnesota,Anoka County,9,22039,11263,10776
Minnesota,Anoka County,10,23771,11987,11784
Minnesota,Anoka County,11,25178,12530,12648
Minnesota,Anoka County,12,27350,13739,13611
Minnesota,Anoka County,13,22229,11030,11199
Minnesota,Anoka County,14,17387,8328,9059
Minnesota,Anoka County,15,13025,6099,6926
Minnesota,Anoka County,16,8757,4028,4729
Minnesota,Anoka County,17,5443,2245,3198
Minnesota,Anoka County,18,5100,1917,3183
Minnesota,Becker County,0,34371,17140,17231
Minnesota,Becker County,1,2133,1090,1043
Minnesota,Becker County,2,2330,1121,1209
Minnesota,Becker County,3,2481,1271,1210
Minnesota,Becker County,4,2165,1129,1036
Minnesota,Becker County,5,1786,861,925
Minnesota,Becker County,6,1758,872,886
Minnesota,Becker County,7,1804,888,916
Minnesota,Becker County,8,2030,1043,987
Minnesota,Becker County,9,1858,957,901
Minnesota,Becker County,10,1745,888,857
Minnesota,Becker County,11,2048,1048,1000
Minnesota,Becker County,12,2485,1266,1219
Minnesota,Becker County,13,2696,1342,1354
Minnesota,Becker County,14,2378,1185,1193
Minnesota,Becker County,15,1790,900,890
Minnesota,Becker County,16,1224,595,629
Minnesota,Becker County,17,848,376,472
Minnesota,Becker County,18,812,308,504
Minnesota,Beltrami County,0,46847,23406,23441
Minnesota,Beltrami County,1,3318,1745,1573
Minnesota,Beltrami County,2,3507,1773,1734
Minnesota,Beltrami County,3,3198,1674,1524
Minnesota,Beltrami County,4,3574,1843,1731
Minnesota,Beltrami County,5,4447,2289,2158
Minnesota,Beltrami County,6,3055,1568,1487
Minnesota,Beltrami County,7,2797,1447,1350
Minnesota,Beltrami County,8,2791,1384,1407
Minnesota,Beltrami County,9,2259,1154,1105
Minnesota,Beltrami County,10,2226,1081,1145
Minnesota,Beltrami County,11,2405,1153,1252
Minnesota,Beltrami County,12,2901,1406,1495
Minnesota,Beltrami County,13,2821,1374,1447
Minnesota,Beltrami County,14,2499,1224,1275
Minnesota,Beltrami County,15,1811,896,915
Minnesota,Beltrami County,16,1288,582,706
Minnesota,Beltrami County,17,912,412,500
Minnesota,Beltrami County,18,1038,401,637
Minnesota,Benton County,0,40545,20233,20312
Minnesota,Benton County,1,2938,1560,1378
Minnesota,Benton County,2,2834,1425,1409
Minnesota,Benton County,3,2885,1445,1440
Minnesota,Benton County,4,2430,1211,1219
Minnesota,Benton County,5,2451,1198,1253
Minnesota,Benton County,6,2915,1454,1461
Minnesota,Benton County,7,3070,1548,1522
Minnesota,Benton County,8,3122,1623,1499
Minnesota,Benton County,9,2418,1240,1178
Minnesota,Benton County,10,2421,1234,1187
Minnesota,Benton County,11,2536,1302,1234
Minnesota,Benton County,12,2661,1340,1321
Minnesota,Benton County,13,2155,1110,1045
Minnesota,Benton County,14,1806,888,918
Minnesota,Benton County,15,1306,614,692
Minnesota,Benton County,16,897,420,477
Minnesota,Benton County,17,695,297,398
Minnesota,Benton County,18,1005,324,681
Minnesota,Big Stone County,0,4989,2475,2514
Minnesota,Big Stone County,1,277,156,121
Minnesota,Big Stone County,2,302,158,144
Minnesota,Big Stone County,3,296,143,153
Minnesota,Big Stone County,4,253,127,126
Minnesota,Big Stone County,5,236,125,111
Minnesota,Big Stone County,6,245,119,126
Minnesota,Big Stone County,7,237,132,105
Minnesota,Big Stone County,8,269,141,128
Minnesota,Big Stone County,9,182,86,96
Minnesota,Big Stone County,10,239,123,116
Minnesota,Big Stone County,11,288,133,155
Minnesota,Big Stone County,12,443,240,203
Minnesota,Big Stone County,13,398,205,193
Minnesota,Big Stone County,14,361,179,182
Minnesota,Big Stone County,15,254,124,130
Minnesota,Big Stone County,16,251,106,145
Minnesota,Big Stone County,17,190,81,109
Minnesota,Big Stone County,18,268,97,171
Minnesota,Blue Earth County,0,67427,33935,33492
Minnesota,Blue Earth County,1,3689,1945,1744
Minnesota,Blue Earth County,2,3724,1970,1754
Minnesota,Blue Earth County,3,3689,1899,1790
Minnesota,Blue Earth County,4,5766,2780,2986
Minnesota,Blue Earth County,5,10842,5438,5404
Minnesota,Blue Earth County,6,4986,2772,2214
Minnesota,Blue Earth County,7,4262,2230,2032
Minnesota,Blue Earth County,8,4078,2149,1929
Minnesota,Blue Earth County,9,3338,1720,1618
Minnesota,Blue Earth County,10,3088,1551,1537
Minnesota,Blue Earth County,11,3312,1701,1611
Minnesota,Blue Earth County,12,3636,1768,1868
Minnesota,Blue Earth County,13,3649,1799,1850
Minnesota,Blue Earth County,14,3059,1524,1535
Minnesota,Blue Earth County,15,2103,1009,1094
Minnesota,Blue Earth County,16,1586,740,846
Minnesota,Blue Earth County,17,1159,463,696
Minnesota,Blue Earth County,18,1461,477,984
Minnesota,Brown County,0,25111,12509,12602
Minnesota,Brown County,1,1407,749,658
Minnesota,Brown County,2,1527,815,712
Minnesota,Brown County,3,1620,849,771
Minnesota,Brown County,4,1676,868,808
Minnesota,Brown County,5,1710,887,823
Minnesota,Brown County,6,1292,651,641
Minnesota,Brown County,7,1375,696,679
Minnesota,Brown County,8,1502,783,719
Minnesota,Brown County,9,1213,613,600
Minnesota,Brown County,10,1275,632,643
Minnesota,Brown County,11,1487,743,744
Minnesota,Brown County,12,1921,934,987
Minnesota,Brown County,13,1863,906,957
Minnesota,Brown County,14,1474,768,706
Minnesota,Brown County,15,1151,552,599
Minnesota,Brown County,16,908,412,496
Minnesota,Brown County,17,713,314,399
Minnesota,Brown County,18,997,337,660
Minnesota,Carlton County,0,35837,18690,17147
Minnesota,Carlton County,1,1870,944,926
Minnesota,Carlton County,2,2281,1162,1119
Minnesota,Carlton County,3,2456,1261,1195
Minnesota,Carlton County,4,2178,1171,1007
Minnesota,Carlton County,5,1924,1107,817
Minnesota,Carlton County,6,2131,1200,931
Minnesota,Carlton County,7,2253,1259,994
Minnesota,Carlton County,8,2375,1308,1067
Minnesota,Carlton County,9,2180,1170,1010
Minnesota,Carlton County,10,2370,1297,1073
Minnesota,Carlton County,11,2440,1311,1129
Minnesota,Carlton County,12,2671,1375,1296
Minnesota,Carlton County,13,2572,1296,1276
Minnesota,Carlton County,14,1987,1004,983
Minnesota,Carlton County,15,1443,719,724
Minnesota,Carlton County,16,1096,509,587
Minnesota,Carlton County,17,804,353,451
Minnesota,Carlton County,18,806,244,562
Minnesota,Carver County,0,103551,51395,52156
Minnesota,Carver County,1,6799,3480,3319
Minnesota,Carver County,2,7684,3940,3744
Minnesota,Carver County,3,8235,4191,4044
Minnesota,Carver County,4,7624,3903,3721
Minnesota,Carver County,5,5731,2835,2896
Minnesota,Carver County,6,4683,2276,2407
Minnesota,Carver County,7,6298,3094,3204
Minnesota,Carver County,8,7756,3905,3851
Minnesota,Carver County,9,7128,3511,3617
Minnesota,Carver County,10,7482,3760,3722
Minnesota,Carver County,11,7877,3899,3978
Minnesota,Carver County,12,7738,3872,3866
Minnesota,Carver County,13,6073,3107,2966
Minnesota,Carver County,14,4403,2131,2272
Minnesota,Carver County,15,3058,1460,1598
Minnesota,Carver County,16,2041,927,1114
Minnesota,Carver County,17,1379,590,789
Minnesota,Carver County,18,1562,514,1048
Minnesota,Cass County,0,29519,15078,14441
Minnesota,Cass County,1,1618,862,756
Minnesota,Cass County,2,1724,929,795
Minnesota,Cass County,3,1846,963,883
Minnesota,Cass County,4,1568,806,762
Minnesota,Cass County,5,1257,629,628
Minnesota,Cass County,6,1318,646,672
Minnesota,Cass County,7,1422,724,698
Minnesota,Cass County,8,1452,748,704
Minnesota,Cass County,9,1382,728,654
Minnesota,Cass County,10,1511,748,763
Minnesota,Cass County,11,1761,899,862
Minnesota,Cass County,12,2445,1227,1218
Minnesota,Cass County,13,2556,1285,1271
Minnesota,Cass County,14,2559,1320,1239
Minnesota,Cass County,15,1987,1018,969
Minnesota,Cass County,16,1556,823,733
Minnesota,Cass County,17,817,431,386
Minnesota,Cass County,18,740,292,448
Minnesota,Chippewa County,0,11924,5986,5938
Minnesota,Chippewa County,1,816,404,412
Minnesota,Chippewa County,2,788,411,377
Minnesota,Chippewa County,3,791,403,388
Minnesota,Chippewa County,4,637,316,321
Minnesota,Chippewa County,5,698,423,275
Minnesota,Chippewa County,6,689,354,335
Minnesota,Chippewa County,7,676,372,304
Minnesota,Chippewa County,8,733,383,350
Minnesota,Chippewa County,9,567,287,280
Minnesota,Chippewa County,10,577,289,288
Minnesota,Chippewa County,11,727,353,374
Minnesota,Chippewa County,12,837,418,419
Minnesota,Chippewa County,13,862,422,440
Minnesota,Chippewa County,14,756,380,376
Minnesota,Chippewa County,15,556,259,297
Minnesota,Chippewa County,16,466,218,248
Minnesota,Chippewa County,17,318,145,173
Minnesota,Chippewa County,18,430,149,281
Minnesota,Chisago County,0,55922,28861,27061
Minnesota,Chisago County,1,3253,1680,1573
Minnesota,Chisago County,2,3433,1759,1674
Minnesota,Chisago County,3,3731,1908,1823
Minnesota,Chisago County,4,3535,1836,1699
Minnesota,Chisago County,5,3027,1663,1364
Minnesota,Chisago County,6,3339,1840,1499
Minnesota,Chisago County,7,3460,1833,1627
Minnesota,Chisago County,8,3772,2043,1729
Minnesota,Chisago County,9,3247,1695,1552
Minnesota,Chisago County,10,3955,2063,1892
Minnesota,Chisago County,11,4320,2232,2088
Minnesota,Chisago County,12,4521,2322,2199
Minnesota,Chisago County,13,3717,1843,1874
Minnesota,Chisago County,14,2920,1481,1439
Minnesota,Chisago County,15,2259,1121,1138
Minnesota,Chisago County,16,1547,779,768
Minnesota,Chisago County,17,926,418,508
Minnesota,Chisago County,18,960,345,615
Minnesota,Clay County,0,63955,31670,32285
Minnesota,Clay County,1,4755,2519,2236
Minnesota,Clay County,2,4474,2265,2209
Minnesota,Clay County,3,4224,2171,2053
Minnesota,Clay County,4,5145,2406,2739
Minnesota,Clay County,5,6569,3026,3543
Minnesota,Clay County,6,4235,2225,2010
Minnesota,Clay County,7,4563,2371,2192
Minnesota,Clay County,8,4446,2214,2232
Minnesota,Clay County,9,3653,1885,1768
Minnesota,Clay County,10,3407,1740,1667
Minnesota,Clay County,11,3138,1582,1556
Minnesota,Clay County,12,3638,1818,1820
Minnesota,Clay County,13,3295,1639,1656
Minnesota,Clay County,14,2587,1287,1300
Minnesota,Clay County,15,1925,905,1020
Minnesota,Clay County,16,1404,645,759
Minnesota,Clay County,17,1161,514,647
Minnesota,Clay County,18,1336,458,878
Minnesota,Clearwater County,0,8810,4504,4306
Minnesota,Clearwater County,1,545,293,252
Minnesota,Clearwater County,2,632,337,295
Minnesota,Clearwater County,3,649,315,334
Minnesota,Clearwater County,4,537,295,242
Minnesota,Clearwater County,5,420,214,206
Minnesota,Clearwater County,6,462,252,210
Minnesota,Clearwater County,7,450,220,230
Minnesota,Clearwater County,8,512,279,233
Minnesota,Clearwater County,9,499,255,244
Minnesota,Clearwater County,10,479,238,241
Minnesota,Clearwater County,11,504,267,237
Minnesota,Clearwater County,12,691,337,354
Minnesota,Clearwater County,13,648,326,322
Minnesota,Clearwater County,14,532,263,269
Minnesota,Clearwater County,15,412,218,194
Minnesota,Clearwater County,16,340,169,171
Minnesota,Clearwater County,17,261,123,138
Minnesota,Clearwater County,18,237,103,134
Minnesota,Cook County,0,5393,2698,2695
Minnesota,Cook County,1,256,132,124
Minnesota,Cook County,2,229,121,108
Minnesota,Cook County,3,236,123,113
Minnesota,Cook County,4,209,115,94
Minnesota,Cook County,5,224,115,109
Minnesota,Cook County,6,254,128,126
Minnesota,Cook County,7,289,136,153
Minnesota,Cook County,8,274,139,135
Minnesota,Cook County,9,273,151,122
Minnesota,Cook County,10,286,141,145
Minnesota,Cook County,11,334,153,181
Minnesota,Cook County,12,451,219,232
Minnesota,Cook County,13,538,266,272
Minnesota,Cook County,14,565,289,276
Minnesota,Cook County,15,422,218,204
Minnesota,Cook County,16,256,131,125
Minnesota,Cook County,17,134,68,66
Minnesota,Cook County,18,163,53,110
Minnesota,Cottonwood County,0,11277,5636,5641
Minnesota,Cottonwood County,1,773,398,375
Minnesota,Cottonwood County,2,735,397,338
Minnesota,Cottonwood County,3,770,389,381
Minnesota,Cottonwood County,4,698,373,325
Minnesota,Cottonwood County,5,632,333,299
Minnesota,Cottonwood County,6,520,266,254
Minnesota,Cottonwood County,7,555,299,256
Minnesota,Cottonwood County,8,610,308,302
Minnesota,Cottonwood County,9,576,286,290
Minnesota,Cottonwood County,10,593,284,309
Minnesota,Cottonwood County,11,667,329,338
Minnesota,Cottonwood County,12,786,395,391
Minnesota,Cottonwood County,13,790,412,378
Minnesota,Cottonwood County,14,703,340,363
Minnesota,Cottonwood County,15,586,283,303
Minnesota,Cottonwood County,16,455,207,248
Minnesota,Cottonwood County,17,374,173,201
Minnesota,Cottonwood County,18,454,164,290
Minnesota,Crow Wing County,0,64889,32283,32606
Minnesota,Crow Wing County,1,3655,1819,1836
Minnesota,Crow Wing County,2,3873,1959,1914
Minnesota,Crow Wing County,3,4076,2096,1980
Minnesota,Crow Wing County,4,3664,1933,1731
Minnesota,Crow Wing County,5,3146,1592,1554
Minnesota,Crow Wing County,6,3648,1900,1748
Minnesota,Crow Wing County,7,3559,1825,1734
Minnesota,Crow Wing County,8,3959,2017,1942
Minnesota,Crow Wing County,9,3278,1642,1636
Minnesota,Crow Wing County,10,3460,1755,1705
Minnesota,Crow Wing County,11,4055,2031,2024
Minnesota,Crow Wing County,12,4975,2417,2558
Minnesota,Crow Wing County,13,4992,2421,2571
Minnesota,Crow Wing County,14,4562,2261,2301
Minnesota,Crow Wing County,15,3647,1817,1830
Minnesota,Crow Wing County,16,2908,1369,1539
Minnesota,Crow Wing County,17,1674,784,890
Minnesota,Crow Wing County,18,1758,645,1113
Minnesota,Dakota County,0,425423,209855,215568
Minnesota,Dakota County,1,27600,14291,13309
Minnesota,Dakota County,2,28830,14832,13998
Minnesota,Dakota County,3,29598,15177,14421
Minnesota,Dakota County,4,26876,13882,12994
Minnesota,Dakota County,5,24339,12319,12020
Minnesota,Dakota County,6,26354,13477,12877
Minnesota,Dakota County,7,29334,14598,14736
Minnesota,Dakota County,8,30432,15185,15247
Minnesota,Dakota County,9,26530,13227,13303
Minnesota,Dakota County,10,27942,13783,14159
Minnesota,Dakota County,11,29129,14195,14934
Minnesota,Dakota County,12,31608,15385,16223
Minnesota,Dakota County,13,26569,12886,13683
Minnesota,Dakota County,14,20922,9737,11185
Minnesota,Dakota County,15,15287,7009,8278
Minnesota,Dakota County,16,10335,4538,5797
Minnesota,Dakota County,17,6518,2735,3783
Minnesota,Dakota County,18,7220,2599,4621
Minnesota,Dodge County,0,20822,10395,10427
Minnesota,Dodge County,1,1300,665,635
Minnesota,Dodge County,2,1450,733,717
Minnesota,Dodge County,3,1647,833,814
Minnesota,Dodge County,4,1441,739,702
Minnesota,Dodge County,5,1192,582,610
Minnesota,Dodge County,6,1155,600,555
Minnesota,Dodge County,7,1290,626,664
Minnesota,Dodge County,8,1413,720,693
Minnesota,Dodge County,9,1357,687,670
Minnesota,Dodge County,10,1384,717,667
Minnesota,Dodge County,11,1381,686,695
Minnesota,Dodge County,12,1444,726,718
Minnesota,Dodge County,13,1304,658,646
Minnesota,Dodge County,14,1006,520,486
Minnesota,Dodge County,15,733,327,406
Minnesota,Dodge County,16,549,258,291
Minnesota,Dodge County,17,362,170,192
Minnesota,Dodge County,18,414,148,266
Minnesota,Douglas County,0,37964,18993,18971
Minnesota,Douglas County,1,2226,1119,1107
Minnesota,Douglas County,2,2232,1130,1102
Minnesota,Douglas County,3,2412,1245,1167
Minnesota,Douglas County,4,2025,1047,978
Minnesota,Douglas County,5,1944,1016,928
Minnesota,Douglas County,6,2124,1144,980
Minnesota,Douglas County,7,2173,1125,1048
Minnesota,Douglas County,8,2300,1197,1103
Minnesota,Douglas County,9,1945,1008,937
Minnesota,Douglas County,10,2059,1026,1033
Minnesota,Douglas County,11,2224,1124,1100
Minnesota,Douglas County,12,2756,1351,1405
Minnesota,Douglas County,13,2893,1394,1499
Minnesota,Douglas County,14,2644,1365,1279
Minnesota,Douglas County,15,2079,985,1094
Minnesota,Douglas County,16,1564,736,828
Minnesota,Douglas County,17,1116,517,599
Minnesota,Douglas County,18,1248,464,784
Minnesota,Faribault County,0,13758,6875,6883
Minnesota,Faribault County,1,788,405,383
Minnesota,Faribault County,2,814,425,389
Minnesota,Faribault County,3,891,459,432
Minnesota,Faribault County,4,828,430,398
Minnesota,Faribault County,5,677,334,343
Minnesota,Faribault County,6,663,365,298
Minnesota,Faribault County,7,705,354,351
Minnesota,Faribault County,8,803,406,397
Minnesota,Faribault County,9,749,395,354
Minnesota,Faribault County,10,695,362,333
Minnesota,Faribault County,11,839,418,421
Minnesota,Faribault County,12,1007,507,500
Minnesota,Faribault County,13,1159,599,560
Minnesota,Faribault County,14,871,435,436
Minnesota,Faribault County,15,742,373,369
Minnesota,Faribault County,16,546,245,301
Minnesota,Faribault County,17,454,191,263
Minnesota,Faribault County,18,527,172,355
Minnesota,Fillmore County,0,21058,10563,10495
Minnesota,Fillmore County,1,1398,747,651
Minnesota,Fillmore County,2,1446,778,668
Minnesota,Fillmore County,3,1541,780,761
Minnesota,Fillmore County,4,1226,624,602
Minnesota,Fillmore County,5,1002,522,480
Minnesota,Fillmore County,6,1015,497,518
Minnesota,Fillmore County,7,1115,554,561
Minnesota,Fillmore County,8,1307,685,622
Minnesota,Fillmore County,9,1103,556,547
Minnesota,Fillmore County,10,1146,607,539
Minnesota,Fillmore County,11,1283,670,613
Minnesota,Fillmore County,12,1512,746,766
Minnesota,Fillmore County,13,1555,778,777
Minnesota,Fillmore County,14,1313,678,635
Minnesota,Fillmore County,15,1004,478,526
Minnesota,Fillmore County,16,739,356,383
Minnesota,Fillmore County,17,578,249,329
Minnesota,Fillmore County,18,775,258,517
Minnesota,Freeborn County,0,30444,15158,15286
Minnesota,Freeborn County,1,1725,900,825
Minnesota,Freeborn County,2,1845,967,878
Minnesota,Freeborn County,3,1945,998,947
Minnesota,Freeborn County,4,1751,906,845
Minnesota,Freeborn County,5,1492,751,741
Minnesota,Freeborn County,6,1671,814,857
Minnesota,Freeborn County,7,1674,854,820
Minnesota,Freeborn County,8,1809,938,871
Minnesota,Freeborn County,9,1595,831,764
Minnesota,Freeborn County,10,1602,833,769
Minnesota,Freeborn County,11,1902,944,958
Minnesota,Freeborn County,12,2440,1245,1195
Minnesota,Freeborn County,13,2251,1147,1104
Minnesota,Freeborn County,14,1867,924,943
Minnesota,Freeborn County,15,1629,773,856
Minnesota,Freeborn County,16,1196,527,669
Minnesota,Freeborn County,17,985,430,555
Minnesota,Freeborn County,18,1065,376,689
Minnesota,Goodhue County,0,46403,23012,23391
Minnesota,Goodhue County,1,2620,1273,1347
Minnesota,Goodhue County,2,2845,1443,1402
Minnesota,Goodhue County,3,3036,1538,1498
Minnesota,Goodhue County,4,2715,1499,1216
Minnesota,Goodhue County,5,2429,1225,1204
Minnesota,Goodhue County,6,2512,1315,1197
Minnesota,Goodhue County,7,2675,1334,1341
Minnesota,Goodhue County,8,2898,1457,1441
Minnesota,Goodhue County,9,2577,1260,1317
Minnesota,Goodhue County,10,2678,1368,1310
Minnesota,Goodhue County,11,3059,1526,1533
Minnesota,Goodhue County,12,3796,1896,1900
Minnesota,Goodhue County,13,3439,1702,1737
Minnesota,Goodhue County,14,2851,1420,1431
Minnesota,Goodhue County,15,2250,1095,1155
Minnesota,Goodhue County,16,1524,696,828
Minnesota,Goodhue County,17,1130,488,642
Minnesota,Goodhue County,18,1369,477,892
Minnesota,Grant County,0,6021,3023,2998
Minnesota,Grant County,1,376,180,196
Minnesota,Grant County,2,376,199,177
Minnesota,Grant County,3,401,203,198
Minnesota,Grant County,4,306,164,142
Minnesota,Grant County,5,273,136,137
Minnesota,Grant County,6,296,153,143
Minnesota,Grant County,7,333,167,166
Minnesota,Grant County,8,377,194,183
Minnesota,Grant County,9,338,173,165
Minnesota,Grant County,10,293,160,133
Minnesota,Grant County,11,322,163,159
Minnesota,Grant County,12,457,214,243
Minnesota,Grant County,13,472,232,240
Minnesota,Grant County,14,393,201,192
Minnesota,Grant County,15,323,168,155
Minnesota,Grant County,16,272,137,135
Minnesota,Grant County,17,173,84,89
Minnesota,Grant County,18,240,95,145
Minnesota,Hennepin County,0,1259428,623200,636228
Minnesota,Hennepin County,1,81461,41523,39938
Minnesota,Hennepin County,2,76330,38729,37601
Minnesota,Hennepin County,3,75697,38228,37469
Minnesota,Hennepin County,4,72067,36575,35492
Minnesota,Hennepin County,5,78107,38893,39214
Minnesota,Hennepin County,6,108501,55518,52983
Minnesota,Hennepin County,7,105881,54363,51518
Minnesota,Hennepin County,8,95502,48186,47316
Minnesota,Hennepin County,9,76388,38677,37711
Minnesota,Hennepin County,10,76202,38395,37807
Minnesota,Hennepin County,11,77252,38472,38780
Minnesota,Hennepin County,12,83268,41037,42231
Minnesota,Hennepin County,13,75984,36847,39137
Minnesota,Hennepin County,14,61056,28703,32353
Minnesota,Hennepin County,15,42703,19652,23051
Minnesota,Hennepin County,16,28779,12687,16092
Minnesota,Hennepin County,17,19614,8078,11536
Minnesota,Hennepin County,18,24636,8637,15999
Minnesota,Houston County,0,18578,9328,9250
Minnesota,Houston County,1,1041,543,498
Minnesota,Houston County,2,1039,534,505
Minnesota,Houston County,3,1236,665,571
Minnesota,Houston County,4,1057,556,501
Minnesota,Houston County,5,870,451,419
Minnesota,Houston County,6,887,457,430
Minnesota,Houston County,7,982,498,484
Minnesota,Houston County,8,1143,589,554
Minnesota,Houston County,9,961,497,464
Minnesota,Houston County,10,1066,537,529
Minnesota,Houston County,11,1185,557,628
Minnesota,Houston County,12,1604,789,815
Minnesota,Houston County,13,1515,771,744
Minnesota,Houston County,14,1258,657,601
Minnesota,Houston County,15,972,483,489
Minnesota,Houston County,16,648,317,331
Minnesota,Houston County,17,484,196,288
Minnesota,Houston County,18,630,231,399
Minnesota,Hubbard County,0,21332,10829,10503
Minnesota,Hubbard County,1,1143,599,544
Minnesota,Hubbard County,2,1305,695,610
Minnesota,Hubbard County,3,1348,680,668
Minnesota,Hubbard County,4,1114,572,542
Minnesota,Hubbard County,5,860,473,387
Minnesota,Hubbard County,6,941,477,464
Minnesota,Hubbard County,7,967,496,471
Minnesota,Hubbard County,8,1207,624,583
Minnesota,Hubbard County,9,1052,512,540
Minnesota,Hubbard County,10,1120,571,549
Minnesota,Hubbard County,11,1344,661,683
Minnesota,Hubbard County,12,1815,899,916
Minnesota,Hubbard County,13,1773,895,878
Minnesota,Hubbard County,14,1799,911,888
Minnesota,Hubbard County,15,1394,742,652
Minnesota,Hubbard County,16,966,474,492
Minnesota,Hubbard County,17,635,304,331
Minnesota,Hubbard County,18,549,244,305
Minnesota,Isanti County,0,39966,20210,19756
Minnesota,Isanti County,1,2357,1210,1147
Minnesota,Isanti County,2,2627,1374,1253
Minnesota,Isanti County,3,2827,1467,1360
Minnesota,Isanti County,4,2402,1246,1156
Minnesota,Isanti County,5,2129,1098,1031
Minnesota,Isanti County,6,2427,1256,1171
Minnesota,Isanti County,7,2667,1335,1332
Minnesota,Isanti County,8,2712,1391,1321
Minnesota,Isanti County,9,2251,1156,1095
Minnesota,Isanti County,10,2480,1259,1221
Minnesota,Isanti County,11,2852,1494,1358
Minnesota,Isanti County,12,3174,1636,1538
Minnesota,Isanti County,13,2637,1345,1292
Minnesota,Isanti County,14,2079,1034,1045
Minnesota,Isanti County,15,1609,740,869
Minnesota,Isanti County,16,1182,567,615
Minnesota,Isanti County,17,787,332,455
Minnesota,Isanti County,18,767,270,497
Minnesota,Itasca County,0,45108,22797,22311
Minnesota,Itasca County,1,2365,1255,1110
Minnesota,Itasca County,2,2494,1304,1190
Minnesota,Itasca County,3,2812,1470,1342
Minnesota,Itasca County,4,2635,1404,1231
Minnesota,Itasca County,5,2075,1090,985
Minnesota,Itasca County,6,2188,1183,1005
Minnesota,Itasca County,7,2204,1080,1124
Minnesota,Itasca County,8,2556,1295,1261
Minnesota,Itasca County,9,2431,1264,1167
Minnesota,Itasca County,10,2540,1281,1259
Minnesota,Itasca County,11,2796,1366,1430
Minnesota,Itasca County,12,3533,1758,1775
Minnesota,Itasca County,13,3886,1919,1967
Minnesota,Itasca County,14,3596,1816,1780
Minnesota,Itasca County,15,2557,1291,1266
Minnesota,Itasca County,16,1926,933,993
Minnesota,Itasca County,17,1181,559,622
Minnesota,Itasca County,18,1333,529,804
Minnesota,Jackson County,0,9911,5073,4838
Minnesota,Jackson County,1,546,277,269
Minnesota,Jackson County,2,568,289,279
Minnesota,Jackson County,3,642,334,308
Minnesota,Jackson County,4,582,318,264
Minnesota,Jackson County,5,467,249,218
Minnesota,Jackson County,6,513,274,239
Minnesota,Jackson County,7,525,280,245
Minnesota,Jackson County,8,600,315,285
Minnesota,Jackson County,9,554,298,256
Minnesota,Jackson County,10,545,270,275
Minnesota,Jackson County,11,562,297,265
Minnesota,Jackson County,12,822,444,378
Minnesota,Jackson County,13,768,387,381
Minnesota,Jackson County,14,637,321,316
Minnesota,Jackson County,15,470,239,231
Minnesota,Jackson County,16,382,184,198
Minnesota,Jackson County,17,317,132,185
Minnesota,Jackson County,18,411,165,246
Minnesota,Kanabec County,0,16207,8159,8048
Minnesota,Kanabec County,1,873,420,453
Minnesota,Kanabec County,2,905,449,456
Minnesota,Kanabec County,3,1065,532,533
Minnesota,Kanabec County,4,970,511,459
Minnesota,Kanabec County,5,832,440,392
Minnesota,Kanabec County,6,770,413,357
Minnesota,Kanabec County,7,838,422,416
Minnesota,Kanabec County,8,923,474,449
Minnesota,Kanabec County,9,908,447,461
Minnesota,Kanabec County,10,1024,512,512
Minnesota,Kanabec County,11,1058,557,501
Minnesota,Kanabec County,12,1359,675,684
Minnesota,Kanabec County,13,1358,703,655
Minnesota,Kanabec County,14,1129,589,540
Minnesota,Kanabec County,15,835,392,443
Minnesota,Kanabec County,16,616,310,306
Minnesota,Kanabec County,17,402,186,216
Minnesota,Kanabec County,18,342,127,215
Minnesota,Kandiyohi County,0,42855,21576,21279
Minnesota,Kandiyohi County,1,2930,1534,1396
Minnesota,Kandiyohi County,2,2853,1467,1386
Minnesota,Kandiyohi County,3,2991,1571,1420
Minnesota,Kandiyohi County,4,2644,1385,1259
Minnesota,Kandiyohi County,5,2509,1302,1207
Minnesota,Kandiyohi County,6,2651,1412,1239
Minnesota,Kandiyohi County,7,2499,1301,1198
Minnesota,Kandiyohi County,8,2622,1389,1233
Minnesota,Kandiyohi County,9,2154,1102,1052
Minnesota,Kandiyohi County,10,2334,1134,1200
Minnesota,Kandiyohi County,11,2426,1217,1209
Minnesota,Kandiyohi County,12,3046,1493,1553
Minnesota,Kandiyohi County,13,3135,1552,1583
Minnesota,Kandiyohi County,14,2547,1282,1265
Minnesota,Kandiyohi County,15,1843,875,968
Minnesota,Kandiyohi County,16,1399,689,710
Minnesota,Kandiyohi County,17,1013,444,569
Minnesota,Kandiyohi County,18,1259,427,832
Minnesota,Kittson County,0,4248,2138,2110
Minnesota,Kittson County,1,233,128,105
Minnesota,Kittson County,2,267,139,128
Minnesota,Kittson County,3,259,124,135
Minnesota,Kittson County,4,244,124,120
Minnesota,Kittson County,5,213,115,98
Minnesota,Kittson County,6,196,94,102
Minnesota,Kittson County,7,194,107,87
Minnesota,Kittson County,8,199,116,83
Minnesota,Kittson County,9,198,89,109
Minnesota,Kittson County,10,230,117,113
Minnesota,Kittson County,11,263,141,122
Minnesota,Kittson County,12,353,182,171
Minnesota,Kittson County,13,363,182,181
Minnesota,Kittson County,14,306,150,156
Minnesota,Kittson County,15,234,129,105
Minnesota,Kittson County,16,191,93,98
Minnesota,Kittson County,17,138,60,78
Minnesota,Kittson County,18,167,48,119
Minnesota,Koochiching County,0,12440,6225,6215
Minnesota,Koochiching County,1,550,275,275
Minnesota,Koochiching County,2,598,305,293
Minnesota,Koochiching County,3,671,335,336
Minnesota,Koochiching County,4,745,369,376
Minnesota,Koochiching County,5,522,278,244
Minnesota,Koochiching County,6,613,309,304
Minnesota,Koochiching County,7,579,311,268
Minnesota,Koochiching County,8,624,312,312
Minnesota,Koochiching County,9,617,310,307
Minnesota,Koochiching County,10,697,339,358
Minnesota,Koochiching County,11,855,446,409
Minnesota,Koochiching County,12,1005,503,502
Minnesota,Koochiching County,13,1185,613,572
Minnesota,Koochiching County,14,1060,540,520
Minnesota,Koochiching County,15,747,359,388
Minnesota,Koochiching County,16,548,258,290
Minnesota,Koochiching County,17,435,220,215
Minnesota,Koochiching County,18,389,143,246
Minnesota,Lac qui Parle County,0,6658,3347,3311
Minnesota,Lac qui Parle County,1,320,167,153
Minnesota,Lac qui Parle County,2,373,212,161
Minnesota,Lac qui Parle County,3,400,207,193
Minnesota,Lac qui Parle County,4,371,187,184
Minnesota,Lac qui Parle County,5,316,152,164
Minnesota,Lac qui Parle County,6,257,134,123
Minnesota,Lac qui Parle County,7,283,151,132
Minnesota,Lac qui Parle County,8,374,182,192
Minnesota,Lac qui Parle County,9,295,150,145
Minnesota,Lac qui Parle County,10,336,171,165
Minnesota,Lac qui Parle County,11,379,203,176
Minnesota,Lac qui Parle County,12,554,277,277
Minnesota,Lac qui Parle County,13,566,300,266
Minnesota,Lac qui Parle County,14,508,257,251
Minnesota,Lac qui Parle County,15,376,196,180
Minnesota,Lac qui Parle County,16,314,144,170
Minnesota,Lac qui Parle County,17,246,118,128
Minnesota,Lac qui Parle County,18,390,139,251
Minnesota,Lake County,0,10658,5488,5170
Minnesota,Lake County,1,523,291,232
Minnesota,Lake County,2,568,311,257
Minnesota,Lake County,3,566,288,278
Minnesota,Lake County,4,542,298,244
Minnesota,Lake County,5,446,228,218
Minnesota,Lake County,6,490,255,235
Minnesota,Lake County,7,550,285,265
Minnesota,Lake County,8,579,319,260
Minnesota,Lake County,9,537,272,265
Minnesota,Lake County,10,563,284,279
Minnesota,Lake County,11,622,295,327
Minnesota,Lake County,12,918,459,459
Minnesota,Lake County,13,979,513,466
Minnesota,Lake County,14,913,494,419
Minnesota,Lake County,15,604,310,294
Minnesota,Lake County,16,478,236,242
Minnesota,Lake County,17,381,182,199
Minnesota,Lake County,18,399,168,231
Minnesota,Lake of the Woods County,0,3758,1966,1792
Minnesota,Lake of the Woods County,1,186,100,86
Minnesota,Lake of the Woods County,2,186,103,83
Minnesota,Lake of the Woods County,3,225,111,114
Minnesota,Lake of the Woods County,4,168,89,79
Minnesota,Lake of the Woods County,5,172,83,89
Minnesota,Lake of the Woods County,6,151,88,63
Minnesota,Lake of the Woods County,7,176,93,83
Minnesota,Lake of the Woods County,8,202,106,96
Minnesota,Lake of the Woods County,9,184,89,95
Minnesota,Lake of the Woods County,10,200,103,97
Minnesota,Lake of the Woods County,11,265,143,122
Minnesota,Lake of the Woods County,12,333,182,151
Minnesota,Lake of the Woods County,13,399,223,176
Minnesota,Lake of the Woods County,14,328,167,161
Minnesota,Lake of the Woods County,15,206,109,97
Minnesota,Lake of the Woods County,16,167,86,81
Minnesota,Lake of the Woods County,17,107,57,50
Minnesota,Lake of the Woods County,18,103,34,69
Minnesota,Le Sueur County,0,28494,14369,14125
Minnesota,Le Sueur County,1,1734,898,836
Minnesota,Le Sueur County,2,1835,938,897
Minnesota,Le Sueur County,3,2044,1027,1017
Minnesota,Le Sueur County,4,1776,932,844
Minnesota,Le Sueur County,5,1506,748,758
Minnesota,Le Sueur County,6,1520,758,762
Minnesota,Le Sueur County,7,1622,823,799
Minnesota,Le Sueur County,8,1869,967,902
Minnesota,Le Sueur County,9,1642,824,818
Minnesota,Le Sueur County,10,1862,939,923
Minnesota,Le Sueur County,11,1982,1051,931
Minnesota,Le Sueur County,12,2165,1115,1050
Minnesota,Le Sueur County,13,1950,998,952
Minnesota,Le Sueur County,14,1640,846,794
Minnesota,Le Sueur County,15,1229,597,632
Minnesota,Le Sueur County,16,937,450,487
Minnesota,Le Sueur County,17,606,274,332
Minnesota,Le Sueur County,18,575,184,391
Minnesota,Lincoln County,0,5673,2861,2812
Minnesota,Lincoln County,1,342,171,171
Minnesota,Lincoln County,2,373,198,175
Minnesota,Lincoln County,3,406,210,196
Minnesota,Lincoln County,4,308,167,141
Minnesota,Lincoln County,5,235,120,115
Minnesota,Lincoln County,6,257,142,115
Minnesota,Lincoln County,7,287,152,135
Minnesota,Lincoln County,8,310,151,159
Minnesota,Lincoln County,9,293,153,140
Minnesota,Lincoln County,10,303,160,143
Minnesota,Lincoln County,11,321,162,159
Minnesota,Lincoln County,12,405,214,191
Minnesota,Lincoln County,13,425,231,194
Minnesota,Lincoln County,14,365,175,190
Minnesota,Lincoln County,15,260,123,137
Minnesota,Lincoln County,16,260,116,144
Minnesota,Lincoln County,17,221,97,124
Minnesota,Lincoln County,18,302,119,183
Minnesota,Lyon County,0,25629,12789,12840
Minnesota,Lyon County,1,1907,1019,888
Minnesota,Lyon County,2,1893,985,908
Minnesota,Lyon County,3,1779,929,850
Minnesota,Lyon County,4,1867,920,947
Minnesota,Lyon County,5,1614,835,779
Minnesota,Lyon County,6,1668,844,824
Minnesota,Lyon County,7,1653,826,827
Minnesota,Lyon County,8,1701,837,864
Minnesota,Lyon County,9,1426,753,673
Minnesota,Lyon County,10,1365,700,665
Minnesota,Lyon County,11,1397,695,702
Minnesota,Lyon County,12,1658,825,833
Minnesota,Lyon County,13,1641,812,829
Minnesota,Lyon County,14,1202,601,601
Minnesota,Lyon County,15,917,429,488
Minnesota,Lyon County,16,704,325,379
Minnesota,Lyon County,17,495,213,282
Minnesota,Lyon County,18,742,241,501
Minnesota,McLeod County,0,35873,17925,17948
Minnesota,McLeod County,1,2105,1072,1033
Minnesota,McLeod County,2,2224,1127,1097
Minnesota,McLeod County,3,2387,1246,1141
Minnesota,McLeod County,4,2275,1157,1118
Minnesota,McLeod County,5,2019,1070,949
Minnesota,McLeod County,6,2134,1121,1013
Minnesota,McLeod County,7,2177,1121,1056
Minnesota,McLeod County,8,2172,1133,1039
Minnesota,McLeod County,9,1988,1000,988
Minnesota,McLeod County,10,2316,1186,1130
Minnesota,McLeod County,11,2383,1215,1168
Minnesota,McLeod County,12,2683,1315,1368
Minnesota,McLeod County,13,2294,1133,1161
Minnesota,McLeod County,14,1947,940,1007
Minnesota,McLeod County,15,1620,779,841
Minnesota,McLeod County,16,1262,550,712
Minnesota,McLeod County,17,891,414,477
Minnesota,McLeod County,18,996,346,650
Minnesota,Mahnomen County,0,5519,2781,2738
Minnesota,Mahnomen County,1,479,246,233
Minnesota,Mahnomen County,2,569,284,285
Minnesota,Mahnomen County,3,446,249,197
Minnesota,Mahnomen County,4,386,208,178
Minnesota,Mahnomen County,5,277,140,137
Minnesota,Mahnomen County,6,294,135,159
Minnesota,Mahnomen County,7,246,121,125
Minnesota,Mahnomen County,8,312,139,173
Minnesota,Mahnomen County,9,255,138,117
Minnesota,Mahnomen County,10,286,146,140
Minnesota,Mahnomen County,11,291,150,141
Minnesota,Mahnomen County,12,376,191,185
Minnesota,Mahnomen County,13,351,193,158
Minnesota,Mahnomen County,14,279,141,138
Minnesota,Mahnomen County,15,236,117,119
Minnesota,Mahnomen County,16,175,74,101
Minnesota,Mahnomen County,17,129,58,71
Minnesota,Mahnomen County,18,132,51,81
Minnesota,Marshall County,0,9390,4738,4652
Minnesota,Marshall County,1,614,313,301
Minnesota,Marshall County,2,577,284,293
Minnesota,Marshall County,3,603,289,314
Minnesota,Marshall County,4,541,265,276
Minnesota,Marshall County,5,498,260,238
Minnesota,Marshall County,6,486,272,214
Minnesota,Marshall County,7,525,262,263
Minnesota,Marshall County,8,524,286,238
Minnesota,Marshall County,9,463,232,231
Minnesota,Marshall County,10,531,283,248
Minnesota,Marshall County,11,586,304,282
Minnesota,Marshall County,12,707,359,348
Minnesota,Marshall County,13,719,394,325
Minnesota,Marshall County,14,590,310,280
Minnesota,Marshall County,15,431,208,223
Minnesota,Marshall County,16,363,173,190
Minnesota,Marshall County,17,272,111,161
Minnesota,Marshall County,18,360,133,227
Minnesota,Martin County,0,19785,9804,9981
Minnesota,Martin County,1,1133,583,550
Minnesota,Martin County,2,1169,596,573
Minnesota,Martin County,3,1288,651,637
Minnesota,Martin County,4,1098,553,545
Minnesota,Martin County,5,1009,517,492
Minnesota,Martin County,6,960,497,463
Minnesota,Martin County,7,1098,549,549
Minnesota,Martin County,8,1102,594,508
Minnesota,Martin County,9,950,467,483
Minnesota,Martin County,10,1057,529,528
Minnesota,Martin County,11,1132,563,569
Minnesota,Martin County,12,1526,754,772
Minnesota,Martin County,13,1613,837,776
Minnesota,Martin County,14,1353,699,654
Minnesota,Martin County,15,1024,504,520
Minnesota,Martin County,16,773,341,432
Minnesota,Martin County,17,603,272,331
Minnesota,Martin County,18,897,298,599
Minnesota,Meeker County,0,23141,11783,11358
Minnesota,Meeker County,1,1418,716,702
Minnesota,Meeker County,2,1528,804,724
Minnesota,Meeker County,3,1635,853,782
Minnesota,Meeker County,4,1506,767,739
Minnesota,Meeker County,5,1219,660,559
Minnesota,Meeker County,6,1112,592,520
Minnesota,Meeker County,7,1252,631,621
Minnesota,Meeker County,8,1341,687,654
Minnesota,Meeker County,9,1248,621,627
Minnesota,Meeker County,10,1294,667,627
Minnesota,Meeker County,11,1445,753,692
Minnesota,Meeker County,12,1768,912,856
Minnesota,Meeker County,13,1741,905,836
Minnesota,Meeker County,14,1510,785,725
Minnesota,Meeker County,15,1036,501,535
Minnesota,Meeker County,16,815,394,421
Minnesota,Meeker County,17,580,269,311
Minnesota,Meeker County,18,693,266,427
Minnesota,Mille Lacs County,0,26139,13139,13000
Minnesota,Mille Lacs County,1,1690,868,822
Minnesota,Mille Lacs County,2,1762,874,888
Minnesota,Mille Lacs County,3,1781,930,851
Minnesota,Mille Lacs County,4,1615,887,728
Minnesota,Mille Lacs County,5,1323,670,653
Minnesota,Mille Lacs County,6,1452,729,723
Minnesota,Mille Lacs County,7,1554,790,764
Minnesota,Mille Lacs County,8,1640,837,803
Minnesota,Mille Lacs County,9,1438,761,677
Minnesota,Mille Lacs County,10,1555,761,794
Minnesota,Mille Lacs County,11,1737,894,843
Minnesota,Mille Lacs County,12,2042,1048,994
Minnesota,Mille Lacs County,13,1763,881,882
Minnesota,Mille Lacs County,14,1494,752,742
Minnesota,Mille Lacs County,15,1128,548,580
Minnesota,Mille Lacs County,16,944,424,520
Minnesota,Mille Lacs County,17,589,273,316
Minnesota,Mille Lacs County,18,632,212,420
Minnesota,Morrison County,0,33169,16745,16424
Minnesota,Morrison County,1,1999,1008,991
Minnesota,Morrison County,2,2139,1115,1024
Minnesota,Morrison County,3,2343,1184,1159
Minnesota,Morrison County,4,1964,1081,883
Minnesota,Morrison County,5,1666,847,819
Minnesota,Morrison County,6,1686,876,810
Minnesota,Morrison County,7,1885,980,905
Minnesota,Morrison County,8,2093,1067,1026
Minnesota,Morrison County,9,1759,892,867
Minnesota,Morrison County,10,1865,934,931
Minnesota,Morrison County,11,2197,1194,1003
Minnesota,Morrison County,12,2554,1256,1298
Minnesota,Morrison County,13,2532,1282,1250
Minnesota,Morrison County,14,2031,1060,971
Minnesota,Morrison County,15,1499,752,747
Minnesota,Morrison County,16,1201,538,663
Minnesota,Morrison County,17,799,336,463
Minnesota,Morrison County,18,957,343,614
Minnesota,Mower County,0,40011,20124,19887
Minnesota,Mower County,1,2661,1371,1290
Minnesota,Mower County,2,2779,1395,1384
Minnesota,Mower County,3,2902,1496,1406
Minnesota,Mower County,4,2676,1472,1204
Minnesota,Mower County,5,2168,1152,1016
Minnesota,Mower County,6,2457,1277,1180
Minnesota,Mower County,7,2481,1256,1225
Minnesota,Mower County,8,2571,1327,1244
Minnesota,Mower County,9,2184,1095,1089
Minnesota,Mower County,10,2272,1169,1103
Minnesota,Mower County,11,2358,1218,1140
Minnesota,Mower County,12,2696,1365,1331
Minnesota,Mower County,13,2466,1247,1219
Minnesota,Mower County,14,2127,1095,1032
Minnesota,Mower County,15,1591,774,817
Minnesota,Mower County,16,1237,541,696
Minnesota,Mower County,17,922,375,547
Minnesota,Mower County,18,1463,499,964
Minnesota,Murray County,0,8276,4140,4136
Minnesota,Murray County,1,479,243,236
Minnesota,Murray County,2,478,257,221
Minnesota,Murray County,3,530,264,266
Minnesota,Murray County,4,487,249,238
Minnesota,Murray County,5,396,177,219
Minnesota,Murray County,6,354,187,167
Minnesota,Murray County,7,398,213,185
Minnesota,Murray County,8,456,226,230
Minnesota,Murray County,9,409,202,207
Minnesota,Murray County,10,422,220,202
Minnesota,Murray County,11,489,253,236
Minnesota,Murray County,12,608,309,299
Minnesota,Murray County,13,659,313,346
Minnesota,Murray County,14,633,344,289
Minnesota,Murray County,15,475,246,229
Minnesota,Murray County,16,377,177,200
Minnesota,Murray County,17,280,132,148
Minnesota,Murray County,18,346,128,218
Minnesota,Nicollet County,0,34220,17295,16925
Minnesota,Nicollet County,1,1994,1018,976
Minnesota,Nicollet County,2,2124,1094,1030
Minnesota,Nicollet County,3,2199,1106,1093
Minnesota,Nicollet County,4,2721,1280,1441
Minnesota,Nicollet County,5,2857,1451,1406
Minnesota,Nicollet County,6,2090,1131,959
Minnesota,Nicollet County,7,2228,1177,1051
Minnesota,Nicollet County,8,2377,1247,1130
Minnesota,Nicollet County,9,1951,983,968
Minnesota,Nicollet County,10,1908,1018,890
Minnesota,Nicollet County,11,1945,1072,873
Minnesota,Nicollet County,12,2179,1097,1082
Minnesota,Nicollet County,13,2089,1018,1071
Minnesota,Nicollet County,14,1803,897,906
Minnesota,Nicollet County,15,1400,731,669
Minnesota,Nicollet County,16,936,403,533
Minnesota,Nicollet County,17,654,295,359
Minnesota,Nicollet County,18,765,277,488
Minnesota,Nobles County,0,21924,11300,10624
Minnesota,Nobles County,1,1797,894,903
Minnesota,Nobles County,2,1738,868,870
Minnesota,Nobles County,3,1576,824,752
Minnesota,Nobles County,4,1447,752,695
Minnesota,Nobles County,5,1365,686,679
Minnesota,Nobles County,6,1332,759,573
Minnesota,Nobles County,7,1370,745,625
Minnesota,Nobles County,8,1388,762,626
Minnesota,Nobles County,9,1119,562,557
Minnesota,Nobles County,10,1224,681,543
Minnesota,Nobles County,11,1309,697,612
Minnesota,Nobles County,12,1311,689,622
Minnesota,Nobles County,13,1363,722,641
Minnesota,Nobles County,14,1020,531,489
Minnesota,Nobles County,15,781,381,400
Minnesota,Nobles County,16,644,317,327
Minnesota,Nobles County,17,460,206,254
Minnesota,Nobles County,18,680,224,456
Minnesota,Norman County,0,6475,3262,3213
Minnesota,Norman County,1,382,189,193
Minnesota,Norman County,2,430,233,197
Minnesota,Norman County,3,456,221,235
Minnesota,Norman County,4,415,231,184
Minnesota,Norman County,5,326,174,152
Minnesota,Norman County,6,331,171,160
Minnesota,Norman County,7,304,156,148
Minnesota,Norman County,8,363,175,188
Minnesota,Norman County,9,380,192,188
Minnesota,Norman County,10,354,182,172
Minnesota,Norman County,11,390,192,198
Minnesota,Norman County,12,517,259,258
Minnesota,Norman County,13,461,232,229
Minnesota,Norman County,14,389,221,168
Minnesota,Norman County,15,315,157,158
Minnesota,Norman County,16,232,105,127
Minnesota,Norman County,17,207,97,110
Minnesota,Norman County,18,223,75,148
Minnesota,Olmsted County,0,156277,76246,80031
Minnesota,Olmsted County,1,10750,5440,5310
Minnesota,Olmsted County,2,10560,5418,5142
Minnesota,Olmsted County,3,10900,5556,5344
Minnesota,Olmsted County,4,9169,4586,4583
Minnesota,Olmsted County,5,8845,4322,4523
Minnesota,Olmsted County,6,11157,5407,5750
Minnesota,Olmsted County,7,11589,5769,5820
Minnesota,Olmsted County,8,11249,5633,5616
Minnesota,Olmsted County,9,9365,4706,4659
Minnesota,Olmsted County,10,8851,4445,4406
Minnesota,Olmsted County,11,9214,4519,4695
Minnesota,Olmsted County,12,10773,5200,5573
Minnesota,Olmsted County,13,9583,4524,5059
Minnesota,Olmsted County,14,7495,3545,3950
Minnesota,Olmsted County,15,5724,2606,3118
Minnesota,Olmsted County,16,4327,1916,2411
Minnesota,Olmsted County,17,3115,1343,1772
Minnesota,Olmsted County,18,3611,1311,2300
Minnesota,Otter Tail County,0,58812,29588,29224
Minnesota,Otter Tail County,1,3544,1840,1704
Minnesota,Otter Tail County,2,3589,1843,1746
Minnesota,Otter Tail County,3,3666,1852,1814
Minnesota,Otter Tail County,4,3259,1732,1527
Minnesota,Otter Tail County,5,2879,1534,1345
Minnesota,Otter Tail County,6,2854,1476,1378
Minnesota,Otter Tail County,7,2914,1481,1433
Minnesota,Otter Tail County,8,3295,1709,1586
Minnesota,Otter Tail County,9,2715,1406,1309
Minnesota,Otter Tail County,10,2926,1451,1475
Minnesota,Otter Tail County,11,3570,1770,1800
Minnesota,Otter Tail County,12,4725,2388,2337
Minnesota,Otter Tail County,13,4884,2442,2442
Minnesota,Otter Tail County,14,4428,2242,2186
Minnesota,Otter Tail County,15,3305,1720,1585
Minnesota,Otter Tail County,16,2447,1205,1242
Minnesota,Otter Tail County,17,1762,776,986
Minnesota,Otter Tail County,18,2050,721,1329
Minnesota,Pennington County,0,14178,7032,7146
Minnesota,Pennington County,1,887,430,457
Minnesota,Pennington County,2,925,478,447
Minnesota,Pennington County,3,913,447,466
Minnesota,Pennington County,4,796,397,399
Minnesota,Pennington County,5,836,460,376
Minnesota,Pennington County,6,949,497,452
Minnesota,Pennington County,7,900,487,413
Minnesota,Pennington County,8,908,463,445
Minnesota,Pennington County,9,824,424,400
Minnesota,Pennington County,10,859,442,417
Minnesota,Pennington County,11,808,414,394
Minnesota,Pennington County,12,1011,490,521
Minnesota,Pennington County,13,970,480,490
Minnesota,Pennington County,14,755,373,382
Minnesota,Pennington County,15,609,277,332
Minnesota,Pennington County,16,475,216,259
Minnesota,Pennington County,17,323,118,205
Minnesota,Pennington County,18,430,139,291
Minnesota,Pine County,0,29483,15830,13653
Minnesota,Pine County,1,1421,758,663
Minnesota,Pine County,2,1512,793,719
Minnesota,Pine County,3,1789,936,853
Minnesota,Pine County,4,1629,865,764
Minnesota,Pine County,5,1409,850,559
Minnesota,Pine County,6,1584,942,642
Minnesota,Pine County,7,1725,1021,704
Minnesota,Pine County,8,1870,1083,787
Minnesota,Pine County,9,1721,985,736
Minnesota,Pine County,10,1752,960,792
Minnesota,Pine County,11,2083,1125,958
Minnesota,Pine County,12,2471,1294,1177
Minnesota,Pine County,13,2419,1287,1132
Minnesota,Pine County,14,2025,1019,1006
Minnesota,Pine County,15,1458,740,718
Minnesota,Pine County,16,1132,512,620
Minnesota,Pine County,17,787,382,405
Minnesota,Pine County,18,696,278,418
Minnesota,Pipestone County,0,9047,4406,4641
Minnesota,Pipestone County,1,658,331,327
Minnesota,Pipestone County,2,656,333,323
Minnesota,Pipestone County,3,651,339,312
Minnesota,Pipestone County,4,554,286,268
Minnesota,Pipestone County,5,458,227,231
Minnesota,Pipestone County,6,443,215,228
Minnesota,Pipestone County,7,461,232,229
Minnesota,Pipestone County,8,510,260,250
Minnesota,Pipestone County,9,442,228,214
Minnesota,Pipestone County,10,489,232,257
Minnesota,Pipestone County,11,552,283,269
Minnesota,Pipestone County,12,652,329,323
Minnesota,Pipestone County,13,625,331,294
Minnesota,Pipestone County,14,471,233,238
Minnesota,Pipestone County,15,408,179,229
Minnesota,Pipestone County,16,319,142,177
Minnesota,Pipestone County,17,299,112,187
Minnesota,Pipestone County,18,399,114,285
Minnesota,Polk County,0,31529,15828,15701
Minnesota,Polk County,1,2206,1152,1054
Minnesota,Polk County,2,2073,1047,1026
Minnesota,Polk County,3,2114,1111,1003
Minnesota,Polk County,4,2079,1012,1067
Minnesota,Polk County,5,1945,1019,926
Minnesota,Polk County,6,1808,976,832
Minnesota,Polk County,7,1992,1024,968
Minnesota,Polk County,8,1962,1023,939
Minnesota,Polk County,9,1571,825,746
Minnesota,Polk County,10,1704,873,831
Minnesota,Polk County,11,1882,944,938
Minnesota,Polk County,12,2286,1136,1150
Minnesota,Polk County,13,2241,1127,1114
Minnesota,Polk County,14,1723,882,841
Minnesota,Polk County,15,1308,672,636
Minnesota,Polk County,16,976,432,544
Minnesota,Polk County,17,709,311,398
Minnesota,Polk County,18,950,262,688
Minnesota,Pope County,0,11097,5665,5432
Minnesota,Pope County,1,614,319,295
Minnesota,Pope County,2,662,357,305
Minnesota,Pope County,3,672,362,310
Minnesota,Pope County,4,547,291,256
Minnesota,Pope County,5,486,261,225
Minnesota,Pope County,6,573,304,269
Minnesota,Pope County,7,661,340,321
Minnesota,Pope County,8,643,349,294
Minnesota,Pope County,9,548,282,266
Minnesota,Pope County,10,570,301,269
Minnesota,Pope County,11,632,320,312
Minnesota,Pope County,12,862,439,423
Minnesota,Pope County,13,917,453,464
Minnesota,Pope County,14,844,447,397
Minnesota,Pope County,15,651,327,324
Minnesota,Pope County,16,446,217,229
Minnesota,Pope County,17,343,140,203
Minnesota,Pope County,18,426,156,270
Minnesota,Ramsey County,0,550210,268571,281639
Minnesota,Ramsey County,1,38093,19516,18577
Minnesota,Ramsey County,2,35959,18539,17420
Minnesota,Ramsey County,3,34539,17463,17076
Minnesota,Ramsey County,4,34793,17569,17224
Minnesota,Ramsey County,5,38887,19089,19798
Minnesota,Ramsey County,6,47882,23821,24061
Minnesota,Ramsey County,7,44144,21900,22244
Minnesota,Ramsey County,8,38091,19053,19038
Minnesota,Ramsey County,9,30248,15213,15035
Minnesota,Ramsey County,10,30229,15017,15212
Minnesota,Ramsey County,11,31016,15302,15714
Minnesota,Ramsey County,12,34605,16745,17860
Minnesota,Ramsey County,13,32396,15205,17191
Minnesota,Ramsey County,14,27279,12633,14646
Minnesota,Ramsey County,15,18899,8589,10310
Minnesota,Ramsey County,16,12973,5590,7383
Minnesota,Ramsey County,17,9043,3611,5432
Minnesota,Ramsey County,18,11134,3716,7418
Minnesota,Red Lake County,0,3999,2042,1957
Minnesota,Red Lake County,1,233,135,98
Minnesota,Red Lake County,2,277,144,133
Minnesota,Red Lake County,3,288,142,146
Minnesota,Red Lake County,4,246,120,126
Minnesota,Red Lake County,5,160,82,78
Minnesota,Red Lake County,6,181,101,80
Minnesota,Red Lake County,7,197,107,90
Minnesota,Red Lake County,8,258,122,136
Minnesota,Red Lake County,9,228,116,112
Minnesota,Red Lake County,10,217,110,107
Minnesota,Red Lake County,11,245,127,118
Minnesota,Red Lake County,12,302,158,144
Minnesota,Red Lake County,13,330,175,155
Minnesota,Red Lake County,14,255,139,116
Minnesota,Red Lake County,15,192,94,98
Minnesota,Red Lake County,16,148,68,80
Minnesota,Red Lake County,17,115,56,59
Minnesota,Red Lake County,18,127,46,81
Minnesota,Redwood County,0,15249,7611,7638
Minnesota,Redwood County,1,996,504,492
Minnesota,Redwood County,2,1030,506,524
Minnesota,Redwood County,3,1105,553,552
Minnesota,Redwood County,4,977,533,444
Minnesota,Redwood County,5,799,406,393
Minnesota,Redwood County,6,784,390,394
Minnesota,Redwood County,7,805,420,385
Minnesota,Redwood County,8,889,471,418
Minnesota,Redwood County,9,758,387,371
Minnesota,Redwood County,10,784,394,390
Minnesota,Redwood County,11,940,502,438
Minnesota,Redwood County,12,1112,554,558
Minnesota,Redwood County,13,1045,544,501
Minnesota,Redwood County,14,908,458,450
Minnesota,Redwood County,15,715,326,389
Minnesota,Redwood County,16,598,286,312
Minnesota,Redwood County,17,420,200,220
Minnesota,Redwood County,18,584,177,407
Minnesota,Renville County,0,14612,7427,7185
Minnesota,Renville County,1,915,494,421
Minnesota,Renville County,2,950,466,484
Minnesota,Renville County,3,968,473,495
Minnesota,Renville County,4,862,440,422
Minnesota,Renville County,5,780,411,369
Minnesota,Renville County,6,715,385,330
Minnesota,Renville County,7,780,402,378
Minnesota,Renville County,8,840,450,390
Minnesota,Renville County,9,743,386,357
Minnesota,Renville County,10,798,405,393
Minnesota,Renville County,11,923,455,468
Minnesota,Renville County,12,1155,603,552
Minnesota,Renville County,13,1143,614,529
Minnesota,Renville County,14,886,480,406
Minnesota,Renville County,15,647,329,318
Minnesota,Renville County,16,558,271,287
Minnesota,Renville County,17,405,177,228
Minnesota,Renville County,18,544,186,358
Minnesota,Rice County,0,66523,33901,32622
Minnesota,Rice County,1,3857,1948,1909
Minnesota,Rice County,2,3975,1975,2000
Minnesota,Rice County,3,4154,2063,2091
Minnesota,Rice County,4,5716,2806,2910
Minnesota,Rice County,5,6505,3343,3162
Minnesota,Rice County,6,3555,1968,1587
Minnesota,Rice County,7,4058,2256,1802
Minnesota,Rice County,8,4071,2231,1840
Minnesota,Rice County,9,3661,1962,1699
Minnesota,Rice County,10,4049,2136,1913
Minnesota,Rice County,11,4091,2171,1920
Minnesota,Rice County,12,4516,2318,2198
Minnesota,Rice County,13,4065,2005,2060
Minnesota,Rice County,14,3327,1625,1702
Minnesota,Rice County,15,2479,1210,1269
Minnesota,Rice County,16,1809,848,961
Minnesota,Rice County,17,1299,574,725
Minnesota,Rice County,18,1336,462,874
Minnesota,Rock County,0,9414,4636,4778
Minnesota,Rock County,1,574,258,316
Minnesota,Rock County,2,651,310,341
Minnesota,Rock County,3,751,394,357
Minnesota,Rock County,4,648,345,303
Minnesota,Rock County,5,468,253,215
Minnesota,Rock County,6,485,254,231
Minnesota,Rock County,7,485,245,240
Minnesota,Rock County,8,528,261,267
Minnesota,Rock County,9,575,278,297
Minnesota,Rock County,10,537,266,271
Minnesota,Rock County,11,520,256,264
Minnesota,Rock County,12,665,331,334
Minnesota,Rock County,13,660,336,324
Minnesota,Rock County,14,528,258,270
Minnesota,Rock County,15,426,207,219
Minnesota,Rock County,16,324,158,166
Minnesota,Rock County,17,256,118,138
Minnesota,Rock County,18,333,108,225
Minnesota,Roseau County,0,15150,7795,7355
Minnesota,Roseau County,1,907,471,436
Minnesota,Roseau County,2,1006,498,508
Minnesota,Roseau County,3,1067,534,533
Minnesota,Roseau County,4,1012,540,472
Minnesota,Roseau County,5,829,434,395
Minnesota,Roseau County,6,787,433,354
Minnesota,Roseau County,7,740,383,357
Minnesota,Roseau County,8,827,455,372
Minnesota,Roseau County,9,846,440,406
Minnesota,Roseau County,10,961,486,475
Minnesota,Roseau County,11,1119,597,522
Minnesota,Roseau County,12,1274,679,595
Minnesota,Roseau County,13,1124,597,527
Minnesota,Roseau County,14,865,435,430
Minnesota,Roseau County,15,600,294,306
Minnesota,Roseau County,16,484,251,233
Minnesota,Roseau County,17,319,150,169
Minnesota,Roseau County,18,383,118,265
Minnesota,St. Louis County,0,199754,100283,99471
Minnesota,St. Louis County,1,10151,5136,5015
Minnesota,St. Louis County,2,10424,5376,5048
Minnesota,St. Louis County,3,10921,5662,5259
Minnesota,St. Louis County,4,13545,6840,6705
Minnesota,St. Louis County,5,17936,9125,8811
Minnesota,St. Louis County,6,11867,6303,5564
Minnesota,St. Louis County,7,11286,5925,5361
Minnesota,St. Louis County,8,12144,6389,5755
Minnesota,St. Louis County,9,10366,5360,5006
Minnesota,St. Louis County,10,10710,5559,5151
Minnesota,St. Louis County,11,11718,5856,5862
Minnesota,St. Louis County,12,14497,7211,7286
Minnesota,St. Louis County,13,15441,7638,7803
Minnesota,St. Louis County,14,13245,6672,6573
Minnesota,St. Louis County,15,9212,4582,4630
Minnesota,St. Louis County,16,6437,2958,3479
Minnesota,St. Louis County,17,4516,1893,2623
Minnesota,St. Louis County,18,5338,1798,3540
Minnesota,Scott County,0,147381,73440,73941
Minnesota,Scott County,1,10084,5096,4988
Minnesota,Scott County,2,11261,5712,5549
Minnesota,Scott County,3,12042,6114,5928
Minnesota,Scott County,4,10648,5485,5163
Minnesota,Scott County,5,8061,4063,3998
Minnesota,Scott County,6,7924,3881,4043
Minnesota,Scott County,7,9754,4894,4860
Minnesota,Scott County,8,11108,5475,5633
Minnesota,Scott County,9,10541,5259,5282
Minnesota,Scott County,10,11110,5554,5556
Minnesota,Scott County,11,10866,5531,5335
Minnesota,Scott County,12,10341,5199,5142
Minnesota,Scott County,13,7606,3848,3758
Minnesota,Scott County,14,5687,2720,2967
Minnesota,Scott County,15,4088,1901,2187
Minnesota,Scott County,16,2763,1279,1484
Minnesota,Scott County,17,1729,770,959
Minnesota,Scott County,18,1768,659,1109
Minnesota,Sherburne County,0,96036,49201,46835
Minnesota,Sherburne County,1,6532,3339,3193
Minnesota,Sherburne County,2,6937,3603,3334
Minnesota,Sherburne County,3,7370,3711,3659
Minnesota,Sherburne County,4,6932,3597,3335
Minnesota,Sherburne County,5,5534,3010,2524
Minnesota,Sherburne County,6,5956,3161,2795
Minnesota,Sherburne County,7,6899,3582,3317
Minnesota,Sherburne County,8,6980,3639,3341
Minnesota,Sherburne County,9,6465,3348,3117
Minnesota,Sherburne County,10,7011,3586,3425
Minnesota,Sherburne County,11,6826,3540,3286
Minnesota,Sherburne County,12,6577,3453,3124
Minnesota,Sherburne County,13,5133,2608,2525
Minnesota,Sherburne County,14,4022,1990,2032
Minnesota,Sherburne County,15,2779,1336,1443
Minnesota,Sherburne County,16,1811,838,973
Minnesota,Sherburne County,17,1121,490,631
Minnesota,Sherburne County,18,1151,370,781
Minnesota,Sibley County,0,15028,7560,7468
Minnesota,Sibley County,1,844,404,440
Minnesota,Sibley County,2,988,529,459
Minnesota,Sibley County,3,1091,533,558
Minnesota,Sibley County,4,957,483,474
Minnesota,Sibley County,5,799,415,384
Minnesota,Sibley County,6,806,428,378
Minnesota,Sibley County,7,825,421,404
Minnesota,Sibley County,8,942,489,453
Minnesota,Sibley County,9,834,445,389
Minnesota,Sibley County,10,892,456,436
Minnesota,Sibley County,11,1000,503,497
Minnesota,Sibley County,12,1255,647,608
Minnesota,Sibley County,13,1039,555,484
Minnesota,Sibley County,14,825,438,387
Minnesota,Sibley County,15,627,294,333
Minnesota,Sibley County,16,490,213,277
Minnesota,Sibley County,17,380,165,215
Minnesota,Sibley County,18,434,142,292
Minnesota,Stearns County,0,159256,80406,78850
Minnesota,Stearns County,1,10134,5213,4921
Minnesota,Stearns County,2,10093,5099,4994
Minnesota,Stearns County,3,10255,5157,5098
Minnesota,Stearns County,4,12844,6415,6429
Minnesota,Stearns County,5,16934,8818,8116
Minnesota,Stearns County,6,10134,5424,4710
Minnesota,Stearns County,7,9342,4983,4359
Minnesota,Stearns County,8,9747,4977,4770
Minnesota,Stearns County,9,8214,4240,3974
Minnesota,Stearns County,10,8458,4235,4223
Minnesota,Stearns County,11,9533,4842,4691
Minnesota,Stearns County,12,10288,5134,5154
Minnesota,Stearns County,13,9201,4646,4555
Minnesota,Stearns County,14,7616,3752,3864
Minnesota,Stearns County,15,5793,2753,3040
Minnesota,Stearns County,16,4240,1992,2248
Minnesota,Stearns County,17,3102,1438,1664
Minnesota,Stearns County,18,3328,1288,2040
Minnesota,Steele County,0,36803,18326,18477
Minnesota,Steele County,1,2293,1129,1164
Minnesota,Steele County,2,2584,1268,1316
Minnesota,Steele County,3,2740,1359,1381
Minnesota,Steele County,4,2379,1233,1146
Minnesota,Steele County,5,1972,1051,921
Minnesota,Steele County,6,2051,1099,952
Minnesota,Steele County,7,2302,1201,1101
Minnesota,Steele County,8,2345,1217,1128
Minnesota,Steele County,9,2041,960,1081
Minnesota,Steele County,10,2215,1147,1068
Minnesota,Steele County,11,2395,1207,1188
Minnesota,Steele County,12,2658,1320,1338
Minnesota,Steele County,13,2337,1190,1147
Minnesota,Steele County,14,2006,1010,996
Minnesota,Steele County,15,1472,695,777
Minnesota,Steele County,16,1142,523,619
Minnesota,Steele County,17,852,344,508
Minnesota,Steele County,18,1019,373,646
Minnesota,Stevens County,0,9753,4850,4903
Minnesota,Stevens County,1,541,276,265
Minnesota,Stevens County,2,570,298,272
Minnesota,Stevens County,3,615,317,298
Minnesota,Stevens County,4,1049,500,549
Minnesota,Stevens County,5,1260,624,636
Minnesota,Stevens County,6,551,290,261
Minnesota,Stevens County,7,527,292,235
Minnesota,Stevens County,8,545,289,256
Minnesota,Stevens County,9,464,241,223
Minnesota,Stevens County,10,428,210,218
Minnesota,Stevens County,11,424,210,214
Minnesota,Stevens County,12,539,280,259
Minnesota,Stevens County,13,554,267,287
Minnesota,Stevens County,14,505,249,256
Minnesota,Stevens County,15,321,157,164
Minnesota,Stevens County,16,277,135,142
Minnesota,Stevens County,17,226,95,131
Minnesota,Stevens County,18,357,120,237
Minnesota,Swift County,0,9345,4725,4620
Minnesota,Swift County,1,570,291,279
Minnesota,Swift County,2,609,320,289
Minnesota,Swift County,3,622,321,301
Minnesota,Swift County,4,538,270,268
Minnesota,Swift County,5,428,232,196
Minnesota,Swift County,6,495,258,237
Minnesota,Swift County,7,517,277,240
Minnesota,Swift County,8,575,300,275
Minnesota,Swift County,9,475,248,227
Minnesota,Swift County,10,506,267,239
Minnesota,Swift County,11,594,309,285
Minnesota,Swift County,12,681,354,327
Minnesota,Swift County,13,691,371,320
Minnesota,Swift County,14,562,287,275
Minnesota,Swift County,15,472,232,240
Minnesota,Swift County,16,340,151,189
Minnesota,Swift County,17,298,120,178
Minnesota,Swift County,18,372,117,255
Minnesota,Todd County,0,24582,12672,11910
Minnesota,Todd County,1,1663,878,785
Minnesota,Todd County,2,1656,824,832
Minnesota,Todd County,3,1580,876,704
Minnesota,Todd County,4,1440,772,668
Minnesota,Todd County,5,1306,670,636
Minnesota,Todd County,6,1192,635,557
Minnesota,Todd County,7,1193,608,585
Minnesota,Todd County,8,1362,711,651
Minnesota,Todd County,9,1201,643,558
Minnesota,Todd County,10,1312,701,611
Minnesota,Todd County,11,1530,745,785
Minnesota,Todd County,12,1918,960,958
Minnesota,Todd County,13,1935,1038,897
Minnesota,Todd County,14,1634,884,750
Minnesota,Todd County,15,1311,645,666
Minnesota,Todd County,16,1011,495,516
Minnesota,Todd County,17,628,290,338
Minnesota,Todd County,18,710,297,413
Minnesota,Traverse County,0,3308,1659,1649
Minnesota,Traverse County,1,188,99,89
Minnesota,Traverse County,2,190,103,87
Minnesota,Traverse County,3,197,100,97
Minnesota,Traverse County,4,182,90,92
Minnesota,Traverse County,5,188,101,87
Minnesota,Traverse County,6,147,73,74
Minnesota,Traverse County,7,139,77,62
Minnesota,Traverse County,8,179,92,87
Minnesota,Traverse County,9,171,92,79
Minnesota,Traverse County,10,149,78,71
Minnesota,Traverse County,11,221,108,113
Minnesota,Traverse County,12,256,131,125
Minnesota,Traverse County,13,269,137,132
Minnesota,Traverse County,14,197,109,88
Minnesota,Traverse County,15,172,81,91
Minnesota,Traverse County,16,153,74,79
Minnesota,Traverse County,17,124,53,71
Minnesota,Traverse County,18,186,61,125
Minnesota,Wabasha County,0,21645,10845,10800
Minnesota,Wabasha County,1,1226,642,584
Minnesota,Wabasha County,2,1309,694,615
Minnesota,Wabasha County,3,1379,694,685
Minnesota,Wabasha County,4,1181,599,582
Minnesota,Wabasha County,5,1062,519,543
Minnesota,Wabasha County,6,1085,524,561
Minnesota,Wabasha County,7,1179,604,575
Minnesota,Wabasha County,8,1243,643,600
Minnesota,Wabasha County,9,1097,556,541
Minnesota,Wabasha County,10,1277,652,625
Minnesota,Wabasha County,11,1507,739,768
Minnesota,Wabasha County,12,1712,858,854
Minnesota,Wabasha County,13,1665,852,813
Minnesota,Wabasha County,14,1440,746,694
Minnesota,Wabasha County,15,1216,581,635
Minnesota,Wabasha County,16,859,416,443
Minnesota,Wabasha County,17,565,275,290
Minnesota,Wabasha County,18,643,251,392
Minnesota,Wadena County,0,13773,6815,6958
Minnesota,Wadena County,1,960,522,438
Minnesota,Wadena County,2,977,493,484
Minnesota,Wadena County,3,1038,497,541
Minnesota,Wadena County,4,844,435,409
Minnesota,Wadena County,5,698,348,350
Minnesota,Wadena County,6,754,394,360
Minnesota,Wadena County,7,666,324,342
Minnesota,Wadena County,8,788,402,386
Minnesota,Wadena County,9,720,354,366
Minnesota,Wadena County,10,738,390,348
Minnesota,Wadena County,11,797,420,377
Minnesota,Wadena County,12,961,479,482
Minnesota,Wadena County,13,935,472,463
Minnesota,Wadena County,14,827,403,424
Minnesota,Wadena County,15,638,301,337
Minnesota,Wadena County,16,537,262,275
Minnesota,Wadena County,17,399,177,222
Minnesota,Wadena County,18,496,142,354
Minnesota,Waseca County,0,18691,9008,9683
Minnesota,Waseca County,1,1054,544,510
Minnesota,Waseca County,2,1177,625,552
Minnesota,Waseca County,3,1333,672,661
Minnesota,Waseca County,4,1207,594,613
Minnesota,Waseca County,5,1039,493,546
Minnesota,Waseca County,6,1104,517,587
Minnesota,Waseca County,7,1166,518,648
Minnesota,Waseca County,8,1267,564,703
Minnesota,Waseca County,9,1133,523,610
Minnesota,Waseca County,10,1142,566,576
Minnesota,Waseca County,11,1143,555,588
Minnesota,Waseca County,12,1259,639,620
Minnesota,Waseca County,13,1267,612,655
Minnesota,Waseca County,14,1128,561,567
Minnesota,Waseca County,15,803,430,373
Minnesota,Waseca County,16,561,248,313
Minnesota,Waseca County,17,389,156,233
Minnesota,Waseca County,18,519,191,328
Minnesota,Washington County,0,259201,128076,131125
Minnesota,Washington County,1,15586,7844,7742
Minnesota,Washington County,2,17668,8991,8677
Minnesota,Washington County,3,18901,9530,9371
Minnesota,Washington County,4,17387,8954,8433
Minnesota,Washington County,5,14724,7601,7123
Minnesota,Washington County,6,13918,7214,6704
Minnesota,Washington County,7,15586,7700,7886
Minnesota,Washington County,8,18065,9019,9046
Minnesota,Washington County,9,16425,8213,8212
Minnesota,Washington County,10,17411,8616,8795
Minnesota,Washington County,11,18575,9010,9565
Minnesota,Washington County,12,19381,9558,9823
Minnesota,Washington County,13,16668,8038,8630
Minnesota,Washington County,14,13335,6433,6902
Minnesota,Washington County,15,9989,4782,5207
Minnesota,Washington County,16,6700,3038,3662
Minnesota,Washington County,17,4302,1868,2434
Minnesota,Washington County,18,4580,1667,2913
Minnesota,Watonwan County,0,10980,5426,5554
Minnesota,Watonwan County,1,767,385,382
Minnesota,Watonwan County,2,750,361,389
Minnesota,Watonwan County,3,712,342,370
Minnesota,Watonwan County,4,712,364,348
Minnesota,Watonwan County,5,686,350,336
Minnesota,Watonwan County,6,573,311,262
Minnesota,Watonwan County,7,567,286,281
Minnesota,Watonwan County,8,643,337,306
Minnesota,Watonwan County,9,592,292,300
Minnesota,Watonwan County,10,545,272,273
Minnesota,Watonwan County,11,646,328,318
Minnesota,Watonwan County,12,781,358,423
Minnesota,Watonwan County,13,815,400,415
Minnesota,Watonwan County,14,601,342,259
Minnesota,Watonwan County,15,442,204,238
Minnesota,Watonwan County,16,412,197,215
Minnesota,Watonwan County,17,311,127,184
Minnesota,Watonwan County,18,425,170,255
Minnesota,Wilkin County,0,6254,3228,3026
Minnesota,Wilkin County,1,382,198,184
Minnesota,Wilkin County,2,377,193,184
Minnesota,Wilkin County,3,401,214,187
Minnesota,Wilkin County,4,396,240,156
Minnesota,Wilkin County,5,328,172,156
Minnesota,Wilkin County,6,287,160,127
Minnesota,Wilkin County,7,338,154,184
Minnesota,Wilkin County,8,388,207,181
Minnesota,Wilkin County,9,339,177,162
Minnesota,Wilkin County,10,372,191,181
Minnesota,Wilkin County,11,408,210,198
Minnesota,Wilkin County,12,550,296,254
Minnesota,Wilkin County,13,488,248,240
Minnesota,Wilkin County,14,344,182,162
Minnesota,Wilkin County,15,270,131,139
Minnesota,Wilkin County,16,224,96,128
Minnesota,Wilkin County,17,185,84,101
Minnesota,Wilkin County,18,177,75,102
Minnesota,Winona County,0,50825,25133,25692
Minnesota,Winona County,1,2452,1196,1256
Minnesota,Winona County,2,2414,1254,1160
Minnesota,Winona County,3,2677,1320,1357
Minnesota,Winona County,4,4625,2117,2508
Minnesota,Winona County,5,7245,3627,3618
Minnesota,Winona County,6,3089,1675,1414
Minnesota,Winona County,7,2610,1315,1295
Minnesota,Winona County,8,2746,1405,1341
Minnesota,Winona County,9,2426,1254,1172
Minnesota,Winona County,10,2545,1325,1220
Minnesota,Winona County,11,2776,1377,1399
Minnesota,Winona County,12,3277,1617,1660
Minnesota,Winona County,13,3312,1642,1670
Minnesota,Winona County,14,2844,1432,1412
Minnesota,Winona County,15,2097,1046,1051
Minnesota,Winona County,16,1430,664,766
Minnesota,Winona County,17,1071,492,579
Minnesota,Winona County,18,1189,375,814
Minnesota,Wright County,0,136349,68848,67501
Minnesota,Wright County,1,9406,4855,4551
Minnesota,Wright County,2,10579,5392,5187
Minnesota,Wright County,3,11504,5885,5619
Minnesota,Wright County,4,9630,5019,4611
Minnesota,Wright County,5,7081,3572,3509
Minnesota,Wright County,6,7354,3748,3606
Minnesota,Wright County,7,8664,4334,4330
Minnesota,Wright County,8,9953,5026,4927
Minnesota,Wright County,9,9412,4794,4618
Minnesota,Wright County,10,9452,4876,4576
Minnesota,Wright County,11,9431,4826,4605
Minnesota,Wright County,12,9327,4788,4539
Minnesota,Wright County,13,7341,3754,3587
Minnesota,Wright County,14,5733,2769,2964
Minnesota,Wright County,15,4500,2091,2409
Minnesota,Wright County,16,3139,1516,1623
Minnesota,Wright County,17,1909,877,1032
Minnesota,Wright County,18,1934,726,1208
Minnesota,Yellow Medicine County,0,9795,4948,4847
Minnesota,Yellow Medicine County,1,611,300,311
Minnesota,Yellow Medicine County,2,630,310,320
Minnesota,Yellow Medicine County,3,695,363,332
Minnesota,Yellow Medicine County,4,594,331,263
Minnesota,Yellow Medicine County,5,541,289,252
Minnesota,Yellow Medicine County,6,512,262,250
Minnesota,Yellow Medicine County,7,562,300,262
Minnesota,Yellow Medicine County,8,555,290,265
Minnesota,Yellow Medicine County,9,483,250,233
Minnesota,Yellow Medicine County,10,521,261,260
Minnesota,Yellow Medicine County,11,594,303,291
Minnesota,Yellow Medicine County,12,745,363,382
Minnesota,Yellow Medicine County,13,771,402,369
Minnesota,Yellow Medicine County,14,558,301,257
Minnesota,Yellow Medicine County,15,403,197,206
Minnesota,Yellow Medicine County,16,355,173,182
Minnesota,Yellow Medicine County,17,268,130,138
Minnesota,Yellow Medicine County,18,397,123,274
Mississippi,Adams County,0,31192,16249,14943
Mississippi,Adams County,1,1821,918,903
Mississippi,Adams County,2,1619,795,824
Mississippi,Adams County,3,1763,893,870
Mississippi,Adams County,4,1660,856,804
Mississippi,Adams County,5,1745,937,808
Mississippi,Adams County,6,2136,1219,917
Mississippi,Adams County,7,2001,1204,797
Mississippi,Adams County,8,2137,1390,747
Mississippi,Adams County,9,1998,1180,818
Mississippi,Adams County,10,1745,990,755
Mississippi,Adams County,11,1914,1036,878
Mississippi,Adams County,12,2414,1231,1183
Mississippi,Adams County,13,2365,1117,1248
Mississippi,Adams County,14,2010,926,1084
Mississippi,Adams County,15,1389,630,759
Mississippi,Adams County,16,1024,436,588
Mississippi,Adams County,17,712,268,444
Mississippi,Adams County,18,739,223,516
Mississippi,Alcorn County,0,36925,18024,18901
Mississippi,Alcorn County,1,2113,1069,1044
Mississippi,Alcorn County,2,2260,1148,1112
Mississippi,Alcorn County,3,2498,1257,1241
Mississippi,Alcorn County,4,2358,1244,1114
Mississippi,Alcorn County,5,2177,1169,1008
Mississippi,Alcorn County,6,2426,1200,1226
Mississippi,Alcorn County,7,2149,1109,1040
Mississippi,Alcorn County,8,2266,1095,1171
Mississippi,Alcorn County,9,2206,1099,1107
Mississippi,Alcorn County,10,2472,1216,1256
Mississippi,Alcorn County,11,2374,1212,1162
Mississippi,Alcorn County,12,2522,1217,1305
Mississippi,Alcorn County,13,2291,1068,1223
Mississippi,Alcorn County,14,2045,922,1123
Mississippi,Alcorn County,15,1917,820,1097
Mississippi,Alcorn County,16,1322,583,739
Mississippi,Alcorn County,17,834,368,466
Mississippi,Alcorn County,18,695,228,467
Mississippi,Amite County,0,12326,5967,6359
Mississippi,Amite County,1,671,346,325
Mississippi,Amite County,2,695,360,335
Mississippi,Amite County,3,725,351,374
Mississippi,Amite County,4,685,344,341
Mississippi,Amite County,5,608,333,275
Mississippi,Amite County,6,661,338,323
Mississippi,Amite County,7,602,288,314
Mississippi,Amite County,8,617,305,312
Mississippi,Amite County,9,607,291,316
Mississippi,Amite County,10,677,329,348
Mississippi,Amite County,11,771,365,406
Mississippi,Amite County,12,1037,497,540
Mississippi,Amite County,13,1074,507,567
Mississippi,Amite County,14,922,462,460
Mississippi,Amite County,15,710,325,385
Mississippi,Amite County,16,564,249,315
Mississippi,Amite County,17,355,165,190
Mississippi,Amite County,18,345,112,233
Mississippi,Attala County,0,18365,8698,9667
Mississippi,Attala County,1,1164,561,603
Mississippi,Attala County,2,1298,649,649
Mississippi,Attala County,3,1411,683,728
Mississippi,Attala County,4,1178,578,600
Mississippi,Attala County,5,1051,550,501
Mississippi,Attala County,6,1099,522,577
Mississippi,Attala County,7,976,446,530
Mississippi,Attala County,8,1025,498,527
Mississippi,Attala County,9,1010,481,529
Mississippi,Attala County,10,1114,523,591
Mississippi,Attala County,11,1136,518,618
Mississippi,Attala County,12,1154,545,609
Mississippi,Attala County,13,1228,585,643
Mississippi,Attala County,14,1047,504,543
Mississippi,Attala County,15,888,406,482
Mississippi,Attala County,16,655,312,343
Mississippi,Attala County,17,474,201,273
Mississippi,Attala County,18,457,136,321
Mississippi,Benton County,0,8271,4100,4171
Mississippi,Benton County,1,490,239,251
Mississippi,Benton County,2,442,215,227
Mississippi,Benton County,3,525,283,242
Mississippi,Benton County,4,517,263,254
Mississippi,Benton County,5,455,243,212
Mississippi,Benton County,6,532,288,244
Mississippi,Benton County,7,472,229,243
Mississippi,Benton County,8,463,219,244
Mississippi,Benton County,9,481,239,242
Mississippi,Benton County,10,528,245,283
Mississippi,Benton County,11,605,318,287
Mississippi,Benton County,12,643,341,302
Mississippi,Benton County,13,571,269,302
Mississippi,Benton County,14,455,236,219
Mississippi,Benton County,15,409,186,223
Mississippi,Benton County,16,321,147,174
Mississippi,Benton County,17,186,81,105
Mississippi,Benton County,18,176,59,117
Mississippi,Bolivar County,0,31333,14557,16776
Mississippi,Bolivar County,1,2074,1072,1002
Mississippi,Bolivar County,2,2232,1150,1082
Mississippi,Bolivar County,3,2109,1056,1053
Mississippi,Bolivar County,4,2265,1045,1220
Mississippi,Bolivar County,5,2345,1155,1190
Mississippi,Bolivar County,6,2340,1158,1182
Mississippi,Bolivar County,7,2036,972,1064
Mississippi,Bolivar County,8,1917,898,1019
Mississippi,Bolivar County,9,1586,716,870
Mississippi,Bolivar County,10,1781,792,989
Mississippi,Bolivar County,11,1821,834,987
Mississippi,Bolivar County,12,1991,876,1115
Mississippi,Bolivar County,13,1885,825,1060
Mississippi,Bolivar County,14,1758,767,991
Mississippi,Bolivar County,15,1339,573,766
Mississippi,Bolivar County,16,876,373,503
Mississippi,Bolivar County,17,476,178,298
Mississippi,Bolivar County,18,502,117,385
Mississippi,Calhoun County,0,14436,6942,7494
Mississippi,Calhoun County,1,813,409,404
Mississippi,Calhoun County,2,906,467,439
Mississippi,Calhoun County,3,1035,558,477
Mississippi,Calhoun County,4,923,467,456
Mississippi,Calhoun County,5,826,422,404
Mississippi,Calhoun County,6,827,388,439
Mississippi,Calhoun County,7,755,389,366
Mississippi,Calhoun County,8,839,407,432
Mississippi,Calhoun County,9,802,394,408
Mississippi,Calhoun County,10,984,467,517
Mississippi,Calhoun County,11,988,462,526
Mississippi,Calhoun County,12,1003,451,552
Mississippi,Calhoun County,13,1003,468,535
Mississippi,Calhoun County,14,884,452,432
Mississippi,Calhoun County,15,621,280,341
Mississippi,Calhoun County,16,524,217,307
Mississippi,Calhoun County,17,344,138,206
Mississippi,Calhoun County,18,359,106,253
Mississippi,Carroll County,0,9911,5012,4899
Mississippi,Carroll County,1,428,214,214
Mississippi,Carroll County,2,475,243,232
Mississippi,Carroll County,3,593,296,297
Mississippi,Carroll County,4,532,268,264
Mississippi,Carroll County,5,520,287,233
Mississippi,Carroll County,6,548,297,251
Mississippi,Carroll County,7,501,291,210
Mississippi,Carroll County,8,591,310,281
Mississippi,Carroll County,9,525,257,268
Mississippi,Carroll County,10,618,307,311
Mississippi,Carroll County,11,649,324,325
Mississippi,Carroll County,12,808,408,400
Mississippi,Carroll County,13,775,387,388
Mississippi,Carroll County,14,725,368,357
Mississippi,Carroll County,15,637,313,324
Mississippi,Carroll County,16,470,219,251
Mississippi,Carroll County,17,272,129,143
Mississippi,Carroll County,18,244,94,150
Mississippi,Chickasaw County,0,17171,8439,8732
Mississippi,Chickasaw County,1,1134,582,552
Mississippi,Chickasaw County,2,1201,609,592
Mississippi,Chickasaw County,3,1206,607,599
Mississippi,Chickasaw County,4,1095,594,501
Mississippi,Chickasaw County,5,1116,610,506
Mississippi,Chickasaw County,6,1217,601,616
Mississippi,Chickasaw County,7,1017,507,510
Mississippi,Chickasaw County,8,1020,539,481
Mississippi,Chickasaw County,9,949,483,466
Mississippi,Chickasaw County,10,984,504,480
Mississippi,Chickasaw County,11,1086,492,594
Mississippi,Chickasaw County,12,1114,521,593
Mississippi,Chickasaw County,13,1074,509,565
Mississippi,Chickasaw County,14,936,455,481
Mississippi,Chickasaw County,15,730,333,397
Mississippi,Chickasaw County,16,529,225,304
Mississippi,Chickasaw County,17,414,165,249
Mississippi,Chickasaw County,18,349,103,246
Mississippi,Choctaw County,0,8278,4044,4234
Mississippi,Choctaw County,1,469,249,220
Mississippi,Choctaw County,2,486,245,241
Mississippi,Choctaw County,3,555,298,257
Mississippi,Choctaw County,4,471,250,221
Mississippi,Choctaw County,5,427,212,215
Mississippi,Choctaw County,6,489,246,243
Mississippi,Choctaw County,7,470,230,240
Mississippi,Choctaw County,8,447,224,223
Mississippi,Choctaw County,9,452,215,237
Mississippi,Choctaw County,10,506,240,266
Mississippi,Choctaw County,11,545,278,267
Mississippi,Choctaw County,12,618,302,316
Mississippi,Choctaw County,13,558,286,272
Mississippi,Choctaw County,14,530,235,295
Mississippi,Choctaw County,15,456,232,224
Mississippi,Choctaw County,16,342,131,211
Mississippi,Choctaw County,17,254,99,155
Mississippi,Choctaw County,18,203,72,131
Mississippi,Claiborne County,0,9002,4265,4737
Mississippi,Claiborne County,1,539,280,259
Mississippi,Claiborne County,2,497,250,247
Mississippi,Claiborne County,3,529,268,261
Mississippi,Claiborne County,4,935,445,490
Mississippi,Claiborne County,5,1247,606,641
Mississippi,Claiborne County,6,520,231,289
Mississippi,Claiborne County,7,448,225,223
Mississippi,Claiborne County,8,464,214,250
Mississippi,Claiborne County,9,458,239,219
Mississippi,Claiborne County,10,404,180,224
Mississippi,Claiborne County,11,430,202,228
Mississippi,Claiborne County,12,509,244,265
Mississippi,Claiborne County,13,550,260,290
Mississippi,Claiborne County,14,546,282,264
Mississippi,Claiborne County,15,325,139,186
Mississippi,Claiborne County,16,235,89,146
Mississippi,Claiborne County,17,177,58,119
Mississippi,Claiborne County,18,189,53,136
Mississippi,Clarke County,0,15604,7297,8307
Mississippi,Clarke County,1,888,427,461
Mississippi,Clarke County,2,877,432,445
Mississippi,Clarke County,3,1063,527,536
Mississippi,Clarke County,4,950,457,493
Mississippi,Clarke County,5,902,474,428
Mississippi,Clarke County,6,939,446,493
Mississippi,Clarke County,7,879,401,478
Mississippi,Clarke County,8,866,380,486
Mississippi,Clarke County,9,820,387,433
Mississippi,Clarke County,10,946,440,506
Mississippi,Clarke County,11,1009,475,534
Mississippi,Clarke County,12,1138,524,614
Mississippi,Clarke County,13,1137,546,591
Mississippi,Clarke County,14,979,436,543
Mississippi,Clarke County,15,852,391,461
Mississippi,Clarke County,16,603,274,329
Mississippi,Clarke County,17,414,168,246
Mississippi,Clarke County,18,342,112,230
Mississippi,Clay County,0,19386,9080,10306
Mississippi,Clay County,1,1091,553,538
Mississippi,Clay County,2,1176,567,609
Mississippi,Clay County,3,1340,664,676
Mississippi,Clay County,4,1220,627,593
Mississippi,Clay County,5,1178,575,603
Mississippi,Clay County,6,1398,659,739
Mississippi,Clay County,7,1160,571,589
Mississippi,Clay County,8,1156,542,614
Mississippi,Clay County,9,1066,489,577
Mississippi,Clay County,10,1133,531,602
Mississippi,Clay County,11,1141,536,605
Mississippi,Clay County,12,1331,585,746
Mississippi,Clay County,13,1416,652,764
Mississippi,Clay County,14,1134,514,620
Mississippi,Clay County,15,956,431,525
Mississippi,Clay County,16,607,270,337
Mississippi,Clay County,17,453,185,268
Mississippi,Clay County,18,430,129,301
Mississippi,Coahoma County,0,22628,10487,12141
Mississippi,Coahoma County,1,1783,887,896
Mississippi,Coahoma County,2,1741,875,866
Mississippi,Coahoma County,3,1624,835,789
Mississippi,Coahoma County,4,1671,836,835
Mississippi,Coahoma County,5,1618,785,833
Mississippi,Coahoma County,6,1524,704,820
Mississippi,Coahoma County,7,1259,570,689
Mississippi,Coahoma County,8,1312,544,768
Mississippi,Coahoma County,9,1160,516,644
Mississippi,Coahoma County,10,1174,516,658
Mississippi,Coahoma County,11,1351,624,727
Mississippi,Coahoma County,12,1468,645,823
Mississippi,Coahoma County,13,1451,658,793
Mississippi,Coahoma County,14,1185,564,621
Mississippi,Coahoma County,15,872,413,459
Mississippi,Coahoma County,16,605,216,389
Mississippi,Coahoma County,17,430,158,272
Mississippi,Coahoma County,18,400,141,259
Mississippi,Copiah County,0,28543,13737,14806
Mississippi,Copiah County,1,1709,846,863
Mississippi,Copiah County,2,1829,932,897
Mississippi,Copiah County,3,1911,966,945
Mississippi,Copiah County,4,2177,1122,1055
Mississippi,Copiah County,5,1892,968,924
Mississippi,Copiah County,6,1789,880,909
Mississippi,Copiah County,7,1632,798,834
Mississippi,Copiah County,8,1701,819,882
Mississippi,Copiah County,9,1542,744,798
Mississippi,Copiah County,10,1573,721,852
Mississippi,Copiah County,11,1760,807,953
Mississippi,Copiah County,12,2047,981,1066
Mississippi,Copiah County,13,1946,945,1001
Mississippi,Copiah County,14,1679,773,906
Mississippi,Copiah County,15,1310,609,701
Mississippi,Copiah County,16,879,409,470
Mississippi,Copiah County,17,558,222,336
Mississippi,Copiah County,18,609,195,414
Mississippi,Covington County,0,18853,9184,9669
Mississippi,Covington County,1,1230,613,617
Mississippi,Covington County,2,1309,671,638
Mississippi,Covington County,3,1327,708,619
Mississippi,Covington County,4,1218,627,591
Mississippi,Covington County,5,1108,537,571
Mississippi,Covington County,6,1311,695,616
Mississippi,Covington County,7,1128,526,602
Mississippi,Covington County,8,1211,599,612
Mississippi,Covington County,9,1016,491,525
Mississippi,Covington County,10,1168,566,602
Mississippi,Covington County,11,1170,538,632
Mississippi,Covington County,12,1278,617,661
Mississippi,Covington County,13,1194,593,601
Mississippi,Covington County,14,1012,480,532
Mississippi,Covington County,15,791,351,440
Mississippi,Covington County,16,618,271,347
Mississippi,Covington County,17,398,176,222
Mississippi,Covington County,18,366,125,241
Mississippi,DeSoto County,0,182001,87795,94206
Mississippi,DeSoto County,1,11175,5647,5528
Mississippi,DeSoto County,2,12647,6419,6228
Mississippi,DeSoto County,3,14122,7192,6930
Mississippi,DeSoto County,4,13468,6996,6472
Mississippi,DeSoto County,5,11198,5719,5479
Mississippi,DeSoto County,6,12260,6076,6184
Mississippi,DeSoto County,7,11463,5345,6118
Mississippi,DeSoto County,8,12902,5950,6952
Mississippi,DeSoto County,9,12503,5769,6734
Mississippi,DeSoto County,10,13381,6364,7017
Mississippi,DeSoto County,11,12020,5785,6235
Mississippi,DeSoto County,12,11422,5490,5932
Mississippi,DeSoto County,13,9972,4763,5209
Mississippi,DeSoto County,14,8017,3714,4303
Mississippi,DeSoto County,15,6472,2950,3522
Mississippi,DeSoto County,16,4320,1858,2462
Mississippi,DeSoto County,17,2537,1050,1487
Mississippi,DeSoto County,18,2122,708,1414
Mississippi,Forrest County,0,75036,35611,39425
Mississippi,Forrest County,1,4901,2485,2416
Mississippi,Forrest County,2,4913,2529,2384
Mississippi,Forrest County,3,4849,2458,2391
Mississippi,Forrest County,4,5266,2485,2781
Mississippi,Forrest County,5,8163,3667,4496
Mississippi,Forrest County,6,6308,3070,3238
Mississippi,Forrest County,7,4993,2454,2539
Mississippi,Forrest County,8,4830,2351,2479
Mississippi,Forrest County,9,4095,1998,2097
Mississippi,Forrest County,10,4027,1958,2069
Mississippi,Forrest County,11,4122,1916,2206
Mississippi,Forrest County,12,4485,2107,2378
Mississippi,Forrest County,13,3896,1823,2073
Mississippi,Forrest County,14,3274,1505,1769
Mississippi,Forrest County,15,2583,1159,1424
Mississippi,Forrest County,16,1839,769,1070
Mississippi,Forrest County,17,1233,483,750
Mississippi,Forrest County,18,1259,394,865
Mississippi,Franklin County,0,7788,3828,3960
Mississippi,Franklin County,1,419,219,200
Mississippi,Franklin County,2,475,263,212
Mississippi,Franklin County,3,587,291,296
Mississippi,Franklin County,4,513,262,251
Mississippi,Franklin County,5,396,205,191
Mississippi,Franklin County,6,422,212,210
Mississippi,Franklin County,7,402,211,191
Mississippi,Franklin County,8,432,198,234
Mississippi,Franklin County,9,442,198,244
Mississippi,Franklin County,10,485,235,250
Mississippi,Franklin County,11,468,227,241
Mississippi,Franklin County,12,578,275,303
Mississippi,Franklin County,13,616,322,294
Mississippi,Franklin County,14,476,248,228
Mississippi,Franklin County,15,391,174,217
Mississippi,Franklin County,16,300,138,162
Mississippi,Franklin County,17,214,96,118
Mississippi,Franklin County,18,172,54,118
Mississippi,George County,0,24250,12260,11990
Mississippi,George County,1,1864,956,908
Mississippi,George County,2,1805,892,913
Mississippi,George County,3,1730,833,897
Mississippi,George County,4,1569,795,774
Mississippi,George County,5,1466,790,676
Mississippi,George County,6,1963,1079,884
Mississippi,George County,7,1423,732,691
Mississippi,George County,8,1480,792,688
Mississippi,George County,9,1401,716,685
Mississippi,George County,10,1557,802,755
Mississippi,George County,11,1529,769,760
Mississippi,George County,12,1573,807,766
Mississippi,George County,13,1377,673,704
Mississippi,George County,14,1155,531,624
Mississippi,George County,15,1035,493,542
Mississippi,George County,16,692,321,371
Mississippi,George County,17,400,185,215
Mississippi,George County,18,231,94,137
Mississippi,Greene County,0,13586,7859,5727
Mississippi,Greene County,1,637,317,320
Mississippi,Greene County,2,683,348,335
Mississippi,Greene County,3,850,423,427
Mississippi,Greene County,4,749,407,342
Mississippi,Greene County,5,948,627,321
Mississippi,Greene County,6,1188,814,374
Mississippi,Greene County,7,1051,737,314
Mississippi,Greene County,8,991,635,356
Mississippi,Greene County,9,943,606,337
Mississippi,Greene County,10,1047,664,383
Mississippi,Greene County,11,853,505,348
Mississippi,Greene County,12,847,449,398
Mississippi,Greene County,13,779,401,378
Mississippi,Greene County,14,624,309,315
Mississippi,Greene County,15,572,279,293
Mississippi,Greene County,16,389,172,217
Mississippi,Greene County,17,240,99,141
Mississippi,Greene County,18,195,67,128
Mississippi,Grenada County,0,21055,10015,11040
Mississippi,Grenada County,1,1351,693,658
Mississippi,Grenada County,2,1367,682,685
Mississippi,Grenada County,3,1484,761,723
Mississippi,Grenada County,4,1270,660,610
Mississippi,Grenada County,5,1306,650,656
Mississippi,Grenada County,6,1451,704,747
Mississippi,Grenada County,7,1120,500,620
Mississippi,Grenada County,8,1211,580,631
Mississippi,Grenada County,9,1221,572,649
Mississippi,Grenada County,10,1327,618,709
Mississippi,Grenada County,11,1389,667,722
Mississippi,Grenada County,12,1443,681,762
Mississippi,Grenada County,13,1371,653,718
Mississippi,Grenada County,14,1216,558,658
Mississippi,Grenada County,15,986,441,545
Mississippi,Grenada County,16,691,279,412
Mississippi,Grenada County,17,452,191,261
Mississippi,Grenada County,18,399,125,274
Mississippi,Hancock County,0,47334,23137,24197
Mississippi,Hancock County,1,2433,1315,1118
Mississippi,Hancock County,2,2542,1314,1228
Mississippi,Hancock County,3,2876,1433,1443
Mississippi,Hancock County,4,2834,1495,1339
Mississippi,Hancock County,5,2456,1211,1245
Mississippi,Hancock County,6,2932,1481,1451
Mississippi,Hancock County,7,2679,1310,1369
Mississippi,Hancock County,8,2754,1303,1451
Mississippi,Hancock County,9,2582,1234,1348
Mississippi,Hancock County,10,3124,1520,1604
Mississippi,Hancock County,11,3244,1603,1641
Mississippi,Hancock County,12,3834,1819,2015
Mississippi,Hancock County,13,3661,1785,1876
Mississippi,Hancock County,14,3090,1432,1658
Mississippi,Hancock County,15,2586,1241,1345
Mississippi,Hancock County,16,1743,795,948
Mississippi,Hancock County,17,1093,511,582
Mississippi,Hancock County,18,871,335,536
Mississippi,Harrison County,0,206650,101231,105419
Mississippi,Harrison County,1,13508,6881,6627
Mississippi,Harrison County,2,13775,7038,6737
Mississippi,Harrison County,3,14169,7271,6898
Mississippi,Harrison County,4,13714,7407,6307
Mississippi,Harrison County,5,13992,7475,6517
Mississippi,Harrison County,6,15219,7557,7662
Mississippi,Harrison County,7,14111,6706,7405
Mississippi,Harrison County,8,13465,6515,6950
Mississippi,Harrison County,9,11953,5787,6166
Mississippi,Harrison County,10,12370,5781,6589
Mississippi,Harrison County,11,12665,6032,6633
Mississippi,Harrison County,12,14265,6924,7341
Mississippi,Harrison County,13,12540,5961,6579
Mississippi,Harrison County,14,10560,4899,5661
Mississippi,Harrison County,15,8205,3831,4374
Mississippi,Harrison County,16,5541,2540,3001
Mississippi,Harrison County,17,3485,1488,1997
Mississippi,Harrison County,18,3113,1138,1975
Mississippi,Hinds County,0,237085,110637,126448
Mississippi,Hinds County,1,15155,7764,7391
Mississippi,Hinds County,2,15710,8058,7652
Mississippi,Hinds County,3,16560,8465,8095
Mississippi,Hinds County,4,17807,8662,9145
Mississippi,Hinds County,5,18501,8767,9734
Mississippi,Hinds County,6,18746,8960,9786
Mississippi,Hinds County,7,15751,7214,8537
Mississippi,Hinds County,8,15176,7086,8090
Mississippi,Hinds County,9,13131,5943,7188
Mississippi,Hinds County,10,13575,6170,7405
Mississippi,Hinds County,11,13804,6328,7476
Mississippi,Hinds County,12,15315,6956,8359
Mississippi,Hinds County,13,14513,6495,8018
Mississippi,Hinds County,14,11662,5178,6484
Mississippi,Hinds County,15,8350,3718,4632
Mississippi,Hinds County,16,5578,2221,3357
Mississippi,Hinds County,17,3744,1456,2288
Mississippi,Hinds County,18,4007,1196,2811
Mississippi,Holmes County,0,17622,8422,9200
Mississippi,Holmes County,1,1163,631,532
Mississippi,Holmes County,2,1246,641,605
Mississippi,Holmes County,3,1332,695,637
Mississippi,Holmes County,4,1460,760,700
Mississippi,Holmes County,5,1420,716,704
Mississippi,Holmes County,6,1283,656,627
Mississippi,Holmes County,7,1004,476,528
Mississippi,Holmes County,8,971,451,520
Mississippi,Holmes County,9,878,393,485
Mississippi,Holmes County,10,932,415,517
Mississippi,Holmes County,11,1020,443,577
Mississippi,Holmes County,12,1204,548,656
Mississippi,Holmes County,13,1057,494,563
Mississippi,Holmes County,14,853,363,490
Mississippi,Holmes County,15,666,309,357
Mississippi,Holmes County,16,476,202,274
Mississippi,Holmes County,17,323,121,202
Mississippi,Holmes County,18,334,108,226
Mississippi,Humphreys County,0,8257,3886,4371
Mississippi,Humphreys County,1,469,234,235
Mississippi,Humphreys County,2,632,332,300
Mississippi,Humphreys County,3,673,339,334
Mississippi,Humphreys County,4,584,301,283
Mississippi,Humphreys County,5,484,239,245
Mississippi,Humphreys County,6,496,249,247
Mississippi,Humphreys County,7,478,232,246
Mississippi,Humphreys County,8,505,235,270
Mississippi,Humphreys County,9,392,179,213
Mississippi,Humphreys County,10,443,193,250
Mississippi,Humphreys County,11,510,220,290
Mississippi,Humphreys County,12,637,296,341
Mississippi,Humphreys County,13,552,258,294
Mississippi,Humphreys County,14,476,218,258
Mississippi,Humphreys County,15,337,148,189
Mississippi,Humphreys County,16,260,117,143
Mississippi,Humphreys County,17,184,66,118
Mississippi,Humphreys County,18,145,30,115
Mississippi,Issaquena County,0,1308,774,534
Mississippi,Issaquena County,1,36,15,21
Mississippi,Issaquena County,2,42,17,25
Mississippi,Issaquena County,3,31,14,17
Mississippi,Issaquena County,4,94,78,16
Mississippi,Issaquena County,5,120,93,27
Mississippi,Issaquena County,6,153,114,39
Mississippi,Issaquena County,7,62,36,26
Mississippi,Issaquena County,8,103,59,44
Mississippi,Issaquena County,9,63,37,26
Mississippi,Issaquena County,10,78,46,32
Mississippi,Issaquena County,11,98,47,51
Mississippi,Issaquena County,12,107,64,43
Mississippi,Issaquena County,13,103,57,46
Mississippi,Issaquena County,14,58,27,31
Mississippi,Issaquena County,15,46,18,28
Mississippi,Issaquena County,16,43,20,23
Mississippi,Issaquena County,17,38,18,20
Mississippi,Issaquena County,18,33,14,19
Mississippi,Itawamba County,0,23517,11594,11923
Mississippi,Itawamba County,1,1313,662,651
Mississippi,Itawamba County,2,1411,697,714
Mississippi,Itawamba County,3,1514,794,720
Mississippi,Itawamba County,4,1785,935,850
Mississippi,Itawamba County,5,1591,804,787
Mississippi,Itawamba County,6,1647,859,788
Mississippi,Itawamba County,7,1326,675,651
Mississippi,Itawamba County,8,1344,668,676
Mississippi,Itawamba County,9,1355,662,693
Mississippi,Itawamba County,10,1569,757,812
Mississippi,Itawamba County,11,1585,825,760
Mississippi,Itawamba County,12,1494,744,750
Mississippi,Itawamba County,13,1431,707,724
Mississippi,Itawamba County,14,1217,589,628
Mississippi,Itawamba County,15,1075,471,604
Mississippi,Itawamba County,16,860,355,505
Mississippi,Itawamba County,17,519,221,298
Mississippi,Itawamba County,18,481,169,312
Mississippi,Jackson County,0,143277,70502,72775
Mississippi,Jackson County,1,8248,4314,3934
Mississippi,Jackson County,2,8958,4569,4389
Mississippi,Jackson County,3,10152,5258,4894
Mississippi,Jackson County,4,9262,4793,4469
Mississippi,Jackson County,5,8331,4279,4052
Mississippi,Jackson County,6,9722,4726,4996
Mississippi,Jackson County,7,9146,4474,4672
Mississippi,Jackson County,8,9299,4485,4814
Mississippi,Jackson County,9,8915,4345,4570
Mississippi,Jackson County,10,9387,4605,4782
Mississippi,Jackson County,11,9592,4787,4805
Mississippi,Jackson County,12,10175,4966,5209
Mississippi,Jackson County,13,9369,4504,4865
Mississippi,Jackson County,14,7538,3623,3915
Mississippi,Jackson County,15,6103,2860,3243
Mississippi,Jackson County,16,4324,1987,2337
Mississippi,Jackson County,17,2694,1138,1556
Mississippi,Jackson County,18,2062,789,1273
Mississippi,Jasper County,0,16428,7947,8481
Mississippi,Jasper County,1,986,512,474
Mississippi,Jasper County,2,1037,527,510
Mississippi,Jasper County,3,1085,546,539
Mississippi,Jasper County,4,905,456,449
Mississippi,Jasper County,5,990,493,497
Mississippi,Jasper County,6,1094,526,568
Mississippi,Jasper County,7,807,389,418
Mississippi,Jasper County,8,936,460,476
Mississippi,Jasper County,9,910,425,485
Mississippi,Jasper County,10,950,470,480
Mississippi,Jasper County,11,1060,522,538
Mississippi,Jasper County,12,1156,539,617
Mississippi,Jasper County,13,1160,548,612
Mississippi,Jasper County,14,1078,512,566
Mississippi,Jasper County,15,832,390,442
Mississippi,Jasper County,16,664,286,378
Mississippi,Jasper County,17,440,208,232
Mississippi,Jasper County,18,338,138,200
Mississippi,Jefferson County,0,7106,3489,3617
Mississippi,Jefferson County,1,458,214,244
Mississippi,Jefferson County,2,486,230,256
Mississippi,Jefferson County,3,416,222,194
Mississippi,Jefferson County,4,401,207,194
Mississippi,Jefferson County,5,460,241,219
Mississippi,Jefferson County,6,524,296,228
Mississippi,Jefferson County,7,431,220,211
Mississippi,Jefferson County,8,460,238,222
Mississippi,Jefferson County,9,372,203,169
Mississippi,Jefferson County,10,417,210,207
Mississippi,Jefferson County,11,424,194,230
Mississippi,Jefferson County,12,568,284,284
Mississippi,Jefferson County,13,490,240,250
Mississippi,Jefferson County,14,406,181,225
Mississippi,Jefferson County,15,263,115,148
Mississippi,Jefferson County,16,206,83,123
Mississippi,Jefferson County,17,153,57,96
Mississippi,Jefferson County,18,171,54,117
Mississippi,Jefferson Davis County,0,11234,5315,5919
Mississippi,Jefferson Davis County,1,602,309,293
Mississippi,Jefferson Davis County,2,674,354,320
Mississippi,Jefferson Davis County,3,592,304,288
Mississippi,Jefferson Davis County,4,567,291,276
Mississippi,Jefferson Davis County,5,708,360,348
Mississippi,Jefferson Davis County,6,725,336,389
Mississippi,Jefferson Davis County,7,535,261,274
Mississippi,Jefferson Davis County,8,616,286,330
Mississippi,Jefferson Davis County,9,632,322,310
Mississippi,Jefferson Davis County,10,682,320,362
Mississippi,Jefferson Davis County,11,715,346,369
Mississippi,Jefferson Davis County,12,812,362,450
Mississippi,Jefferson Davis County,13,824,378,446
Mississippi,Jefferson Davis County,14,805,368,437
Mississippi,Jefferson Davis County,15,672,319,353
Mississippi,Jefferson Davis County,16,487,201,286
Mississippi,Jefferson Davis County,17,274,109,165
Mississippi,Jefferson Davis County,18,312,89,223
Mississippi,Jones County,0,68461,33256,35205
Mississippi,Jones County,1,4593,2369,2224
Mississippi,Jones County,2,4809,2497,2312
Mississippi,Jones County,3,4920,2531,2389
Mississippi,Jones County,4,5044,2520,2524
Mississippi,Jones County,5,4151,2123,2028
Mississippi,Jones County,6,4359,2111,2248
Mississippi,Jones County,7,4014,1888,2126
Mississippi,Jones County,8,4284,2105,2179
Mississippi,Jones County,9,3667,1750,1917
Mississippi,Jones County,10,4127,2065,2062
Mississippi,Jones County,11,3927,1954,1973
Mississippi,Jones County,12,4504,2138,2366
Mississippi,Jones County,13,4485,2165,2320
Mississippi,Jones County,14,3700,1695,2005
Mississippi,Jones County,15,3001,1424,1577
Mississippi,Jones County,16,2091,906,1185
Mississippi,Jones County,17,1443,559,884
Mississippi,Jones County,18,1342,456,886
Mississippi,Kemper County,0,10027,5021,5006
Mississippi,Kemper County,1,445,228,217
Mississippi,Kemper County,2,495,248,247
Mississippi,Kemper County,3,554,304,250
Mississippi,Kemper County,4,947,505,442
Mississippi,Kemper County,5,840,448,392
Mississippi,Kemper County,6,701,400,301
Mississippi,Kemper County,7,498,259,239
Mississippi,Kemper County,8,524,305,219
Mississippi,Kemper County,9,536,268,268
Mississippi,Kemper County,10,605,292,313
Mississippi,Kemper County,11,574,269,305
Mississippi,Kemper County,12,640,294,346
Mississippi,Kemper County,13,643,307,336
Mississippi,Kemper County,14,584,287,297
Mississippi,Kemper County,15,502,240,262
Mississippi,Kemper County,16,335,144,191
Mississippi,Kemper County,17,290,129,161
Mississippi,Kemper County,18,314,94,220
Mississippi,Lafayette County,0,54793,26552,28241
Mississippi,Lafayette County,1,2755,1316,1439
Mississippi,Lafayette County,2,2739,1361,1378
Mississippi,Lafayette County,3,2791,1415,1376
Mississippi,Lafayette County,4,5887,2792,3095
Mississippi,Lafayette County,5,8401,4144,4257
Mississippi,Lafayette County,6,4221,2174,2047
Mississippi,Lafayette County,7,3508,1775,1733
Mississippi,Lafayette County,8,3423,1775,1648
Mississippi,Lafayette County,9,2944,1446,1498
Mississippi,Lafayette County,10,2911,1421,1490
Mississippi,Lafayette County,11,2699,1285,1414
Mississippi,Lafayette County,12,2836,1316,1520
Mississippi,Lafayette County,13,2749,1303,1446
Mississippi,Lafayette County,14,2454,1127,1327
Mississippi,Lafayette County,15,1821,880,941
Mississippi,Lafayette County,16,1209,526,683
Mississippi,Lafayette County,17,735,292,443
Mississippi,Lafayette County,18,710,204,506
Mississippi,Lamar County,0,62447,30001,32446
Mississippi,Lamar County,1,4072,2053,2019
Mississippi,Lamar County,2,4284,2188,2096
Mississippi,Lamar County,3,4559,2257,2302
Mississippi,Lamar County,4,3876,1970,1906
Mississippi,Lamar County,5,3885,1900,1985
Mississippi,Lamar County,6,4616,2247,2369
Mississippi,Lamar County,7,4525,2056,2469
Mississippi,Lamar County,8,4702,2196,2506
Mississippi,Lamar County,9,4084,1970,2114
Mississippi,Lamar County,10,4092,2042,2050
Mississippi,Lamar County,11,3794,1817,1977
Mississippi,Lamar County,12,3809,1788,2021
Mississippi,Lamar County,13,3546,1707,1839
Mississippi,Lamar County,14,2901,1373,1528
Mississippi,Lamar County,15,2225,1015,1210
Mississippi,Lamar County,16,1596,713,883
Mississippi,Lamar County,17,978,377,601
Mississippi,Lamar County,18,903,332,571
Mississippi,Lauderdale County,0,75317,36501,38816
Mississippi,Lauderdale County,1,4767,2383,2384
Mississippi,Lauderdale County,2,4663,2378,2285
Mississippi,Lauderdale County,3,5191,2618,2573
Mississippi,Lauderdale County,4,5016,2594,2422
Mississippi,Lauderdale County,5,4584,2407,2177
Mississippi,Lauderdale County,6,5426,2761,2665
Mississippi,Lauderdale County,7,4615,2322,2293
Mississippi,Lauderdale County,8,4562,2260,2302
Mississippi,Lauderdale County,9,4293,2096,2197
Mississippi,Lauderdale County,10,4611,2209,2402
Mississippi,Lauderdale County,11,4728,2210,2518
Mississippi,Lauderdale County,12,4930,2398,2532
Mississippi,Lauderdale County,13,4859,2271,2588
Mississippi,Lauderdale County,14,4229,1943,2286
Mississippi,Lauderdale County,15,3210,1473,1737
Mississippi,Lauderdale County,16,2361,1023,1338
Mississippi,Lauderdale County,17,1643,653,990
Mississippi,Lauderdale County,18,1629,502,1127
Mississippi,Lawrence County,0,12455,6044,6411
Mississippi,Lawrence County,1,788,380,408
Mississippi,Lawrence County,2,835,447,388
Mississippi,Lawrence County,3,901,454,447
Mississippi,Lawrence County,4,772,387,385
Mississippi,Lawrence County,5,655,312,343
Mississippi,Lawrence County,6,731,364,367
Mississippi,Lawrence County,7,695,326,369
Mississippi,Lawrence County,8,774,410,364
Mississippi,Lawrence County,9,702,324,378
Mississippi,Lawrence County,10,729,353,376
Mississippi,Lawrence County,11,822,401,421
Mississippi,Lawrence County,12,918,430,488
Mississippi,Lawrence County,13,893,447,446
Mississippi,Lawrence County,14,717,351,366
Mississippi,Lawrence County,15,582,262,320
Mississippi,Lawrence County,16,451,205,246
Mississippi,Lawrence County,17,288,112,176
Mississippi,Lawrence County,18,202,79,123
Mississippi,Leake County,0,22763,11752,11011
Mississippi,Leake County,1,1448,761,687
Mississippi,Leake County,2,1407,732,675
Mississippi,Leake County,3,1708,1018,690
Mississippi,Leake County,4,1771,1201,570
Mississippi,Leake County,5,1360,779,581
Mississippi,Leake County,6,1569,786,783
Mississippi,Leake County,7,1347,697,650
Mississippi,Leake County,8,1511,768,743
Mississippi,Leake County,9,1296,647,649
Mississippi,Leake County,10,1422,662,760
Mississippi,Leake County,11,1360,683,677
Mississippi,Leake County,12,1434,747,687
Mississippi,Leake County,13,1411,649,762
Mississippi,Leake County,14,1256,605,651
Mississippi,Leake County,15,920,428,492
Mississippi,Leake County,16,618,262,356
Mississippi,Leake County,17,469,170,299
Mississippi,Leake County,18,456,157,299
Mississippi,Lee County,0,85202,40726,44476
Mississippi,Lee County,1,5826,2917,2909
Mississippi,Lee County,2,5823,2945,2878
Mississippi,Lee County,3,6211,3255,2956
Mississippi,Lee County,4,5679,2938,2741
Mississippi,Lee County,5,5108,2499,2609
Mississippi,Lee County,6,5994,2876,3118
Mississippi,Lee County,7,5296,2473,2823
Mississippi,Lee County,8,5635,2684,2951
Mississippi,Lee County,9,5243,2482,2761
Mississippi,Lee County,10,5489,2670,2819
Mississippi,Lee County,11,5573,2696,2877
Mississippi,Lee County,12,5605,2655,2950
Mississippi,Lee County,13,5122,2382,2740
Mississippi,Lee County,14,4049,1803,2246
Mississippi,Lee County,15,3322,1469,1853
Mississippi,Lee County,16,2271,1007,1264
Mississippi,Lee County,17,1548,571,977
Mississippi,Lee County,18,1408,404,1004
Mississippi,Leflore County,0,28919,13483,15436
Mississippi,Leflore County,1,2236,1086,1150
Mississippi,Leflore County,2,2170,1130,1040
Mississippi,Leflore County,3,2297,1154,1143
Mississippi,Leflore County,4,2203,1116,1087
Mississippi,Leflore County,5,2331,1120,1211
Mississippi,Leflore County,6,2021,1017,1004
Mississippi,Leflore County,7,1683,796,887
Mississippi,Leflore County,8,1708,783,925
Mississippi,Leflore County,9,1556,693,863
Mississippi,Leflore County,10,1532,651,881
Mississippi,Leflore County,11,1535,703,832
Mississippi,Leflore County,12,1756,764,992
Mississippi,Leflore County,13,1720,750,970
Mississippi,Leflore County,14,1387,633,754
Mississippi,Leflore County,15,1005,442,563
Mississippi,Leflore County,16,735,315,420
Mississippi,Leflore County,17,479,175,304
Mississippi,Leflore County,18,565,155,410
Mississippi,Lincoln County,0,34205,16296,17909
Mississippi,Lincoln County,1,2079,1028,1051
Mississippi,Lincoln County,2,2232,1161,1071
Mississippi,Lincoln County,3,2388,1248,1140
Mississippi,Lincoln County,4,2142,1039,1103
Mississippi,Lincoln County,5,1907,962,945
Mississippi,Lincoln County,6,2245,1074,1171
Mississippi,Lincoln County,7,1900,908,992
Mississippi,Lincoln County,8,2264,1069,1195
Mississippi,Lincoln County,9,2103,1022,1081
Mississippi,Lincoln County,10,2294,1107,1187
Mississippi,Lincoln County,11,2134,1029,1105
Mississippi,Lincoln County,12,2353,1112,1241
Mississippi,Lincoln County,13,2283,1059,1224
Mississippi,Lincoln County,14,1956,882,1074
Mississippi,Lincoln County,15,1481,705,776
Mississippi,Lincoln County,16,1078,417,661
Mississippi,Lincoln County,17,687,253,434
Mississippi,Lincoln County,18,679,221,458
Mississippi,Lowndes County,0,58930,28055,30875
Mississippi,Lowndes County,1,3791,1998,1793
Mississippi,Lowndes County,2,3800,1950,1850
Mississippi,Lowndes County,3,4053,2109,1944
Mississippi,Lowndes County,4,3817,1882,1935
Mississippi,Lowndes County,5,4280,2058,2222
Mississippi,Lowndes County,6,4444,2120,2324
Mississippi,Lowndes County,7,3736,1829,1907
Mississippi,Lowndes County,8,3621,1745,1876
Mississippi,Lowndes County,9,3262,1543,1719
Mississippi,Lowndes County,10,3406,1523,1883
Mississippi,Lowndes County,11,3561,1671,1890
Mississippi,Lowndes County,12,4004,1899,2105
Mississippi,Lowndes County,13,3803,1760,2043
Mississippi,Lowndes County,14,3080,1442,1638
Mississippi,Lowndes County,15,2394,1083,1311
Mississippi,Lowndes County,16,1594,695,899
Mississippi,Lowndes County,17,1130,417,713
Mississippi,Lowndes County,18,1154,331,823
Mississippi,Madison County,0,105630,50599,55031
Mississippi,Madison County,1,6684,3361,3323
Mississippi,Madison County,2,7145,3629,3516
Mississippi,Madison County,3,7897,4101,3796
Mississippi,Madison County,4,7435,3699,3736
Mississippi,Madison County,5,6445,3169,3276
Mississippi,Madison County,6,6813,3353,3460
Mississippi,Madison County,7,6805,3166,3639
Mississippi,Madison County,8,7458,3555,3903
Mississippi,Madison County,9,6954,3257,3697
Mississippi,Madison County,10,7149,3405,3744
Mississippi,Madison County,11,6862,3275,3587
Mississippi,Madison County,12,7396,3506,3890
Mississippi,Madison County,13,6544,3054,3490
Mississippi,Madison County,14,5405,2470,2935
Mississippi,Madison County,15,3624,1738,1886
Mississippi,Madison County,16,2112,896,1216
Mississippi,Madison County,17,1434,541,893
Mississippi,Madison County,18,1468,424,1044
Mississippi,Marion County,0,24715,11946,12769
Mississippi,Marion County,1,1433,739,694
Mississippi,Marion County,2,1619,780,839
Mississippi,Marion County,3,1713,835,878
Mississippi,Marion County,4,1451,768,683
Mississippi,Marion County,5,1447,718,729
Mississippi,Marion County,6,1563,775,788
Mississippi,Marion County,7,1464,743,721
Mississippi,Marion County,8,1588,789,799
Mississippi,Marion County,9,1473,754,719
Mississippi,Marion County,10,1519,761,758
Mississippi,Marion County,11,1494,706,788
Mississippi,Marion County,12,1721,832,889
Mississippi,Marion County,13,1639,777,862
Mississippi,Marion County,14,1428,677,751
Mississippi,Marion County,15,1200,541,659
Mississippi,Marion County,16,757,322,435
Mississippi,Marion County,17,586,241,345
Mississippi,Marion County,18,620,188,432
Mississippi,Marshall County,0,35451,17596,17855
Mississippi,Marshall County,1,1997,1046,951
Mississippi,Marshall County,2,2001,993,1008
Mississippi,Marshall County,3,2134,1095,1039
Mississippi,Marshall County,4,2268,1082,1186
Mississippi,Marshall County,5,2397,1161,1236
Mississippi,Marshall County,6,2426,1306,1120
Mississippi,Marshall County,7,1959,1073,886
Mississippi,Marshall County,8,2041,1039,1002
Mississippi,Marshall County,9,2086,1108,978
Mississippi,Marshall County,10,2177,1101,1076
Mississippi,Marshall County,11,2476,1279,1197
Mississippi,Marshall County,12,2662,1329,1333
Mississippi,Marshall County,13,2613,1262,1351
Mississippi,Marshall County,14,2196,1001,1195
Mississippi,Marshall County,15,1623,768,855
Mississippi,Marshall County,16,1109,481,628
Mississippi,Marshall County,17,681,280,401
Mississippi,Marshall County,18,605,192,413
Mississippi,Monroe County,0,35564,16944,18620
Mississippi,Monroe County,1,2005,980,1025
Mississippi,Monroe County,2,2125,1102,1023
Mississippi,Monroe County,3,2524,1254,1270
Mississippi,Monroe County,4,2182,1085,1097
Mississippi,Monroe County,5,1977,979,998
Mississippi,Monroe County,6,2271,1125,1146
Mississippi,Monroe County,7,2043,1024,1019
Mississippi,Monroe County,8,2033,973,1060
Mississippi,Monroe County,9,2066,987,1079
Mississippi,Monroe County,10,2264,1118,1146
Mississippi,Monroe County,11,2370,1124,1246
Mississippi,Monroe County,12,2462,1147,1315
Mississippi,Monroe County,13,2411,1146,1265
Mississippi,Monroe County,14,2127,988,1139
Mississippi,Monroe County,15,1785,839,946
Mississippi,Monroe County,16,1216,487,729
Mississippi,Monroe County,17,899,341,558
Mississippi,Monroe County,18,804,245,559
Mississippi,Montgomery County,0,10023,4784,5239
Mississippi,Montgomery County,1,598,292,306
Mississippi,Montgomery County,2,628,308,320
Mississippi,Montgomery County,3,655,323,332
Mississippi,Montgomery County,4,568,292,276
Mississippi,Montgomery County,5,530,277,253
Mississippi,Montgomery County,6,667,341,326
Mississippi,Montgomery County,7,492,227,265
Mississippi,Montgomery County,8,547,273,274
Mississippi,Montgomery County,9,487,234,253
Mississippi,Montgomery County,10,547,248,299
Mississippi,Montgomery County,11,672,311,361
Mississippi,Montgomery County,12,752,357,395
Mississippi,Montgomery County,13,711,344,367
Mississippi,Montgomery County,14,632,314,318
Mississippi,Montgomery County,15,593,268,325
Mississippi,Montgomery County,16,422,194,228
Mississippi,Montgomery County,17,243,97,146
Mississippi,Montgomery County,18,279,84,195
Mississippi,Neshoba County,0,29125,13866,15259
Mississippi,Neshoba County,1,2086,1054,1032
Mississippi,Neshoba County,2,2185,1067,1118
Mississippi,Neshoba County,3,2468,1264,1204
Mississippi,Neshoba County,4,2123,1080,1043
Mississippi,Neshoba County,5,1758,838,920
Mississippi,Neshoba County,6,1831,867,964
Mississippi,Neshoba County,7,1671,785,886
Mississippi,Neshoba County,8,1749,838,911
Mississippi,Neshoba County,9,1667,754,913
Mississippi,Neshoba County,10,1718,821,897
Mississippi,Neshoba County,11,1681,775,906
Mississippi,Neshoba County,12,1754,853,901
Mississippi,Neshoba County,13,1826,834,992
Mississippi,Neshoba County,14,1541,742,799
Mississippi,Neshoba County,15,1180,552,628
Mississippi,Neshoba County,16,759,346,413
Mississippi,Neshoba County,17,570,215,355
Mississippi,Neshoba County,18,558,181,377
Mississippi,Newton County,0,21443,10259,11184
Mississippi,Newton County,1,1378,677,701
Mississippi,Newton County,2,1503,743,760
Mississippi,Newton County,3,1600,803,797
Mississippi,Newton County,4,1750,918,832
Mississippi,Newton County,5,1391,686,705
Mississippi,Newton County,6,1390,693,697
Mississippi,Newton County,7,1130,539,591
Mississippi,Newton County,8,1210,567,643
Mississippi,Newton County,9,1307,636,671
Mississippi,Newton County,10,1411,667,744
Mississippi,Newton County,11,1237,603,634
Mississippi,Newton County,12,1283,631,652
Mississippi,Newton County,13,1268,568,700
Mississippi,Newton County,14,1128,507,621
Mississippi,Newton County,15,942,433,509
Mississippi,Newton County,16,646,271,375
Mississippi,Newton County,17,445,185,260
Mississippi,Newton County,18,424,132,292
Mississippi,Noxubee County,0,10535,4968,5567
Mississippi,Noxubee County,1,770,380,390
Mississippi,Noxubee County,2,683,334,349
Mississippi,Noxubee County,3,714,370,344
Mississippi,Noxubee County,4,659,352,307
Mississippi,Noxubee County,5,746,347,399
Mississippi,Noxubee County,6,726,355,371
Mississippi,Noxubee County,7,648,317,331
Mississippi,Noxubee County,8,620,288,332
Mississippi,Noxubee County,9,529,242,287
Mississippi,Noxubee County,10,602,270,332
Mississippi,Noxubee County,11,645,282,363
Mississippi,Noxubee County,12,713,324,389
Mississippi,Noxubee County,13,756,370,386
Mississippi,Noxubee County,14,542,272,270
Mississippi,Noxubee County,15,438,182,256
Mississippi,Noxubee County,16,292,128,164
Mississippi,Noxubee County,17,228,91,137
Mississippi,Noxubee County,18,224,64,160
Mississippi,Oktibbeha County,0,49599,24736,24863
Mississippi,Oktibbeha County,1,2668,1374,1294
Mississippi,Oktibbeha County,2,2396,1221,1175
Mississippi,Oktibbeha County,3,2382,1228,1154
Mississippi,Oktibbeha County,4,5066,2497,2569
Mississippi,Oktibbeha County,5,11388,6253,5135
Mississippi,Oktibbeha County,6,4139,2120,2019
Mississippi,Oktibbeha County,7,2738,1336,1402
Mississippi,Oktibbeha County,8,2581,1293,1288
Mississippi,Oktibbeha County,9,1996,965,1031
Mississippi,Oktibbeha County,10,1934,913,1021
Mississippi,Oktibbeha County,11,2067,936,1131
Mississippi,Oktibbeha County,12,2283,1025,1258
Mississippi,Oktibbeha County,13,2251,1076,1175
Mississippi,Oktibbeha County,14,1795,844,951
Mississippi,Oktibbeha County,15,1371,627,744
Mississippi,Oktibbeha County,16,1089,469,620
Mississippi,Oktibbeha County,17,700,296,404
Mississippi,Oktibbeha County,18,755,263,492
Mississippi,Panola County,0,34178,16423,17755
Mississippi,Panola County,1,2349,1215,1134
Mississippi,Panola County,2,2309,1172,1137
Mississippi,Panola County,3,2379,1211,1168
Mississippi,Panola County,4,2245,1143,1102
Mississippi,Panola County,5,2159,1111,1048
Mississippi,Panola County,6,2449,1213,1236
Mississippi,Panola County,7,2099,895,1204
Mississippi,Panola County,8,2001,967,1034
Mississippi,Panola County,9,1932,877,1055
Mississippi,Panola County,10,2055,980,1075
Mississippi,Panola County,11,2243,1059,1184
Mississippi,Panola County,12,2298,1099,1199
Mississippi,Panola County,13,2281,1115,1166
Mississippi,Panola County,14,1792,835,957
Mississippi,Panola County,15,1424,644,780
Mississippi,Panola County,16,964,416,548
Mississippi,Panola County,17,629,263,366
Mississippi,Panola County,18,570,208,362
Mississippi,Pearl River County,0,55387,27264,28123
Mississippi,Pearl River County,1,3210,1630,1580
Mississippi,Pearl River County,2,3470,1793,1677
Mississippi,Pearl River County,3,3671,1814,1857
Mississippi,Pearl River County,4,3798,1993,1805
Mississippi,Pearl River County,5,3306,1718,1588
Mississippi,Pearl River County,6,3479,1790,1689
Mississippi,Pearl River County,7,3047,1480,1567
Mississippi,Pearl River County,8,3114,1524,1590
Mississippi,Pearl River County,9,3190,1511,1679
Mississippi,Pearl River County,10,3492,1745,1747
Mississippi,Pearl River County,11,3633,1784,1849
Mississippi,Pearl River County,12,3836,1908,1928
Mississippi,Pearl River County,13,3746,1776,1970
Mississippi,Pearl River County,14,3460,1649,1811
Mississippi,Pearl River County,15,2849,1352,1497
Mississippi,Pearl River County,16,1957,917,1040
Mississippi,Pearl River County,17,1155,519,636
Mississippi,Pearl River County,18,974,361,613
Mississippi,Perry County,0,11931,5833,6098
Mississippi,Perry County,1,692,391,301
Mississippi,Perry County,2,736,360,376
Mississippi,Perry County,3,805,420,385
Mississippi,Perry County,4,719,382,337
Mississippi,Perry County,5,687,349,338
Mississippi,Perry County,6,815,398,417
Mississippi,Perry County,7,601,266,335
Mississippi,Perry County,8,739,360,379
Mississippi,Perry County,9,719,361,358
Mississippi,Perry County,10,724,350,374
Mississippi,Perry County,11,763,373,390
Mississippi,Perry County,12,905,436,469
Mississippi,Perry County,13,847,417,430
Mississippi,Perry County,14,682,329,353
Mississippi,Perry County,15,591,265,326
Mississippi,Perry County,16,405,180,225
Mississippi,Perry County,17,274,116,158
Mississippi,Perry County,18,227,80,147
Mississippi,Pike County,0,39563,18653,20910
Mississippi,Pike County,1,2669,1295,1374
Mississippi,Pike County,2,2841,1407,1434
Mississippi,Pike County,3,2977,1508,1469
Mississippi,Pike County,4,2943,1523,1420
Mississippi,Pike County,5,2432,1183,1249
Mississippi,Pike County,6,2617,1287,1330
Mississippi,Pike County,7,2072,954,1118
Mississippi,Pike County,8,2361,1108,1253
Mississippi,Pike County,9,2266,1038,1228
Mississippi,Pike County,10,2363,1090,1273
Mississippi,Pike County,11,2241,1061,1180
Mississippi,Pike County,12,2509,1145,1364
Mississippi,Pike County,13,2439,1143,1296
Mississippi,Pike County,14,2309,1022,1287
Mississippi,Pike County,15,1714,783,931
Mississippi,Pike County,16,1194,511,683
Mississippi,Pike County,17,815,336,479
Mississippi,Pike County,18,801,259,542
Mississippi,Pontotoc County,0,31833,15572,16261
Mississippi,Pontotoc County,1,2249,1131,1118
Mississippi,Pontotoc County,2,2226,1112,1114
Mississippi,Pontotoc County,3,2533,1300,1233
Mississippi,Pontotoc County,4,2147,1093,1054
Mississippi,Pontotoc County,5,1884,904,980
Mississippi,Pontotoc County,6,2026,1018,1008
Mississippi,Pontotoc County,7,2018,1018,1000
Mississippi,Pontotoc County,8,2085,1018,1067
Mississippi,Pontotoc County,9,1870,913,957
Mississippi,Pontotoc County,10,1976,960,1016
Mississippi,Pontotoc County,11,2107,1065,1042
Mississippi,Pontotoc County,12,2094,1006,1088
Mississippi,Pontotoc County,13,1855,914,941
Mississippi,Pontotoc County,14,1538,758,780
Mississippi,Pontotoc County,15,1202,561,641
Mississippi,Pontotoc County,16,863,375,488
Mississippi,Pontotoc County,17,575,225,350
Mississippi,Pontotoc County,18,585,201,384
Mississippi,Prentiss County,0,25315,12417,12898
Mississippi,Prentiss County,1,1519,800,719
Mississippi,Prentiss County,2,1596,823,773
Mississippi,Prentiss County,3,1594,832,762
Mississippi,Prentiss County,4,1675,881,794
Mississippi,Prentiss County,5,1802,976,826
Mississippi,Prentiss County,6,1748,854,894
Mississippi,Prentiss County,7,1473,768,705
Mississippi,Prentiss County,8,1499,770,729
Mississippi,Prentiss County,9,1366,680,686
Mississippi,Prentiss County,10,1566,784,782
Mississippi,Prentiss County,11,1681,809,872
Mississippi,Prentiss County,12,1620,783,837
Mississippi,Prentiss County,13,1573,761,812
Mississippi,Prentiss County,14,1332,630,702
Mississippi,Prentiss County,15,1182,487,695
Mississippi,Prentiss County,16,893,367,526
Mississippi,Prentiss County,17,606,237,369
Mississippi,Prentiss County,18,590,175,415
Mississippi,Quitman County,0,7051,3277,3774
Mississippi,Quitman County,1,422,187,235
Mississippi,Quitman County,2,446,229,217
Mississippi,Quitman County,3,447,239,208
Mississippi,Quitman County,4,475,258,217
Mississippi,Quitman County,5,466,220,246
Mississippi,Quitman County,6,474,232,242
Mississippi,Quitman County,7,372,187,185
Mississippi,Quitman County,8,361,162,199
Mississippi,Quitman County,9,442,180,262
Mississippi,Quitman County,10,442,180,262
Mississippi,Quitman County,11,473,219,254
Mississippi,Quitman County,12,506,256,250
Mississippi,Quitman County,13,501,231,270
Mississippi,Quitman County,14,383,157,226
Mississippi,Quitman County,15,320,141,179
Mississippi,Quitman County,16,236,104,132
Mississippi,Quitman County,17,142,49,93
Mississippi,Quitman County,18,143,46,97
Mississippi,Rankin County,0,153902,74073,79829
Mississippi,Rankin County,1,9005,4485,4520
Mississippi,Rankin County,2,9784,5023,4761
Mississippi,Rankin County,3,10531,5387,5144
Mississippi,Rankin County,4,9657,4885,4772
Mississippi,Rankin County,5,8731,4326,4405
Mississippi,Rankin County,6,10569,5124,5445
Mississippi,Rankin County,7,10987,5177,5810
Mississippi,Rankin County,8,11248,5472,5776
Mississippi,Rankin County,9,10690,5213,5477
Mississippi,Rankin County,10,10652,5178,5474
Mississippi,Rankin County,11,9538,4705,4833
Mississippi,Rankin County,12,9879,4747,5132
Mississippi,Rankin County,13,9092,4254,4838
Mississippi,Rankin County,14,7750,3483,4267
Mississippi,Rankin County,15,6320,2817,3503
Mississippi,Rankin County,16,4157,1837,2320
Mississippi,Rankin County,17,2744,1102,1642
Mississippi,Rankin County,18,2568,858,1710
Mississippi,Scott County,0,28287,13883,14404
Mississippi,Scott County,1,2210,1208,1002
Mississippi,Scott County,2,2061,1060,1001
Mississippi,Scott County,3,2176,1141,1035
Mississippi,Scott County,4,1744,926,818
Mississippi,Scott County,5,1692,844,848
Mississippi,Scott County,6,1935,970,965
Mississippi,Scott County,7,1720,857,863
Mississippi,Scott County,8,1667,807,860
Mississippi,Scott County,9,1689,821,868
Mississippi,Scott County,10,1759,909,850
Mississippi,Scott County,11,1740,832,908
Mississippi,Scott County,12,1866,913,953
Mississippi,Scott County,13,1768,830,938
Mississippi,Scott County,14,1372,615,757
Mississippi,Scott County,15,1088,462,626
Mississippi,Scott County,16,787,340,447
Mississippi,Scott County,17,525,200,325
Mississippi,Scott County,18,488,148,340
Mississippi,Sharkey County,0,4377,2091,2286
Mississippi,Sharkey County,1,261,139,122
Mississippi,Sharkey County,2,289,153,136
Mississippi,Sharkey County,3,332,183,149
Mississippi,Sharkey County,4,281,152,129
Mississippi,Sharkey County,5,226,105,121
Mississippi,Sharkey County,6,236,113,123
Mississippi,Sharkey County,7,235,111,124
Mississippi,Sharkey County,8,241,106,135
Mississippi,Sharkey County,9,235,109,126
Mississippi,Sharkey County,10,219,109,110
Mississippi,Sharkey County,11,278,132,146
Mississippi,Sharkey County,12,363,148,215
Mississippi,Sharkey County,13,343,149,194
Mississippi,Sharkey County,14,283,131,152
Mississippi,Sharkey County,15,203,100,103
Mississippi,Sharkey County,16,127,62,65
Mississippi,Sharkey County,17,97,45,52
Mississippi,Sharkey County,18,128,44,84
Mississippi,Simpson County,0,26758,12986,13772
Mississippi,Simpson County,1,1492,725,767
Mississippi,Simpson County,2,1729,891,838
Mississippi,Simpson County,3,1933,1016,917
Mississippi,Simpson County,4,1754,936,818
Mississippi,Simpson County,5,1578,835,743
Mississippi,Simpson County,6,1818,909,909
Mississippi,Simpson County,7,1433,665,768
Mississippi,Simpson County,8,1680,819,861
Mississippi,Simpson County,9,1539,747,792
Mississippi,Simpson County,10,1652,766,886
Mississippi,Simpson County,11,1649,770,879
Mississippi,Simpson County,12,1918,899,1019
Mississippi,Simpson County,13,1877,920,957
Mississippi,Simpson County,14,1526,719,807
Mississippi,Simpson County,15,1187,544,643
Mississippi,Simpson County,16,905,399,506
Mississippi,Simpson County,17,579,235,344
Mississippi,Simpson County,18,509,191,318
Mississippi,Smith County,0,16002,7689,8313
Mississippi,Smith County,1,912,467,445
Mississippi,Smith County,2,993,503,490
Mississippi,Smith County,3,1100,542,558
Mississippi,Smith County,4,1038,522,516
Mississippi,Smith County,5,897,451,446
Mississippi,Smith County,6,1011,489,522
Mississippi,Smith County,7,789,376,413
Mississippi,Smith County,8,975,464,511
Mississippi,Smith County,9,863,412,451
Mississippi,Smith County,10,1033,503,530
Mississippi,Smith County,11,1025,502,523
Mississippi,Smith County,12,1105,512,593
Mississippi,Smith County,13,1123,565,558
Mississippi,Smith County,14,952,468,484
Mississippi,Smith County,15,819,407,412
Mississippi,Smith County,16,595,251,344
Mississippi,Smith County,17,403,135,268
Mississippi,Smith County,18,369,120,249
Mississippi,Stone County,0,18717,9455,9262
Mississippi,Stone County,1,1053,532,521
Mississippi,Stone County,2,1078,568,510
Mississippi,Stone County,3,1127,576,551
Mississippi,Stone County,4,1829,965,864
Mississippi,Stone County,5,1441,745,696
Mississippi,Stone County,6,1223,640,583
Mississippi,Stone County,7,1064,563,501
Mississippi,Stone County,8,1101,530,571
Mississippi,Stone County,9,1072,559,513
Mississippi,Stone County,10,1136,591,545
Mississippi,Stone County,11,1172,583,589
Mississippi,Stone County,12,1232,593,639
Mississippi,Stone County,13,1198,573,625
Mississippi,Stone County,14,1065,539,526
Mississippi,Stone County,15,834,416,418
Mississippi,Stone County,16,529,240,289
Mississippi,Stone County,17,339,155,184
Mississippi,Stone County,18,224,87,137
Mississippi,Sunflower County,0,25735,13737,11998
Mississippi,Sunflower County,1,1441,759,682
Mississippi,Sunflower County,2,1571,767,804
Mississippi,Sunflower County,3,1724,852,872
Mississippi,Sunflower County,4,1705,872,833
Mississippi,Sunflower County,5,1797,1055,742
Mississippi,Sunflower County,6,2408,1515,893
Mississippi,Sunflower County,7,1870,1198,672
Mississippi,Sunflower County,8,1802,1044,758
Mississippi,Sunflower County,9,1580,941,639
Mississippi,Sunflower County,10,1654,945,709
Mississippi,Sunflower County,11,1627,868,759
Mississippi,Sunflower County,12,1598,760,838
Mississippi,Sunflower County,13,1440,682,758
Mississippi,Sunflower County,14,1300,599,701
Mississippi,Sunflower County,15,803,365,438
Mississippi,Sunflower County,16,600,256,344
Mississippi,Sunflower County,17,407,150,257
Mississippi,Sunflower County,18,408,109,299
Mississippi,Tallahatchie County,0,13987,7776,6211
Mississippi,Tallahatchie County,1,788,392,396
Mississippi,Tallahatchie County,2,722,347,375
Mississippi,Tallahatchie County,3,797,390,407
Mississippi,Tallahatchie County,4,724,375,349
Mississippi,Tallahatchie County,5,1174,814,360
Mississippi,Tallahatchie County,6,1336,922,414
Mississippi,Tallahatchie County,7,1106,773,333
Mississippi,Tallahatchie County,8,936,601,335
Mississippi,Tallahatchie County,9,877,524,353
Mississippi,Tallahatchie County,10,909,500,409
Mississippi,Tallahatchie County,11,843,435,408
Mississippi,Tallahatchie County,12,831,387,444
Mississippi,Tallahatchie County,13,854,433,421
Mississippi,Tallahatchie County,14,685,341,344
Mississippi,Tallahatchie County,15,492,201,291
Mississippi,Tallahatchie County,16,374,155,219
Mississippi,Tallahatchie County,17,277,104,173
Mississippi,Tallahatchie County,18,262,82,180
Mississippi,Tate County,0,28759,13850,14909
Mississippi,Tate County,1,1667,829,838
Mississippi,Tate County,2,1707,863,844
Mississippi,Tate County,3,1962,1011,951
Mississippi,Tate County,4,2524,1262,1262
Mississippi,Tate County,5,2063,1034,1029
Mississippi,Tate County,6,1824,915,909
Mississippi,Tate County,7,1729,849,880
Mississippi,Tate County,8,1658,780,878
Mississippi,Tate County,9,1504,699,805
Mississippi,Tate County,10,1762,835,927
Mississippi,Tate County,11,1838,922,916
Mississippi,Tate County,12,1997,945,1052
Mississippi,Tate County,13,1725,797,928
Mississippi,Tate County,14,1618,762,856
Mississippi,Tate County,15,1289,575,714
Mississippi,Tate County,16,896,404,492
Mississippi,Tate County,17,517,223,294
Mississippi,Tate County,18,479,145,334
Mississippi,Tippah County,0,21995,10718,11277
Mississippi,Tippah County,1,1402,707,695
Mississippi,Tippah County,2,1441,735,706
Mississippi,Tippah County,3,1611,806,805
Mississippi,Tippah County,4,1489,751,738
Mississippi,Tippah County,5,1446,730,716
Mississippi,Tippah County,6,1444,715,729
Mississippi,Tippah County,7,1181,571,610
Mississippi,Tippah County,8,1355,608,747
Mississippi,Tippah County,9,1295,651,644
Mississippi,Tippah County,10,1403,718,685
Mississippi,Tippah County,11,1479,757,722
Mississippi,Tippah County,12,1502,744,758
Mississippi,Tippah County,13,1310,628,682
Mississippi,Tippah County,14,1182,535,647
Mississippi,Tippah County,15,1013,472,541
Mississippi,Tippah County,16,676,306,370
Mississippi,Tippah County,17,428,166,262
Mississippi,Tippah County,18,338,118,220
Mississippi,Tishomingo County,0,19454,9452,10002
Mississippi,Tishomingo County,1,1071,572,499
Mississippi,Tishomingo County,2,1090,560,530
Mississippi,Tishomingo County,3,1318,681,637
Mississippi,Tishomingo County,4,1126,573,553
Mississippi,Tishomingo County,5,1077,534,543
Mississippi,Tishomingo County,6,1212,632,580
Mississippi,Tishomingo County,7,1054,529,525
Mississippi,Tishomingo County,8,1064,475,589
Mississippi,Tishomingo County,9,1145,524,621
Mississippi,Tishomingo County,10,1269,601,668
Mississippi,Tishomingo County,11,1376,682,694
Mississippi,Tishomingo County,12,1366,696,670
Mississippi,Tishomingo County,13,1317,640,677
Mississippi,Tishomingo County,14,1210,585,625
Mississippi,Tishomingo County,15,1098,483,615
Mississippi,Tishomingo County,16,740,337,403
Mississippi,Tishomingo County,17,537,217,320
Mississippi,Tishomingo County,18,384,131,253
Mississippi,Tunica County,0,9944,4650,5294
Mississippi,Tunica County,1,857,422,435
Mississippi,Tunica County,2,813,406,407
Mississippi,Tunica County,3,770,397,373
Mississippi,Tunica County,4,732,383,349
Mississippi,Tunica County,5,622,295,327
Mississippi,Tunica County,6,701,311,390
Mississippi,Tunica County,7,679,303,376
Mississippi,Tunica County,8,687,302,385
Mississippi,Tunica County,9,567,253,314
Mississippi,Tunica County,10,608,289,319
Mississippi,Tunica County,11,525,243,282
Mississippi,Tunica County,12,606,269,337
Mississippi,Tunica County,13,562,249,313
Mississippi,Tunica County,14,482,207,275
Mississippi,Tunica County,15,301,152,149
Mississippi,Tunica County,16,191,81,110
Mississippi,Tunica County,17,131,51,80
Mississippi,Tunica County,18,110,37,73
Mississippi,Union County,0,28606,14016,14590
Mississippi,Union County,1,1907,978,929
Mississippi,Union County,2,1948,966,982
Mississippi,Union County,3,2105,1057,1048
Mississippi,Union County,4,1834,945,889
Mississippi,Union County,5,1633,854,779
Mississippi,Union County,6,1900,937,963
Mississippi,Union County,7,1712,853,859
Mississippi,Union County,8,1811,921,890
Mississippi,Union County,9,1845,893,952
Mississippi,Union County,10,1842,887,955
Mississippi,Union County,11,1825,912,913
Mississippi,Union County,12,1793,886,907
Mississippi,Union County,13,1666,806,860
Mississippi,Union County,14,1501,718,783
Mississippi,Union County,15,1259,599,660
Mississippi,Union County,16,861,365,496
Mississippi,Union County,17,581,237,344
Mississippi,Union County,18,583,202,381
Mississippi,Walthall County,0,14465,6968,7497
Mississippi,Walthall County,1,835,388,447
Mississippi,Walthall County,2,881,443,438
Mississippi,Walthall County,3,989,527,462
Mississippi,Walthall County,4,919,455,464
Mississippi,Walthall County,5,888,467,421
Mississippi,Walthall County,6,867,446,421
Mississippi,Walthall County,7,780,396,384
Mississippi,Walthall County,8,892,436,456
Mississippi,Walthall County,9,842,389,453
Mississippi,Walthall County,10,888,394,494
Mississippi,Walthall County,11,831,407,424
Mississippi,Walthall County,12,998,478,520
Mississippi,Walthall County,13,1015,487,528
Mississippi,Walthall County,14,881,419,462
Mississippi,Walthall County,15,660,295,365
Mississippi,Walthall County,16,543,244,299
Mississippi,Walthall County,17,385,164,221
Mississippi,Walthall County,18,371,133,238
Mississippi,Warren County,0,46176,21990,24186
Mississippi,Warren County,1,2957,1574,1383
Mississippi,Warren County,2,2913,1418,1495
Mississippi,Warren County,3,3198,1648,1550
Mississippi,Warren County,4,3004,1495,1509
Mississippi,Warren County,5,2824,1366,1458
Mississippi,Warren County,6,3049,1458,1591
Mississippi,Warren County,7,2675,1260,1415
Mississippi,Warren County,8,2912,1364,1548
Mississippi,Warren County,9,2749,1318,1431
Mississippi,Warren County,10,2773,1296,1477
Mississippi,Warren County,11,2860,1317,1543
Mississippi,Warren County,12,3328,1582,1746
Mississippi,Warren County,13,3269,1519,1750
Mississippi,Warren County,14,2696,1319,1377
Mississippi,Warren County,15,1945,879,1066
Mississippi,Warren County,16,1384,594,790
Mississippi,Warren County,17,853,348,505
Mississippi,Warren County,18,787,235,552
Mississippi,Washington County,0,45063,20889,24174
Mississippi,Washington County,1,3232,1603,1629
Mississippi,Washington County,2,3318,1658,1660
Mississippi,Washington County,3,3194,1625,1569
Mississippi,Washington County,4,2958,1490,1468
Mississippi,Washington County,5,2912,1413,1499
Mississippi,Washington County,6,3027,1465,1562
Mississippi,Washington County,7,2562,1206,1356
Mississippi,Washington County,8,2666,1193,1473
Mississippi,Washington County,9,2367,1045,1322
Mississippi,Washington County,10,2588,1149,1439
Mississippi,Washington County,11,2747,1218,1529
Mississippi,Washington County,12,3135,1441,1694
Mississippi,Washington County,13,3217,1431,1786
Mississippi,Washington County,14,2652,1196,1456
Mississippi,Washington County,15,1784,768,1016
Mississippi,Washington County,16,1200,513,687
Mississippi,Washington County,17,764,274,490
Mississippi,Washington County,18,740,201,539
Mississippi,Wayne County,0,20298,9749,10549
Mississippi,Wayne County,1,1379,702,677
Mississippi,Wayne County,2,1362,679,683
Mississippi,Wayne County,3,1412,731,681
Mississippi,Wayne County,4,1284,646,638
Mississippi,Wayne County,5,1244,608,636
Mississippi,Wayne County,6,1394,677,717
Mississippi,Wayne County,7,1155,535,620
Mississippi,Wayne County,8,1184,565,619
Mississippi,Wayne County,9,1148,541,607
Mississippi,Wayne County,10,1211,580,631
Mississippi,Wayne County,11,1198,560,638
Mississippi,Wayne County,12,1527,735,792
Mississippi,Wayne County,13,1327,654,673
Mississippi,Wayne County,14,1076,511,565
Mississippi,Wayne County,15,893,410,483
Mississippi,Wayne County,16,654,274,380
Mississippi,Wayne County,17,490,219,271
Mississippi,Wayne County,18,360,122,238
Mississippi,Webster County,0,9788,4779,5009
Mississippi,Webster County,1,587,283,304
Mississippi,Webster County,2,616,345,271
Mississippi,Webster County,3,705,363,342
Mississippi,Webster County,4,636,337,299
Mississippi,Webster County,5,531,244,287
Mississippi,Webster County,6,597,305,292
Mississippi,Webster County,7,587,271,316
Mississippi,Webster County,8,608,322,286
Mississippi,Webster County,9,514,245,269
Mississippi,Webster County,10,609,305,304
Mississippi,Webster County,11,664,317,347
Mississippi,Webster County,12,735,380,355
Mississippi,Webster County,13,661,321,340
Mississippi,Webster County,14,547,259,288
Mississippi,Webster County,15,458,209,249
Mississippi,Webster County,16,330,136,194
Mississippi,Webster County,17,213,83,130
Mississippi,Webster County,18,190,54,136
Mississippi,Wilkinson County,0,8792,4714,4078
Mississippi,Wilkinson County,1,465,260,205
Mississippi,Wilkinson County,2,516,253,263
Mississippi,Wilkinson County,3,563,272,291
Mississippi,Wilkinson County,4,485,254,231
Mississippi,Wilkinson County,5,544,349,195
Mississippi,Wilkinson County,6,725,475,250
Mississippi,Wilkinson County,7,650,434,216
Mississippi,Wilkinson County,8,575,342,233
Mississippi,Wilkinson County,9,473,281,192
Mississippi,Wilkinson County,10,474,249,225
Mississippi,Wilkinson County,11,555,270,285
Mississippi,Wilkinson County,12,622,305,317
Mississippi,Wilkinson County,13,632,310,322
Mississippi,Wilkinson County,14,536,256,280
Mississippi,Wilkinson County,15,331,159,172
Mississippi,Wilkinson County,16,280,119,161
Mississippi,Wilkinson County,17,162,63,99
Mississippi,Wilkinson County,18,204,63,141
Mississippi,Winston County,0,18165,8867,9298
Mississippi,Winston County,1,964,501,463
Mississippi,Winston County,2,1072,548,524
Mississippi,Winston County,3,1346,701,645
Mississippi,Winston County,4,1150,614,536
Mississippi,Winston County,5,954,491,463
Mississippi,Winston County,6,1126,571,555
Mississippi,Winston County,7,1043,519,524
Mississippi,Winston County,8,1058,513,545
Mississippi,Winston County,9,1062,510,552
Mississippi,Winston County,10,1110,534,576
Mississippi,Winston County,11,1089,561,528
Mississippi,Winston County,12,1259,602,657
Mississippi,Winston County,13,1304,619,685
Mississippi,Winston County,14,1149,538,611
Mississippi,Winston County,15,915,438,477
Mississippi,Winston County,16,633,261,372
Mississippi,Winston County,17,479,182,297
Mississippi,Winston County,18,452,164,288
Mississippi,Yalobusha County,0,12392,5934,6458
Mississippi,Yalobusha County,1,759,380,379
Mississippi,Yalobusha County,2,729,392,337
Mississippi,Yalobusha County,3,829,434,395
Mississippi,Yalobusha County,4,711,364,347
Mississippi,Yalobusha County,5,646,333,313
Mississippi,Yalobusha County,6,840,362,478
Mississippi,Yalobusha County,7,627,291,336
Mississippi,Yalobusha County,8,687,313,374
Mississippi,Yalobusha County,9,690,341,349
Mississippi,Yalobusha County,10,814,397,417
Mississippi,Yalobusha County,11,772,374,398
Mississippi,Yalobusha County,12,861,398,463
Mississippi,Yalobusha County,13,953,436,517
Mississippi,Yalobusha County,14,817,391,426
Mississippi,Yalobusha County,15,663,338,325
Mississippi,Yalobusha County,16,444,180,264
Mississippi,Yalobusha County,17,316,139,177
Mississippi,Yalobusha County,18,234,71,163
Mississippi,Yazoo County,0,28248,16261,11987
Mississippi,Yazoo County,1,1569,816,753
Mississippi,Yazoo County,2,1722,880,842
Mississippi,Yazoo County,3,1903,1004,899
Mississippi,Yazoo County,4,1588,838,750
Mississippi,Yazoo County,5,1779,1006,773
Mississippi,Yazoo County,6,2519,1717,802
Mississippi,Yazoo County,7,2541,1857,684
Mississippi,Yazoo County,8,2560,1840,720
Mississippi,Yazoo County,9,1881,1249,632
Mississippi,Yazoo County,10,1653,988,665
Mississippi,Yazoo County,11,1629,902,727
Mississippi,Yazoo County,12,1604,830,774
Mississippi,Yazoo County,13,1538,755,783
Mississippi,Yazoo County,14,1176,577,599
Mississippi,Yazoo County,15,942,417,525
Mississippi,Yazoo County,16,662,271,391
Mississippi,Yazoo County,17,468,169,299
Mississippi,Yazoo County,18,514,145,369
Missouri,Adair County,0,25339,12194,13145
Missouri,Adair County,1,1276,674,602
Missouri,Adair County,2,1207,625,582
Missouri,Adair County,3,1349,663,686
Missouri,Adair County,4,2869,1281,1588
Missouri,Adair County,5,4974,2342,2632
Missouri,Adair County,6,1455,756,699
Missouri,Adair County,7,1167,582,585
Missouri,Adair County,8,1190,567,623
Missouri,Adair County,9,971,485,486
Missouri,Adair County,10,1215,620,595
Missouri,Adair County,11,1238,640,598
Missouri,Adair County,12,1374,633,741
Missouri,Adair County,13,1299,637,662
Missouri,Adair County,14,1124,554,570
Missouri,Adair County,15,943,449,494
Missouri,Adair County,16,704,327,377
Missouri,Adair County,17,458,179,279
Missouri,Adair County,18,526,180,346
Missouri,Andrew County,0,17607,8746,8861
Missouri,Andrew County,1,1001,508,493
Missouri,Andrew County,2,1144,584,560
Missouri,Andrew County,3,1190,595,595
Missouri,Andrew County,4,1083,597,486
Missouri,Andrew County,5,893,462,431
Missouri,Andrew County,6,1038,529,509
Missouri,Andrew County,7,975,477,498
Missouri,Andrew County,8,1117,537,580
Missouri,Andrew County,9,1051,510,541
Missouri,Andrew County,10,1105,587,518
Missouri,Andrew County,11,1156,600,556
Missouri,Andrew County,12,1293,648,645
Missouri,Andrew County,13,1308,618,690
Missouri,Andrew County,14,1039,548,491
Missouri,Andrew County,15,806,370,436
Missouri,Andrew County,16,617,287,330
Missouri,Andrew County,17,374,158,216
Missouri,Andrew County,18,417,131,286
Missouri,Atchison County,0,5171,2572,2599
Missouri,Atchison County,1,251,133,118
Missouri,Atchison County,2,299,158,141
Missouri,Atchison County,3,291,147,144
Missouri,Atchison County,4,277,142,135
Missouri,Atchison County,5,222,112,110
Missouri,Atchison County,6,295,151,144
Missouri,Atchison County,7,234,114,120
Missouri,Atchison County,8,278,146,132
Missouri,Atchison County,9,280,144,136
Missouri,Atchison County,10,317,165,152
Missouri,Atchison County,11,351,168,183
Missouri,Atchison County,12,373,199,174
Missouri,Atchison County,13,388,189,199
Missouri,Atchison County,14,341,174,167
Missouri,Atchison County,15,368,182,186
Missouri,Atchison County,16,268,135,133
Missouri,Atchison County,17,140,61,79
Missouri,Atchison County,18,198,52,146
Missouri,Audrain County,0,25473,11687,13786
Missouri,Audrain County,1,1610,822,788
Missouri,Audrain County,2,1488,780,708
Missouri,Audrain County,3,1576,838,738
Missouri,Audrain County,4,1661,935,726
Missouri,Audrain County,5,1530,667,863
Missouri,Audrain County,6,1688,673,1015
Missouri,Audrain County,7,1611,616,995
Missouri,Audrain County,8,1663,707,956
Missouri,Audrain County,9,1555,629,926
Missouri,Audrain County,10,1555,720,835
Missouri,Audrain County,11,1541,699,842
Missouri,Audrain County,12,1752,818,934
Missouri,Audrain County,13,1691,829,862
Missouri,Audrain County,14,1466,677,789
Missouri,Audrain County,15,1119,557,562
Missouri,Audrain County,16,835,358,477
Missouri,Audrain County,17,577,221,356
Missouri,Audrain County,18,555,141,414
Missouri,Barry County,0,35886,18147,17739
Missouri,Barry County,1,2173,1157,1016
Missouri,Barry County,2,2230,1210,1020
Missouri,Barry County,3,2358,1221,1137
Missouri,Barry County,4,2124,1124,1000
Missouri,Barry County,5,1952,1055,897
Missouri,Barry County,6,2145,1103,1042
Missouri,Barry County,7,1833,953,880
Missouri,Barry County,8,1909,957,952
Missouri,Barry County,9,1888,951,937
Missouri,Barry County,10,2169,1045,1124
Missouri,Barry County,11,2312,1164,1148
Missouri,Barry County,12,2733,1403,1330
Missouri,Barry County,13,2672,1293,1379
Missouri,Barry County,14,2302,1150,1152
Missouri,Barry County,15,1945,951,994
Missouri,Barry County,16,1452,696,756
Missouri,Barry County,17,908,397,511
Missouri,Barry County,18,781,317,464
Missouri,Barton County,0,11798,5807,5991
Missouri,Barton County,1,674,336,338
Missouri,Barton County,2,705,358,347
Missouri,Barton County,3,846,442,404
Missouri,Barton County,4,800,436,364
Missouri,Barton County,5,672,339,333
Missouri,Barton County,6,685,354,331
Missouri,Barton County,7,553,271,282
Missouri,Barton County,8,724,346,378
Missouri,Barton County,9,604,307,297
Missouri,Barton County,10,653,323,330
Missouri,Barton County,11,722,358,364
Missouri,Barton County,12,859,411,448
Missouri,Barton County,13,878,452,426
Missouri,Barton County,14,711,326,385
Missouri,Barton County,15,599,273,326
Missouri,Barton County,16,469,227,242
Missouri,Barton County,17,297,127,170
Missouri,Barton County,18,347,121,226
Missouri,Bates County,0,16320,8069,8251
Missouri,Bates County,1,958,489,469
Missouri,Bates County,2,992,500,492
Missouri,Bates County,3,1151,562,589
Missouri,Bates County,4,1044,575,469
Missouri,Bates County,5,915,494,421
Missouri,Bates County,6,905,455,450
Missouri,Bates County,7,920,484,436
Missouri,Bates County,8,978,442,536
Missouri,Bates County,9,902,454,448
Missouri,Bates County,10,931,475,456
Missouri,Bates County,11,1044,530,514
Missouri,Bates County,12,1276,624,652
Missouri,Bates County,13,1140,588,552
Missouri,Bates County,14,965,445,520
Missouri,Bates County,15,711,351,360
Missouri,Bates County,16,639,278,361
Missouri,Bates County,17,469,195,274
Missouri,Bates County,18,380,128,252
Missouri,Benton County,0,19278,9663,9615
Missouri,Benton County,1,847,423,424
Missouri,Benton County,2,877,448,429
Missouri,Benton County,3,970,498,472
Missouri,Benton County,4,950,496,454
Missouri,Benton County,5,697,358,339
Missouri,Benton County,6,834,437,397
Missouri,Benton County,7,745,396,349
Missouri,Benton County,8,823,396,427
Missouri,Benton County,9,789,385,404
Missouri,Benton County,10,1101,557,544
Missouri,Benton County,11,1229,626,603
Missouri,Benton County,12,1635,818,817
Missouri,Benton County,13,1842,895,947
Missouri,Benton County,14,1875,906,969
Missouri,Benton County,15,1603,826,777
Missouri,Benton County,16,1168,609,559
Missouri,Benton County,17,728,355,373
Missouri,Benton County,18,565,234,331
Missouri,Bollinger County,0,12169,6120,6049
Missouri,Bollinger County,1,587,326,261
Missouri,Bollinger County,2,760,401,359
Missouri,Bollinger County,3,760,386,374
Missouri,Bollinger County,4,733,404,329
Missouri,Bollinger County,5,590,308,282
Missouri,Bollinger County,6,660,316,344
Missouri,Bollinger County,7,636,330,306
Missouri,Bollinger County,8,684,354,330
Missouri,Bollinger County,9,687,350,337
Missouri,Bollinger County,10,791,371,420
Missouri,Bollinger County,11,866,433,433
Missouri,Bollinger County,12,988,530,458
Missouri,Bollinger County,13,925,439,486
Missouri,Bollinger County,14,830,394,436
Missouri,Bollinger County,15,626,306,320
Missouri,Bollinger County,16,489,237,252
Missouri,Bollinger County,17,300,145,155
Missouri,Bollinger County,18,257,90,167
Missouri,Boone County,0,180005,87247,92758
Missouri,Boone County,1,10513,5375,5138
Missouri,Boone County,2,10186,5233,4953
Missouri,Boone County,3,10117,5244,4873
Missouri,Boone County,4,14493,6832,7661
Missouri,Boone County,5,25819,12272,13547
Missouri,Boone County,6,15208,7570,7638
Missouri,Boone County,7,12279,6201,6078
Missouri,Boone County,8,11566,5715,5851
Missouri,Boone County,9,9716,4794,4922
Missouri,Boone County,10,9523,4639,4884
Missouri,Boone County,11,9042,4331,4711
Missouri,Boone County,12,10097,4855,5242
Missouri,Boone County,13,9388,4357,5031
Missouri,Boone County,14,7974,3770,4204
Missouri,Boone County,15,5419,2584,2835
Missouri,Boone County,16,3566,1535,2031
Missouri,Boone County,17,2356,1008,1348
Missouri,Boone County,18,2743,932,1811
Missouri,Buchanan County,0,88571,44705,43866
Missouri,Buchanan County,1,5563,2881,2682
Missouri,Buchanan County,2,5524,2786,2738
Missouri,Buchanan County,3,5586,2848,2738
Missouri,Buchanan County,4,5600,2899,2701
Missouri,Buchanan County,5,5844,3160,2684
Missouri,Buchanan County,6,6510,3444,3066
Missouri,Buchanan County,7,6042,3219,2823
Missouri,Buchanan County,8,5935,3258,2677
Missouri,Buchanan County,9,5168,2800,2368
Missouri,Buchanan County,10,5231,2669,2562
Missouri,Buchanan County,11,5491,2785,2706
Missouri,Buchanan County,12,6150,3089,3061
Missouri,Buchanan County,13,5652,2742,2910
Missouri,Buchanan County,14,4602,2143,2459
Missouri,Buchanan County,15,3456,1574,1882
Missouri,Buchanan County,16,2523,1066,1457
Missouri,Buchanan County,17,1755,715,1040
Missouri,Buchanan County,18,1939,627,1312
Missouri,Butler County,0,42639,20715,21924
Missouri,Butler County,1,2710,1450,1260
Missouri,Butler County,2,2783,1388,1395
Missouri,Butler County,3,2817,1447,1370
Missouri,Butler County,4,2628,1395,1233
Missouri,Butler County,5,2357,1183,1174
Missouri,Butler County,6,2723,1346,1377
Missouri,Butler County,7,2580,1277,1303
Missouri,Butler County,8,2543,1191,1352
Missouri,Butler County,9,2400,1181,1219
Missouri,Butler County,10,2562,1259,1303
Missouri,Butler County,11,2701,1293,1408
Missouri,Butler County,12,2906,1399,1507
Missouri,Butler County,13,2908,1368,1540
Missouri,Butler County,14,2412,1097,1315
Missouri,Butler County,15,2020,924,1096
Missouri,Butler County,16,1497,686,811
Missouri,Butler County,17,1157,474,683
Missouri,Butler County,18,935,357,578
Missouri,Caldwell County,0,9108,4620,4488
Missouri,Caldwell County,1,525,251,274
Missouri,Caldwell County,2,559,321,238
Missouri,Caldwell County,3,671,360,311
Missouri,Caldwell County,4,628,352,276
Missouri,Caldwell County,5,516,264,252
Missouri,Caldwell County,6,496,264,232
Missouri,Caldwell County,7,440,216,224
Missouri,Caldwell County,8,518,255,263
Missouri,Caldwell County,9,489,248,241
Missouri,Caldwell County,10,557,295,262
Missouri,Caldwell County,11,598,296,302
Missouri,Caldwell County,12,686,346,340
Missouri,Caldwell County,13,623,301,322
Missouri,Caldwell County,14,572,287,285
Missouri,Caldwell County,15,436,225,211
Missouri,Caldwell County,16,331,154,177
Missouri,Caldwell County,17,234,107,127
Missouri,Caldwell County,18,229,78,151
Missouri,Callaway County,0,44889,22949,21940
Missouri,Callaway County,1,2449,1279,1170
Missouri,Callaway County,2,2572,1296,1276
Missouri,Callaway County,3,2715,1416,1299
Missouri,Callaway County,4,3092,1507,1585
Missouri,Callaway County,5,3304,1763,1541
Missouri,Callaway County,6,3084,1669,1415
Missouri,Callaway County,7,2848,1559,1289
Missouri,Callaway County,8,2917,1551,1366
Missouri,Callaway County,9,2590,1346,1244
Missouri,Callaway County,10,2829,1462,1367
Missouri,Callaway County,11,2958,1528,1430
Missouri,Callaway County,12,3339,1661,1678
Missouri,Callaway County,13,2888,1414,1474
Missouri,Callaway County,14,2554,1303,1251
Missouri,Callaway County,15,1838,934,904
Missouri,Callaway County,16,1294,623,671
Missouri,Callaway County,17,818,369,449
Missouri,Callaway County,18,800,269,531
Missouri,Camden County,0,45815,22792,23023
Missouri,Camden County,1,2052,1066,986
Missouri,Camden County,2,2137,1102,1035
Missouri,Camden County,3,2346,1176,1170
Missouri,Camden County,4,2357,1231,1126
Missouri,Camden County,5,1836,940,896
Missouri,Camden County,6,2126,1067,1059
Missouri,Camden County,7,2151,1067,1084
Missouri,Camden County,8,2176,1057,1119
Missouri,Camden County,9,2049,1032,1017
Missouri,Camden County,10,2495,1190,1305
Missouri,Camden County,11,2958,1439,1519
Missouri,Camden County,12,3852,1856,1996
Missouri,Camden County,13,4375,2115,2260
Missouri,Camden County,14,4290,2101,2189
Missouri,Camden County,15,3737,1906,1831
Missouri,Camden County,16,2484,1313,1171
Missouri,Camden County,17,1374,697,677
Missouri,Camden County,18,1020,437,583
Missouri,Cape Girardeau County,0,78753,38191,40562
Missouri,Cape Girardeau County,1,4558,2314,2244
Missouri,Cape Girardeau County,2,4614,2404,2210
Missouri,Cape Girardeau County,3,4852,2476,2376
Missouri,Cape Girardeau County,4,5771,2753,3018
Missouri,Cape Girardeau County,5,7996,3860,4136
Missouri,Cape Girardeau County,6,5343,2720,2623
Missouri,Cape Girardeau County,7,4735,2339,2396
Missouri,Cape Girardeau County,8,4721,2317,2404
Missouri,Cape Girardeau County,9,4152,2105,2047
Missouri,Cape Girardeau County,10,4398,2177,2221
Missouri,Cape Girardeau County,11,4462,2170,2292
Missouri,Cape Girardeau County,12,5020,2478,2542
Missouri,Cape Girardeau County,13,4852,2321,2531
Missouri,Cape Girardeau County,14,4277,2040,2237
Missouri,Cape Girardeau County,15,3142,1431,1711
Missouri,Cape Girardeau County,16,2281,949,1332
Missouri,Cape Girardeau County,17,1742,725,1017
Missouri,Cape Girardeau County,18,1837,612,1225
Missouri,Carroll County,0,8743,4247,4496
Missouri,Carroll County,1,511,270,241
Missouri,Carroll County,2,564,284,280
Missouri,Carroll County,3,568,275,293
Missouri,Carroll County,4,557,271,286
Missouri,Carroll County,5,493,244,249
Missouri,Carroll County,6,479,255,224
Missouri,Carroll County,7,401,193,208
Missouri,Carroll County,8,486,221,265
Missouri,Carroll County,9,498,237,261
Missouri,Carroll County,10,530,279,251
Missouri,Carroll County,11,546,269,277
Missouri,Carroll County,12,639,331,308
Missouri,Carroll County,13,565,264,301
Missouri,Carroll County,14,565,282,283
Missouri,Carroll County,15,509,223,286
Missouri,Carroll County,16,347,154,193
Missouri,Carroll County,17,242,102,140
Missouri,Carroll County,18,243,93,150
Missouri,Carter County,0,6054,2926,3128
Missouri,Carter County,1,389,185,204
Missouri,Carter County,2,368,184,184
Missouri,Carter County,3,418,202,216
Missouri,Carter County,4,376,192,184
Missouri,Carter County,5,308,148,160
Missouri,Carter County,6,328,154,174
Missouri,Carter County,7,285,133,152
Missouri,Carter County,8,353,181,172
Missouri,Carter County,9,337,156,181
Missouri,Carter County,10,374,184,190
Missouri,Carter County,11,391,197,194
Missouri,Carter County,12,464,236,228
Missouri,Carter County,13,456,227,229
Missouri,Carter County,14,402,185,217
Missouri,Carter County,15,331,160,171
Missouri,Carter County,16,211,102,109
Missouri,Carter County,17,131,48,83
Missouri,Carter County,18,132,52,80
Missouri,Cass County,0,104954,51161,53793
Missouri,Cass County,1,6432,3283,3149
Missouri,Cass County,2,6984,3576,3408
Missouri,Cass County,3,7436,3785,3651
Missouri,Cass County,4,6907,3544,3363
Missouri,Cass County,5,5651,2875,2776
Missouri,Cass County,6,6254,3105,3149
Missouri,Cass County,7,6222,3075,3147
Missouri,Cass County,8,6649,3215,3434
Missouri,Cass County,9,6489,3166,3323
Missouri,Cass County,10,6742,3314,3428
Missouri,Cass County,11,6848,3383,3465
Missouri,Cass County,12,7807,3819,3988
Missouri,Cass County,13,6841,3318,3523
Missouri,Cass County,14,5453,2497,2956
Missouri,Cass County,15,4436,2007,2429
Missouri,Cass County,16,3396,1490,1906
Missouri,Cass County,17,2173,898,1275
Missouri,Cass County,18,2234,811,1423
Missouri,Cedar County,0,14165,7075,7090
Missouri,Cedar County,1,979,493,486
Missouri,Cedar County,2,878,453,425
Missouri,Cedar County,3,945,497,448
Missouri,Cedar County,4,910,510,400
Missouri,Cedar County,5,677,361,316
Missouri,Cedar County,6,733,379,354
Missouri,Cedar County,7,651,310,341
Missouri,Cedar County,8,711,355,356
Missouri,Cedar County,9,698,350,348
Missouri,Cedar County,10,803,415,388
Missouri,Cedar County,11,855,396,459
Missouri,Cedar County,12,985,495,490
Missouri,Cedar County,13,1032,536,496
Missouri,Cedar County,14,992,463,529
Missouri,Cedar County,15,824,401,423
Missouri,Cedar County,16,648,299,349
Missouri,Cedar County,17,449,222,227
Missouri,Cedar County,18,395,140,255
Missouri,Chariton County,0,7451,3699,3752
Missouri,Chariton County,1,449,224,225
Missouri,Chariton County,2,458,241,217
Missouri,Chariton County,3,485,258,227
Missouri,Chariton County,4,450,246,204
Missouri,Chariton County,5,326,159,167
Missouri,Chariton County,6,394,199,195
Missouri,Chariton County,7,340,166,174
Missouri,Chariton County,8,385,195,190
Missouri,Chariton County,9,394,186,208
Missouri,Chariton County,10,370,184,186
Missouri,Chariton County,11,450,236,214
Missouri,Chariton County,12,573,295,278
Missouri,Chariton County,13,615,301,314
Missouri,Chariton County,14,482,261,221
Missouri,Chariton County,15,395,191,204
Missouri,Chariton County,16,334,151,183
Missouri,Chariton County,17,224,85,139
Missouri,Chariton County,18,327,121,206
Missouri,Christian County,0,86983,42666,44317
Missouri,Christian County,1,5489,2867,2622
Missouri,Christian County,2,6263,3262,3001
Missouri,Christian County,3,6495,3285,3210
Missouri,Christian County,4,5610,2864,2746
Missouri,Christian County,5,4431,2166,2265
Missouri,Christian County,6,5427,2683,2744
Missouri,Christian County,7,5866,2801,3065
Missouri,Christian County,8,6223,3043,3180
Missouri,Christian County,9,5592,2787,2805
Missouri,Christian County,10,5757,2898,2859
Missouri,Christian County,11,5179,2545,2634
Missouri,Christian County,12,5781,2777,3004
Missouri,Christian County,13,5199,2444,2755
Missouri,Christian County,14,4533,2117,2416
Missouri,Christian County,15,3677,1764,1913
Missouri,Christian County,16,2521,1136,1385
Missouri,Christian County,17,1545,691,854
Missouri,Christian County,18,1395,536,859
Missouri,Clark County,0,6842,3495,3347
Missouri,Clark County,1,419,233,186
Missouri,Clark County,2,427,213,214
Missouri,Clark County,3,467,259,208
Missouri,Clark County,4,384,199,185
Missouri,Clark County,5,332,175,157
Missouri,Clark County,6,373,178,195
Missouri,Clark County,7,349,194,155
Missouri,Clark County,8,364,178,186
Missouri,Clark County,9,397,215,182
Missouri,Clark County,10,365,184,181
Missouri,Clark County,11,486,261,225
Missouri,Clark County,12,552,274,278
Missouri,Clark County,13,504,269,235
Missouri,Clark County,14,445,229,216
Missouri,Clark County,15,326,151,175
Missouri,Clark County,16,258,119,139
Missouri,Clark County,17,187,92,95
Missouri,Clark County,18,207,72,135
Missouri,Clay County,0,246365,120984,125381
Missouri,Clay County,1,15697,8098,7599
Missouri,Clay County,2,16331,8292,8039
Missouri,Clay County,3,17217,8790,8427
Missouri,Clay County,4,15486,7994,7492
Missouri,Clay County,5,14271,7149,7122
Missouri,Clay County,6,18034,8988,9046
Missouri,Clay County,7,17982,8928,9054
Missouri,Clay County,8,17819,8959,8860
Missouri,Clay County,9,16183,7949,8234
Missouri,Clay County,10,16657,8231,8426
Missouri,Clay County,11,15413,7570,7843
Missouri,Clay County,12,16097,7868,8229
Missouri,Clay County,13,14407,6865,7542
Missouri,Clay County,14,11595,5334,6261
Missouri,Clay County,15,9248,4290,4958
Missouri,Clay County,16,6081,2716,3365
Missouri,Clay County,17,3923,1581,2342
Missouri,Clay County,18,3924,1382,2542
Missouri,Clinton County,0,20470,10296,10174
Missouri,Clinton County,1,1239,634,605
Missouri,Clinton County,2,1265,663,602
Missouri,Clinton County,3,1423,734,689
Missouri,Clinton County,4,1316,700,616
Missouri,Clinton County,5,1044,527,517
Missouri,Clinton County,6,1193,628,565
Missouri,Clinton County,7,1125,547,578
Missouri,Clinton County,8,1234,601,633
Missouri,Clinton County,9,1178,608,570
Missouri,Clinton County,10,1322,649,673
Missouri,Clinton County,11,1386,709,677
Missouri,Clinton County,12,1592,781,811
Missouri,Clinton County,13,1450,737,713
Missouri,Clinton County,14,1182,576,606
Missouri,Clinton County,15,916,459,457
Missouri,Clinton County,16,654,312,342
Missouri,Clinton County,17,452,216,236
Missouri,Clinton County,18,499,215,284
Missouri,Cole County,0,76796,38795,38001
Missouri,Cole County,1,4574,2359,2215
Missouri,Cole County,2,4685,2342,2343
Missouri,Cole County,3,4999,2525,2474
Missouri,Cole County,4,4818,2453,2365
Missouri,Cole County,5,4675,2409,2266
Missouri,Cole County,6,5265,2871,2394
Missouri,Cole County,7,5156,2808,2348
Missouri,Cole County,8,5245,2854,2391
Missouri,Cole County,9,4613,2509,2104
Missouri,Cole County,10,4874,2553,2321
Missouri,Cole County,11,5031,2634,2397
Missouri,Cole County,12,5227,2549,2678
Missouri,Cole County,13,4900,2349,2551
Missouri,Cole County,14,4241,1978,2263
Missouri,Cole County,15,3279,1546,1733
Missouri,Cole County,16,2192,974,1218
Missouri,Cole County,17,1414,582,832
Missouri,Cole County,18,1608,500,1108
Missouri,Cooper County,0,17603,9196,8407
Missouri,Cooper County,1,947,492,455
Missouri,Cooper County,2,1013,520,493
Missouri,Cooper County,3,1109,519,590
Missouri,Cooper County,4,1121,619,502
Missouri,Cooper County,5,1311,860,451
Missouri,Cooper County,6,1314,836,478
Missouri,Cooper County,7,1064,594,470
Missouri,Cooper County,8,1109,571,538
Missouri,Cooper County,9,981,525,456
Missouri,Cooper County,10,1005,519,486
Missouri,Cooper County,11,1076,549,527
Missouri,Cooper County,12,1250,599,651
Missouri,Cooper County,13,1148,588,560
Missouri,Cooper County,14,969,473,496
Missouri,Cooper County,15,784,366,418
Missouri,Cooper County,16,568,251,317
Missouri,Cooper County,17,375,159,216
Missouri,Cooper County,18,459,156,303
Missouri,Crawford County,0,23957,11883,12074
Missouri,Crawford County,1,1360,702,658
Missouri,Crawford County,2,1426,686,740
Missouri,Crawford County,3,1677,815,862
Missouri,Crawford County,4,1464,769,695
Missouri,Crawford County,5,1285,675,610
Missouri,Crawford County,6,1386,690,696
Missouri,Crawford County,7,1266,631,635
Missouri,Crawford County,8,1405,713,692
Missouri,Crawford County,9,1311,644,667
Missouri,Crawford County,10,1416,719,697
Missouri,Crawford County,11,1586,794,792
Missouri,Crawford County,12,1924,983,941
Missouri,Crawford County,13,1740,852,888
Missouri,Crawford County,14,1480,737,743
Missouri,Crawford County,15,1267,625,642
Missouri,Crawford County,16,882,401,481
Missouri,Crawford County,17,546,261,285
Missouri,Crawford County,18,536,186,350
Missouri,Dade County,0,7569,3866,3703
Missouri,Dade County,1,366,206,160
Missouri,Dade County,2,423,226,197
Missouri,Dade County,3,467,267,200
Missouri,Dade County,4,457,254,203
Missouri,Dade County,5,357,189,168
Missouri,Dade County,6,350,185,165
Missouri,Dade County,7,352,182,170
Missouri,Dade County,8,430,209,221
Missouri,Dade County,9,403,220,183
Missouri,Dade County,10,454,238,216
Missouri,Dade County,11,495,239,256
Missouri,Dade County,12,589,293,296
Missouri,Dade County,13,636,291,345
Missouri,Dade County,14,572,301,271
Missouri,Dade County,15,424,210,214
Missouri,Dade County,16,333,162,171
Missouri,Dade County,17,239,118,121
Missouri,Dade County,18,222,76,146
Missouri,Dallas County,0,16762,8364,8398
Missouri,Dallas County,1,1090,581,509
Missouri,Dallas County,2,1028,487,541
Missouri,Dallas County,3,1166,609,557
Missouri,Dallas County,4,1003,520,483
Missouri,Dallas County,5,829,438,391
Missouri,Dallas County,6,930,481,449
Missouri,Dallas County,7,884,451,433
Missouri,Dallas County,8,892,458,434
Missouri,Dallas County,9,889,444,445
Missouri,Dallas County,10,933,467,466
Missouri,Dallas County,11,1086,531,555
Missouri,Dallas County,12,1324,647,677
Missouri,Dallas County,13,1310,644,666
Missouri,Dallas County,14,1093,558,535
Missouri,Dallas County,15,829,407,422
Missouri,Dallas County,16,652,312,340
Missouri,Dallas County,17,416,180,236
Missouri,Dallas County,18,408,149,259
Missouri,Daviess County,0,8313,4193,4120
Missouri,Daviess County,1,557,299,258
Missouri,Daviess County,2,545,284,261
Missouri,Daviess County,3,625,319,306
Missouri,Daviess County,4,587,293,294
Missouri,Daviess County,5,441,232,209
Missouri,Daviess County,6,464,229,235
Missouri,Daviess County,7,393,197,196
Missouri,Daviess County,8,430,229,201
Missouri,Daviess County,9,456,240,216
Missouri,Daviess County,10,471,222,249
Missouri,Daviess County,11,469,236,233
Missouri,Daviess County,12,577,290,287
Missouri,Daviess County,13,599,295,304
Missouri,Daviess County,14,519,262,257
Missouri,Daviess County,15,491,243,248
Missouri,Daviess County,16,297,157,140
Missouri,Daviess County,17,204,92,112
Missouri,Daviess County,18,188,74,114
Missouri,DeKalb County,0,12630,7905,4725
Missouri,DeKalb County,1,613,296,317
Missouri,DeKalb County,2,580,318,262
Missouri,DeKalb County,3,608,313,295
Missouri,DeKalb County,4,581,336,245
Missouri,DeKalb County,5,802,581,221
Missouri,DeKalb County,6,1033,766,267
Missouri,DeKalb County,7,989,766,223
Missouri,DeKalb County,8,953,687,266
Missouri,DeKalb County,9,948,684,264
Missouri,DeKalb County,10,932,644,288
Missouri,DeKalb County,11,896,612,284
Missouri,DeKalb County,12,859,505,354
Missouri,DeKalb County,13,734,398,336
Missouri,DeKalb County,14,624,344,280
Missouri,DeKalb County,15,449,226,223
Missouri,DeKalb County,16,387,193,194
Missouri,DeKalb County,17,311,127,184
Missouri,DeKalb County,18,331,109,222
Missouri,Dent County,0,15441,7691,7750
Missouri,Dent County,1,905,455,450
Missouri,Dent County,2,976,491,485
Missouri,Dent County,3,955,515,440
Missouri,Dent County,4,942,494,448
Missouri,Dent County,5,708,386,322
Missouri,Dent County,6,807,397,410
Missouri,Dent County,7,835,404,431
Missouri,Dent County,8,887,466,421
Missouri,Dent County,9,805,394,411
Missouri,Dent County,10,867,430,437
Missouri,Dent County,11,988,485,503
Missouri,Dent County,12,1263,646,617
Missouri,Dent County,13,1144,574,570
Missouri,Dent County,14,985,472,513
Missouri,Dent County,15,849,407,442
Missouri,Dent County,16,640,297,343
Missouri,Dent County,17,461,217,244
Missouri,Dent County,18,424,161,263
Missouri,Douglas County,0,13373,6692,6681
Missouri,Douglas County,1,756,399,357
Missouri,Douglas County,2,810,413,397
Missouri,Douglas County,3,868,441,427
Missouri,Douglas County,4,711,369,342
Missouri,Douglas County,5,584,302,282
Missouri,Douglas County,6,636,330,306
Missouri,Douglas County,7,687,338,349
Missouri,Douglas County,8,708,364,344
Missouri,Douglas County,9,651,327,324
Missouri,Douglas County,10,727,351,376
Missouri,Douglas County,11,820,417,403
Missouri,Douglas County,12,1040,540,500
Missouri,Douglas County,13,1121,538,583
Missouri,Douglas County,14,1016,519,497
Missouri,Douglas County,15,823,396,427
Missouri,Douglas County,16,634,317,317
Missouri,Douglas County,17,412,179,233
Missouri,Douglas County,18,369,152,217
Missouri,Dunklin County,0,29423,14075,15348
Missouri,Dunklin County,1,2000,1040,960
Missouri,Dunklin County,2,2166,1152,1014
Missouri,Dunklin County,3,2119,1031,1088
Missouri,Dunklin County,4,1911,949,962
Missouri,Dunklin County,5,1600,802,798
Missouri,Dunklin County,6,1745,847,898
Missouri,Dunklin County,7,1527,735,792
Missouri,Dunklin County,8,1639,781,858
Missouri,Dunklin County,9,1683,808,875
Missouri,Dunklin County,10,1742,843,899
Missouri,Dunklin County,11,1818,864,954
Missouri,Dunklin County,12,2025,1001,1024
Missouri,Dunklin County,13,1940,902,1038
Missouri,Dunklin County,14,1657,789,868
Missouri,Dunklin County,15,1376,564,812
Missouri,Dunklin County,16,1057,470,587
Missouri,Dunklin County,17,711,271,440
Missouri,Dunklin County,18,707,226,481
Missouri,Franklin County,0,103670,51520,52150
Missouri,Franklin County,1,6281,3231,3050
Missouri,Franklin County,2,6551,3388,3163
Missouri,Franklin County,3,6838,3531,3307
Missouri,Franklin County,4,6291,3247,3044
Missouri,Franklin County,5,5651,2922,2729
Missouri,Franklin County,6,6640,3366,3274
Missouri,Franklin County,7,6204,3153,3051
Missouri,Franklin County,8,6195,3143,3052
Missouri,Franklin County,9,5546,2800,2746
Missouri,Franklin County,10,6401,3161,3240
Missouri,Franklin County,11,7341,3639,3702
Missouri,Franklin County,12,8357,4199,4158
Missouri,Franklin County,13,7376,3588,3788
Missouri,Franklin County,14,5830,2850,2980
Missouri,Franklin County,15,4642,2158,2484
Missouri,Franklin County,16,3360,1510,1850
Missouri,Franklin County,17,2156,926,1230
Missouri,Franklin County,18,2010,708,1302
Missouri,Gasconade County,0,14705,7340,7365
Missouri,Gasconade County,1,774,423,351
Missouri,Gasconade County,2,791,425,366
Missouri,Gasconade County,3,912,474,438
Missouri,Gasconade County,4,850,447,403
Missouri,Gasconade County,5,731,364,367
Missouri,Gasconade County,6,822,407,415
Missouri,Gasconade County,7,755,376,379
Missouri,Gasconade County,8,795,399,396
Missouri,Gasconade County,9,719,366,353
Missouri,Gasconade County,10,860,449,411
Missouri,Gasconade County,11,1005,483,522
Missouri,Gasconade County,12,1159,599,560
Missouri,Gasconade County,13,1188,627,561
Missouri,Gasconade County,14,970,475,495
Missouri,Gasconade County,15,842,387,455
Missouri,Gasconade County,16,598,286,312
Missouri,Gasconade County,17,441,193,248
Missouri,Gasconade County,18,493,160,333
Missouri,Gentry County,0,6628,3198,3430
Missouri,Gentry County,1,480,227,253
Missouri,Gentry County,2,471,233,238
Missouri,Gentry County,3,425,201,224
Missouri,Gentry County,4,405,204,201
Missouri,Gentry County,5,333,157,176
Missouri,Gentry County,6,418,210,208
Missouri,Gentry County,7,375,178,197
Missouri,Gentry County,8,380,186,194
Missouri,Gentry County,9,336,170,166
Missouri,Gentry County,10,369,179,190
Missouri,Gentry County,11,405,209,196
Missouri,Gentry County,12,467,242,225
Missouri,Gentry County,13,447,221,226
Missouri,Gentry County,14,354,169,185
Missouri,Gentry County,15,273,132,141
Missouri,Gentry County,16,258,121,137
Missouri,Gentry County,17,189,82,107
Missouri,Gentry County,18,243,77,166
Missouri,Greene County,0,291923,141855,150068
Missouri,Greene County,1,17658,9039,8619
Missouri,Greene County,2,16770,8564,8206
Missouri,Greene County,3,16807,8638,8169
Missouri,Greene County,4,19063,9450,9613
Missouri,Greene County,5,30426,14840,15586
Missouri,Greene County,6,22296,11223,11073
Missouri,Greene County,7,18862,9543,9319
Missouri,Greene County,8,18389,9365,9024
Missouri,Greene County,9,15904,8044,7860
Missouri,Greene County,10,16441,8211,8230
Missouri,Greene County,11,16433,8040,8393
Missouri,Greene County,12,17957,8561,9396
Missouri,Greene County,13,16832,8013,8819
Missouri,Greene County,14,14766,6614,8152
Missouri,Greene County,15,11917,5360,6557
Missouri,Greene County,16,8708,3685,5023
Missouri,Greene County,17,5903,2387,3516
Missouri,Greene County,18,6791,2278,4513
Missouri,Grundy County,0,9914,4824,5090
Missouri,Grundy County,1,725,381,344
Missouri,Grundy County,2,643,332,311
Missouri,Grundy County,3,640,333,307
Missouri,Grundy County,4,631,290,341
Missouri,Grundy County,5,543,270,273
Missouri,Grundy County,6,641,314,327
Missouri,Grundy County,7,586,308,278
Missouri,Grundy County,8,497,270,227
Missouri,Grundy County,9,454,229,225
Missouri,Grundy County,10,504,227,277
Missouri,Grundy County,11,574,283,291
Missouri,Grundy County,12,682,341,341
Missouri,Grundy County,13,654,339,315
Missouri,Grundy County,14,581,268,313
Missouri,Grundy County,15,476,220,256
Missouri,Grundy County,16,444,196,248
Missouri,Grundy County,17,294,119,175
Missouri,Grundy County,18,345,104,241
Missouri,Harrison County,0,8414,4155,4259
Missouri,Harrison County,1,537,289,248
Missouri,Harrison County,2,538,263,275
Missouri,Harrison County,3,627,327,300
Missouri,Harrison County,4,517,276,241
Missouri,Harrison County,5,376,211,165
Missouri,Harrison County,6,436,225,211
Missouri,Harrison County,7,451,221,230
Missouri,Harrison County,8,463,242,221
Missouri,Harrison County,9,415,208,207
Missouri,Harrison County,10,437,227,210
Missouri,Harrison County,11,502,247,255
Missouri,Harrison County,12,592,286,306
Missouri,Harrison County,13,633,293,340
Missouri,Harrison County,14,520,260,260
Missouri,Harrison County,15,427,219,208
Missouri,Harrison County,16,361,168,193
Missouri,Harrison County,17,253,95,158
Missouri,Harrison County,18,329,98,231
Missouri,Henry County,0,21792,10691,11101
Missouri,Henry County,1,1294,657,637
Missouri,Henry County,2,1365,698,667
Missouri,Henry County,3,1309,652,657
Missouri,Henry County,4,1283,659,624
Missouri,Henry County,5,1074,546,528
Missouri,Henry County,6,1211,600,611
Missouri,Henry County,7,1222,618,604
Missouri,Henry County,8,1244,606,638
Missouri,Henry County,9,1096,559,537
Missouri,Henry County,10,1272,631,641
Missouri,Henry County,11,1403,720,683
Missouri,Henry County,12,1673,814,859
Missouri,Henry County,13,1608,760,848
Missouri,Henry County,14,1420,681,739
Missouri,Henry County,15,1267,614,653
Missouri,Henry County,16,912,421,491
Missouri,Henry County,17,577,260,317
Missouri,Henry County,18,562,195,367
Missouri,Hickory County,0,9509,4700,4809
Missouri,Hickory County,1,426,234,192
Missouri,Hickory County,2,427,216,211
Missouri,Hickory County,3,486,235,251
Missouri,Hickory County,4,458,229,229
Missouri,Hickory County,5,322,156,166
Missouri,Hickory County,6,351,177,174
Missouri,Hickory County,7,368,192,176
Missouri,Hickory County,8,407,192,215
Missouri,Hickory County,9,368,165,203
Missouri,Hickory County,10,512,263,249
Missouri,Hickory County,11,613,308,305
Missouri,Hickory County,12,791,366,425
Missouri,Hickory County,13,863,414,449
Missouri,Hickory County,14,915,453,462
Missouri,Hickory County,15,890,456,434
Missouri,Hickory County,16,636,331,305
Missouri,Hickory County,17,375,182,193
Missouri,Hickory County,18,301,131,170
Missouri,Holt County,0,4404,2154,2250
Missouri,Holt County,1,227,103,124
Missouri,Holt County,2,257,131,126
Missouri,Holt County,3,266,131,135
Missouri,Holt County,4,227,115,112
Missouri,Holt County,5,173,85,88
Missouri,Holt County,6,216,101,115
Missouri,Holt County,7,217,122,95
Missouri,Holt County,8,217,122,95
Missouri,Holt County,9,232,114,118
Missouri,Holt County,10,277,140,137
Missouri,Holt County,11,301,142,159
Missouri,Holt County,12,353,171,182
Missouri,Holt County,13,335,158,177
Missouri,Holt County,14,330,180,150
Missouri,Holt County,15,245,120,125
Missouri,Holt County,16,190,100,90
Missouri,Holt County,17,138,60,78
Missouri,Holt County,18,203,59,144
Missouri,Howard County,0,10137,5064,5073
Missouri,Howard County,1,602,302,300
Missouri,Howard County,2,613,341,272
Missouri,Howard County,3,633,320,313
Missouri,Howard County,4,791,416,375
Missouri,Howard County,5,808,415,393
Missouri,Howard County,6,538,264,274
Missouri,Howard County,7,573,277,296
Missouri,Howard County,8,595,295,300
Missouri,Howard County,9,471,237,234
Missouri,Howard County,10,536,268,268
Missouri,Howard County,11,590,315,275
Missouri,Howard County,12,723,356,367
Missouri,Howard County,13,711,357,354
Missouri,Howard County,14,642,304,338
Missouri,Howard County,15,438,222,216
Missouri,Howard County,16,353,166,187
Missouri,Howard County,17,255,109,146
Missouri,Howard County,18,265,100,165
Missouri,Howell County,0,40076,19500,20576
Missouri,Howell County,1,2533,1249,1284
Missouri,Howell County,2,2680,1398,1282
Missouri,Howell County,3,2724,1364,1360
Missouri,Howell County,4,2502,1275,1227
Missouri,Howell County,5,2239,1162,1077
Missouri,Howell County,6,2482,1247,1235
Missouri,Howell County,7,2324,1126,1198
Missouri,Howell County,8,2259,1144,1115
Missouri,Howell County,9,2255,1096,1159
Missouri,Howell County,10,2391,1157,1234
Missouri,Howell County,11,2379,1174,1205
Missouri,Howell County,12,2785,1325,1460
Missouri,Howell County,13,2571,1212,1359
Missouri,Howell County,14,2451,1189,1262
Missouri,Howell County,15,2051,931,1120
Missouri,Howell County,16,1437,648,789
Missouri,Howell County,17,989,449,540
Missouri,Howell County,18,1024,354,670
Missouri,Iron County,0,10177,5069,5108
Missouri,Iron County,1,529,272,257
Missouri,Iron County,2,553,294,259
Missouri,Iron County,3,645,332,313
Missouri,Iron County,4,605,320,285
Missouri,Iron County,5,497,240,257
Missouri,Iron County,6,538,283,255
Missouri,Iron County,7,512,276,236
Missouri,Iron County,8,608,258,350
Missouri,Iron County,9,610,302,308
Missouri,Iron County,10,628,334,294
Missouri,Iron County,11,678,342,336
Missouri,Iron County,12,812,414,398
Missouri,Iron County,13,785,384,401
Missouri,Iron County,14,694,344,350
Missouri,Iron County,15,537,270,267
Missouri,Iron County,16,404,192,212
Missouri,Iron County,17,286,129,157
Missouri,Iron County,18,256,83,173
Missouri,Jackson County,0,700307,338751,361556
Missouri,Jackson County,1,46270,23756,22514
Missouri,Jackson County,2,45840,23186,22654
Missouri,Jackson County,3,46126,23359,22767
Missouri,Jackson County,4,42056,21189,20867
Missouri,Jackson County,5,42171,20708,21463
Missouri,Jackson County,6,57674,28450,29224
Missouri,Jackson County,7,51895,25643,26252
Missouri,Jackson County,8,47790,23369,24421
Missouri,Jackson County,9,40242,19496,20746
Missouri,Jackson County,10,42108,20738,21370
Missouri,Jackson County,11,42425,20760,21665
Missouri,Jackson County,12,48030,22959,25071
Missouri,Jackson County,13,43025,20355,22670
Missouri,Jackson County,14,34884,16006,18878
Missouri,Jackson County,15,25982,11561,14421
Missouri,Jackson County,16,17876,7690,10186
Missouri,Jackson County,17,12127,4850,7277
Missouri,Jackson County,18,13786,4676,9110
Missouri,Jasper County,0,120636,58923,61713
Missouri,Jasper County,1,8277,4204,4073
Missouri,Jasper County,2,8337,4249,4088
Missouri,Jasper County,3,8474,4263,4211
Missouri,Jasper County,4,8082,4201,3881
Missouri,Jasper County,5,7970,4038,3932
Missouri,Jasper County,6,8890,4427,4463
Missouri,Jasper County,7,8067,3996,4071
Missouri,Jasper County,8,7880,3922,3958
Missouri,Jasper County,9,7138,3574,3564
Missouri,Jasper County,10,7218,3476,3742
Missouri,Jasper County,11,6820,3365,3455
Missouri,Jasper County,12,7576,3722,3854
Missouri,Jasper County,13,7044,3309,3735
Missouri,Jasper County,14,5983,2719,3264
Missouri,Jasper County,15,4708,2158,2550
Missouri,Jasper County,16,3427,1534,1893
Missouri,Jasper County,17,2329,971,1358
Missouri,Jasper County,18,2416,795,1621
Missouri,Jefferson County,0,224347,111370,112977
Missouri,Jefferson County,1,13211,6669,6542
Missouri,Jefferson County,2,14439,7420,7019
Missouri,Jefferson County,3,15255,7862,7393
Missouri,Jefferson County,4,13800,7115,6685
Missouri,Jefferson County,5,11866,6106,5760
Missouri,Jefferson County,6,14308,7211,7097
Missouri,Jefferson County,7,14621,7349,7272
Missouri,Jefferson County,8,15455,7778,7677
Missouri,Jefferson County,9,14074,7128,6946
Missouri,Jefferson County,10,14912,7366,7546
Missouri,Jefferson County,11,15579,7712,7867
Missouri,Jefferson County,12,17799,8947,8852
Missouri,Jefferson County,13,15392,7471,7921
Missouri,Jefferson County,14,12086,5721,6365
Missouri,Jefferson County,15,8846,4142,4704
Missouri,Jefferson County,16,6160,2739,3421
Missouri,Jefferson County,17,3511,1535,1976
Missouri,Jefferson County,18,3033,1099,1934
Missouri,Johnson County,0,53652,27578,26074
Missouri,Johnson County,1,3340,1699,1641
Missouri,Johnson County,2,3195,1650,1545
Missouri,Johnson County,3,3133,1621,1512
Missouri,Johnson County,4,4377,2160,2217
Missouri,Johnson County,5,8183,4590,3593
Missouri,Johnson County,6,4368,2456,1912
Missouri,Johnson County,7,3408,1786,1622
Missouri,Johnson County,8,3145,1602,1543
Missouri,Johnson County,9,2543,1350,1193
Missouri,Johnson County,10,2559,1242,1317
Missouri,Johnson County,11,2635,1296,1339
Missouri,Johnson County,12,3232,1553,1679
Missouri,Johnson County,13,2744,1346,1398
Missouri,Johnson County,14,2193,1093,1100
Missouri,Johnson County,15,1751,834,917
Missouri,Johnson County,16,1215,577,638
Missouri,Johnson County,17,782,372,410
Missouri,Johnson County,18,849,351,498
Missouri,Knox County,0,3947,1974,1973
Missouri,Knox County,1,231,119,112
Missouri,Knox County,2,247,133,114
Missouri,Knox County,3,265,140,125
Missouri,Knox County,4,271,147,124
Missouri,Knox County,5,208,114,94
Missouri,Knox County,6,193,101,92
Missouri,Knox County,7,186,89,97
Missouri,Knox County,8,195,102,93
Missouri,Knox County,9,189,83,106
Missouri,Knox County,10,231,120,111
Missouri,Knox County,11,246,117,129
Missouri,Knox County,12,315,167,148
Missouri,Knox County,13,299,153,146
Missouri,Knox County,14,231,116,115
Missouri,Knox County,15,219,100,119
Missouri,Knox County,16,194,88,106
Missouri,Knox County,17,101,39,62
Missouri,Knox County,18,126,46,80
Missouri,Laclede County,0,35713,17552,18161
Missouri,Laclede County,1,2482,1262,1220
Missouri,Laclede County,2,2326,1154,1172
Missouri,Laclede County,3,2561,1334,1227
Missouri,Laclede County,4,2212,1128,1084
Missouri,Laclede County,5,1940,958,982
Missouri,Laclede County,6,2138,1101,1037
Missouri,Laclede County,7,2039,1012,1027
Missouri,Laclede County,8,2167,1068,1099
Missouri,Laclede County,9,1959,943,1016
Missouri,Laclede County,10,2263,1124,1139
Missouri,Laclede County,11,2348,1165,1183
Missouri,Laclede County,12,2584,1316,1268
Missouri,Laclede County,13,2321,1115,1206
Missouri,Laclede County,14,1955,918,1037
Missouri,Laclede County,15,1673,779,894
Missouri,Laclede County,16,1229,550,679
Missouri,Laclede County,17,821,355,466
Missouri,Laclede County,18,695,270,425
Missouri,Lafayette County,0,32598,16169,16429
Missouri,Lafayette County,1,1893,996,897
Missouri,Lafayette County,2,2045,1045,1000
Missouri,Lafayette County,3,2193,1105,1088
Missouri,Lafayette County,4,2087,1134,953
Missouri,Lafayette County,5,1721,928,793
Missouri,Lafayette County,6,1982,1014,968
Missouri,Lafayette County,7,1872,893,979
Missouri,Lafayette County,8,1855,920,935
Missouri,Lafayette County,9,1779,875,904
Missouri,Lafayette County,10,2123,1022,1101
Missouri,Lafayette County,11,2158,1091,1067
Missouri,Lafayette County,12,2452,1200,1252
Missouri,Lafayette County,13,2288,1136,1152
Missouri,Lafayette County,14,1788,861,927
Missouri,Lafayette County,15,1433,683,750
Missouri,Lafayette County,16,1228,598,630
Missouri,Lafayette County,17,791,355,436
Missouri,Lafayette County,18,910,313,597
Missouri,Lawrence County,0,38359,19039,19320
Missouri,Lawrence County,1,2555,1281,1274
Missouri,Lawrence County,2,2592,1331,1261
Missouri,Lawrence County,3,2799,1458,1341
Missouri,Lawrence County,4,2631,1372,1259
Missouri,Lawrence County,5,2079,1087,992
Missouri,Lawrence County,6,2159,1085,1074
Missouri,Lawrence County,7,2100,1052,1048
Missouri,Lawrence County,8,2336,1159,1177
Missouri,Lawrence County,9,2132,1051,1081
Missouri,Lawrence County,10,2399,1222,1177
Missouri,Lawrence County,11,2377,1182,1195
Missouri,Lawrence County,12,2745,1333,1412
Missouri,Lawrence County,13,2437,1181,1256
Missouri,Lawrence County,14,2033,996,1037
Missouri,Lawrence County,15,1756,787,969
Missouri,Lawrence County,16,1302,618,684
Missouri,Lawrence County,17,926,423,503
Missouri,Lawrence County,18,1001,421,580
Missouri,Lewis County,0,9855,4950,4905
Missouri,Lewis County,1,562,305,257
Missouri,Lewis County,2,578,294,284
Missouri,Lewis County,3,653,348,305
Missouri,Lewis County,4,756,402,354
Missouri,Lewis County,5,863,465,398
Missouri,Lewis County,6,516,259,257
Missouri,Lewis County,7,504,253,251
Missouri,Lewis County,8,577,275,302
Missouri,Lewis County,9,487,250,237
Missouri,Lewis County,10,536,262,274
Missouri,Lewis County,11,617,320,297
Missouri,Lewis County,12,713,354,359
Missouri,Lewis County,13,671,325,346
Missouri,Lewis County,14,497,240,257
Missouri,Lewis County,15,486,250,236
Missouri,Lewis County,16,338,161,177
Missouri,Lewis County,17,244,96,148
Missouri,Lewis County,18,257,91,166
Missouri,Lincoln County,0,57686,28843,28843
Missouri,Lincoln County,1,3995,1977,2018
Missouri,Lincoln County,2,3977,2068,1909
Missouri,Lincoln County,3,4172,2209,1963
Missouri,Lincoln County,4,3759,1943,1816
Missouri,Lincoln County,5,3246,1625,1621
Missouri,Lincoln County,6,4236,2086,2150
Missouri,Lincoln County,7,3736,1807,1929
Missouri,Lincoln County,8,3889,1961,1928
Missouri,Lincoln County,9,3322,1645,1677
Missouri,Lincoln County,10,3628,1845,1783
Missouri,Lincoln County,11,3945,1964,1981
Missouri,Lincoln County,12,4262,2160,2102
Missouri,Lincoln County,13,3779,1903,1876
Missouri,Lincoln County,14,2718,1315,1403
Missouri,Lincoln County,15,1954,970,984
Missouri,Lincoln County,16,1435,705,730
Missouri,Lincoln County,17,821,365,456
Missouri,Lincoln County,18,812,295,517
Missouri,Linn County,0,12037,5868,6169
Missouri,Linn County,1,730,366,364
Missouri,Linn County,2,717,391,326
Missouri,Linn County,3,875,440,435
Missouri,Linn County,4,769,384,385
Missouri,Linn County,5,642,341,301
Missouri,Linn County,6,699,369,330
Missouri,Linn County,7,599,301,298
Missouri,Linn County,8,664,313,351
Missouri,Linn County,9,655,331,324
Missouri,Linn County,10,649,319,330
Missouri,Linn County,11,699,354,345
Missouri,Linn County,12,936,443,493
Missouri,Linn County,13,860,410,450
Missouri,Linn County,14,781,384,397
Missouri,Linn County,15,641,291,350
Missouri,Linn County,16,448,203,245
Missouri,Linn County,17,302,116,186
Missouri,Linn County,18,371,112,259
Missouri,Livingston County,0,15146,6589,8557
Missouri,Livingston County,1,852,450,402
Missouri,Livingston County,2,856,449,407
Missouri,Livingston County,3,956,450,506
Missouri,Livingston County,4,778,404,374
Missouri,Livingston County,5,870,367,503
Missouri,Livingston County,6,1073,417,656
Missouri,Livingston County,7,1025,380,645
Missouri,Livingston County,8,1025,380,645
Missouri,Livingston County,9,1024,377,647
Missouri,Livingston County,10,939,367,572
Missouri,Livingston County,11,926,401,525
Missouri,Livingston County,12,989,451,538
Missouri,Livingston County,13,918,441,477
Missouri,Livingston County,14,791,377,414
Missouri,Livingston County,15,705,307,398
Missouri,Livingston County,16,540,255,285
Missouri,Livingston County,17,353,150,203
Missouri,Livingston County,18,526,166,360
Missouri,McDonald County,0,23078,11647,11431
Missouri,McDonald County,1,1711,902,809
Missouri,McDonald County,2,1543,766,777
Missouri,McDonald County,3,1665,860,805
Missouri,McDonald County,4,1609,833,776
Missouri,McDonald County,5,1316,704,612
Missouri,McDonald County,6,1386,719,667
Missouri,McDonald County,7,1319,683,636
Missouri,McDonald County,8,1428,714,714
Missouri,McDonald County,9,1364,644,720
Missouri,McDonald County,10,1485,773,712
Missouri,McDonald County,11,1592,799,793
Missouri,McDonald County,12,1664,837,827
Missouri,McDonald County,13,1469,735,734
Missouri,McDonald County,14,1159,588,571
Missouri,McDonald County,15,948,459,489
Missouri,McDonald County,16,689,335,354
Missouri,McDonald County,17,419,180,239
Missouri,McDonald County,18,312,116,196
Missouri,Macon County,0,15153,7505,7648
Missouri,Macon County,1,863,464,399
Missouri,Macon County,2,937,475,462
Missouri,Macon County,3,1040,508,532
Missouri,Macon County,4,933,485,448
Missouri,Macon County,5,767,426,341
Missouri,Macon County,6,792,395,397
Missouri,Macon County,7,752,375,377
Missouri,Macon County,8,842,410,432
Missouri,Macon County,9,827,436,391
Missouri,Macon County,10,891,429,462
Missouri,Macon County,11,909,480,429
Missouri,Macon County,12,1088,555,533
Missouri,Macon County,13,1065,514,551
Missouri,Macon County,14,988,474,514
Missouri,Macon County,15,855,415,440
Missouri,Macon County,16,681,305,376
Missouri,Macon County,17,425,196,229
Missouri,Macon County,18,498,163,335
Missouri,Madison County,0,12188,5961,6227
Missouri,Madison County,1,730,387,343
Missouri,Madison County,2,802,407,395
Missouri,Madison County,3,818,422,396
Missouri,Madison County,4,724,377,347
Missouri,Madison County,5,609,307,302
Missouri,Madison County,6,781,374,407
Missouri,Madison County,7,675,328,347
Missouri,Madison County,8,682,342,340
Missouri,Madison County,9,694,359,335
Missouri,Madison County,10,787,363,424
Missouri,Madison County,11,804,399,405
Missouri,Madison County,12,874,424,450
Missouri,Madison County,13,878,427,451
Missouri,Madison County,14,700,335,365
Missouri,Madison County,15,577,261,316
Missouri,Madison County,16,470,207,263
Missouri,Madison County,17,294,123,171
Missouri,Madison County,18,289,119,170
Missouri,Maries County,0,8769,4401,4368
Missouri,Maries County,1,389,186,203
Missouri,Maries County,2,480,253,227
Missouri,Maries County,3,562,297,265
Missouri,Maries County,4,528,264,264
Missouri,Maries County,5,477,248,229
Missouri,Maries County,6,454,253,201
Missouri,Maries County,7,443,198,245
Missouri,Maries County,8,498,251,247
Missouri,Maries County,9,484,269,215
Missouri,Maries County,10,546,263,283
Missouri,Maries County,11,630,299,331
Missouri,Maries County,12,736,389,347
Missouri,Maries County,13,659,329,330
Missouri,Maries County,14,588,292,296
Missouri,Maries County,15,453,214,239
Missouri,Maries County,16,383,195,188
Missouri,Maries County,17,230,97,133
Missouri,Maries County,18,229,104,125
Missouri,Marion County,0,28592,13924,14668
Missouri,Marion County,1,1859,964,895
Missouri,Marion County,2,1766,843,923
Missouri,Marion County,3,1924,924,1000
Missouri,Marion County,4,1871,988,883
Missouri,Marion County,5,1865,943,922
Missouri,Marion County,6,1818,874,944
Missouri,Marion County,7,1673,847,826
Missouri,Marion County,8,1739,853,886
Missouri,Marion County,9,1585,798,787
Missouri,Marion County,10,1706,880,826
Missouri,Marion County,11,1729,858,871
Missouri,Marion County,12,1964,955,1009
Missouri,Marion County,13,1925,924,1001
Missouri,Marion County,14,1623,766,857
Missouri,Marion County,15,1239,592,647
Missouri,Marion County,16,892,383,509
Missouri,Marion County,17,647,268,379
Missouri,Marion County,18,767,264,503
Missouri,Mercer County,0,3641,1851,1790
Missouri,Mercer County,1,234,124,110
Missouri,Mercer County,2,220,116,104
Missouri,Mercer County,3,250,127,123
Missouri,Mercer County,4,246,136,110
Missouri,Mercer County,5,192,105,87
Missouri,Mercer County,6,183,89,94
Missouri,Mercer County,7,165,88,77
Missouri,Mercer County,8,189,95,94
Missouri,Mercer County,9,162,77,85
Missouri,Mercer County,10,219,120,99
Missouri,Mercer County,11,205,96,109
Missouri,Mercer County,12,278,131,147
Missouri,Mercer County,13,295,155,140
Missouri,Mercer County,14,244,135,109
Missouri,Mercer County,15,159,85,74
Missouri,Mercer County,16,150,69,81
Missouri,Mercer County,17,104,49,55
Missouri,Mercer County,18,146,54,92
Missouri,Miller County,0,25336,12645,12691
Missouri,Miller County,1,1584,790,794
Missouri,Miller County,2,1591,798,793
Missouri,Miller County,3,1751,894,857
Missouri,Miller County,4,1549,810,739
Missouri,Miller County,5,1338,719,619
Missouri,Miller County,6,1485,744,741
Missouri,Miller County,7,1498,775,723
Missouri,Miller County,8,1531,749,782
Missouri,Miller County,9,1384,685,699
Missouri,Miller County,10,1509,793,716
Missouri,Miller County,11,1651,849,802
Missouri,Miller County,12,1818,873,945
Missouri,Miller County,13,1769,863,906
Missouri,Miller County,14,1609,781,828
Missouri,Miller County,15,1251,627,624
Missouri,Miller County,16,874,410,464
Missouri,Miller County,17,538,240,298
Missouri,Miller County,18,606,245,361
Missouri,Mississippi County,0,13336,7219,6117
Missouri,Mississippi County,1,674,333,341
Missouri,Mississippi County,2,822,401,421
Missouri,Mississippi County,3,798,439,359
Missouri,Mississippi County,4,771,413,358
Missouri,Mississippi County,5,828,508,320
Missouri,Mississippi County,6,969,624,345
Missouri,Mississippi County,7,858,514,344
Missouri,Mississippi County,8,880,529,351
Missouri,Mississippi County,9,889,517,372
Missouri,Mississippi County,10,892,566,326
Missouri,Mississippi County,11,902,503,399
Missouri,Mississippi County,12,904,459,445
Missouri,Mississippi County,13,777,379,398
Missouri,Mississippi County,14,723,335,388
Missouri,Mississippi County,15,610,283,327
Missouri,Mississippi County,16,491,229,262
Missouri,Mississippi County,17,286,126,160
Missouri,Mississippi County,18,262,61,201
Missouri,Moniteau County,0,16121,8567,7554
Missouri,Moniteau County,1,1013,510,503
Missouri,Moniteau County,2,1119,548,571
Missouri,Moniteau County,3,1112,576,536
Missouri,Moniteau County,4,1045,525,520
Missouri,Moniteau County,5,912,512,400
Missouri,Moniteau County,6,1108,657,451
Missouri,Moniteau County,7,1085,631,454
Missouri,Moniteau County,8,1141,682,459
Missouri,Moniteau County,9,1047,608,439
Missouri,Moniteau County,10,1057,595,462
Missouri,Moniteau County,11,1014,558,456
Missouri,Moniteau County,12,1026,531,495
Missouri,Moniteau County,13,899,455,444
Missouri,Moniteau County,14,776,384,392
Missouri,Moniteau County,15,666,320,346
Missouri,Moniteau County,16,440,218,222
Missouri,Moniteau County,17,328,143,185
Missouri,Moniteau County,18,333,114,219
Missouri,Monroe County,0,8664,4388,4276
Missouri,Monroe County,1,511,269,242
Missouri,Monroe County,2,508,268,240
Missouri,Monroe County,3,526,284,242
Missouri,Monroe County,4,528,270,258
Missouri,Monroe County,5,370,197,173
Missouri,Monroe County,6,436,217,219
Missouri,Monroe County,7,422,212,210
Missouri,Monroe County,8,475,252,223
Missouri,Monroe County,9,434,243,191
Missouri,Monroe County,10,501,252,249
Missouri,Monroe County,11,521,263,258
Missouri,Monroe County,12,710,361,349
Missouri,Monroe County,13,699,342,357
Missouri,Monroe County,14,615,306,309
Missouri,Monroe County,15,492,248,244
Missouri,Monroe County,16,399,204,195
Missouri,Monroe County,17,252,101,151
Missouri,Monroe County,18,265,99,166
Missouri,Montgomery County,0,11534,5785,5749
Missouri,Montgomery County,1,617,293,324
Missouri,Montgomery County,2,677,362,315
Missouri,Montgomery County,3,758,413,345
Missouri,Montgomery County,4,709,399,310
Missouri,Montgomery County,5,534,282,252
Missouri,Montgomery County,6,653,350,303
Missouri,Montgomery County,7,596,288,308
Missouri,Montgomery County,8,656,327,329
Missouri,Montgomery County,9,627,306,321
Missouri,Montgomery County,10,685,371,314
Missouri,Montgomery County,11,778,396,382
Missouri,Montgomery County,12,938,457,481
Missouri,Montgomery County,13,864,436,428
Missouri,Montgomery County,14,743,378,365
Missouri,Montgomery County,15,551,257,294
Missouri,Montgomery County,16,460,213,247
Missouri,Montgomery County,17,309,134,175
Missouri,Montgomery County,18,379,123,256
Missouri,Morgan County,0,20358,10198,10160
Missouri,Morgan County,1,1303,655,648
Missouri,Morgan County,2,1245,640,605
Missouri,Morgan County,3,1333,703,630
Missouri,Morgan County,4,1177,596,581
Missouri,Morgan County,5,923,475,448
Missouri,Morgan County,6,1083,535,548
Missouri,Morgan County,7,1019,500,519
Missouri,Morgan County,8,994,517,477
Missouri,Morgan County,9,952,491,461
Missouri,Morgan County,10,1057,523,534
Missouri,Morgan County,11,1297,650,647
Missouri,Morgan County,12,1548,759,789
Missouri,Morgan County,13,1655,826,829
Missouri,Morgan County,14,1483,753,730
Missouri,Morgan County,15,1235,613,622
Missouri,Morgan County,16,983,499,484
Missouri,Morgan County,17,569,261,308
Missouri,Morgan County,18,502,202,300
Missouri,New Madrid County,0,17296,8307,8989
Missouri,New Madrid County,1,1074,538,536
Missouri,New Madrid County,2,1076,572,504
Missouri,New Madrid County,3,1202,624,578
Missouri,New Madrid County,4,980,480,500
Missouri,New Madrid County,5,871,449,422
Missouri,New Madrid County,6,1081,538,543
Missouri,New Madrid County,7,961,451,510
Missouri,New Madrid County,8,982,469,513
Missouri,New Madrid County,9,991,483,508
Missouri,New Madrid County,10,1090,543,547
Missouri,New Madrid County,11,1124,534,590
Missouri,New Madrid County,12,1318,633,685
Missouri,New Madrid County,13,1233,557,676
Missouri,New Madrid County,14,1040,485,555
Missouri,New Madrid County,15,863,408,455
Missouri,New Madrid County,16,604,261,343
Missouri,New Madrid County,17,411,155,256
Missouri,New Madrid County,18,395,127,268
Missouri,Newton County,0,58266,29061,29205
Missouri,Newton County,1,3563,1931,1632
Missouri,Newton County,2,3761,1919,1842
Missouri,Newton County,3,4001,2088,1913
Missouri,Newton County,4,3915,2056,1859
Missouri,Newton County,5,3323,1781,1542
Missouri,Newton County,6,3559,1789,1770
Missouri,Newton County,7,3317,1708,1609
Missouri,Newton County,8,3431,1707,1724
Missouri,Newton County,9,3211,1612,1599
Missouri,Newton County,10,3641,1803,1838
Missouri,Newton County,11,3851,1901,1950
Missouri,Newton County,12,4179,2092,2087
Missouri,Newton County,13,3961,1890,2071
Missouri,Newton County,14,3241,1580,1661
Missouri,Newton County,15,2801,1316,1485
Missouri,Newton County,16,2049,902,1147
Missouri,Newton County,17,1329,567,762
Missouri,Newton County,18,1133,419,714
Missouri,Nodaway County,0,22304,11244,11060
Missouri,Nodaway County,1,1060,557,503
Missouri,Nodaway County,2,913,485,428
Missouri,Nodaway County,3,920,475,445
Missouri,Nodaway County,4,2556,1136,1420
Missouri,Nodaway County,5,4466,2256,2210
Missouri,Nodaway County,6,1338,803,535
Missouri,Nodaway County,7,1083,614,469
Missouri,Nodaway County,8,1149,617,532
Missouri,Nodaway County,9,949,502,447
Missouri,Nodaway County,10,967,519,448
Missouri,Nodaway County,11,1104,553,551
Missouri,Nodaway County,12,1252,616,636
Missouri,Nodaway County,13,1143,588,555
Missouri,Nodaway County,14,977,474,503
Missouri,Nodaway County,15,795,402,393
Missouri,Nodaway County,16,615,270,345
Missouri,Nodaway County,17,451,175,276
Missouri,Nodaway County,18,566,202,364
Missouri,Oregon County,0,10541,5180,5361
Missouri,Oregon County,1,632,332,300
Missouri,Oregon County,2,655,338,317
Missouri,Oregon County,3,676,347,329
Missouri,Oregon County,4,611,286,325
Missouri,Oregon County,5,499,259,240
Missouri,Oregon County,6,532,274,258
Missouri,Oregon County,7,491,234,257
Missouri,Oregon County,8,516,259,257
Missouri,Oregon County,9,512,269,243
Missouri,Oregon County,10,597,282,315
Missouri,Oregon County,11,691,348,343
Missouri,Oregon County,12,870,413,457
Missouri,Oregon County,13,801,407,394
Missouri,Oregon County,14,727,347,380
Missouri,Oregon County,15,636,306,330
Missouri,Oregon County,16,513,246,267
Missouri,Oregon County,17,309,143,166
Missouri,Oregon County,18,273,90,183
Missouri,Osage County,0,13714,7066,6648
Missouri,Osage County,1,830,425,405
Missouri,Osage County,2,818,411,407
Missouri,Osage County,3,974,510,464
Missouri,Osage County,4,937,519,418
Missouri,Osage County,5,773,424,349
Missouri,Osage County,6,828,450,378
Missouri,Osage County,7,725,373,352
Missouri,Osage County,8,819,431,388
Missouri,Osage County,9,804,422,382
Missouri,Osage County,10,884,465,419
Missouri,Osage County,11,944,477,467
Missouri,Osage County,12,1068,556,512
Missouri,Osage County,13,920,475,445
Missouri,Osage County,14,722,365,357
Missouri,Osage County,15,575,291,284
Missouri,Osage County,16,465,213,252
Missouri,Osage County,17,327,157,170
Missouri,Osage County,18,301,102,199
Missouri,Ozark County,0,9017,4523,4494
Missouri,Ozark County,1,376,203,173
Missouri,Ozark County,2,456,251,205
Missouri,Ozark County,3,552,281,271
Missouri,Ozark County,4,446,218,228
Missouri,Ozark County,5,336,185,151
Missouri,Ozark County,6,386,198,188
Missouri,Ozark County,7,364,164,200
Missouri,Ozark County,8,413,199,214
Missouri,Ozark County,9,439,222,217
Missouri,Ozark County,10,465,241,224
Missouri,Ozark County,11,570,266,304
Missouri,Ozark County,12,749,370,379
Missouri,Ozark County,13,865,429,436
Missouri,Ozark County,14,795,418,377
Missouri,Ozark County,15,663,333,330
Missouri,Ozark County,16,541,287,254
Missouri,Ozark County,17,322,152,170
Missouri,Ozark County,18,279,106,173
Missouri,Pemiscot County,0,16272,7688,8584
Missouri,Pemiscot County,1,1179,588,591
Missouri,Pemiscot County,2,1155,580,575
Missouri,Pemiscot County,3,1137,605,532
Missouri,Pemiscot County,4,1090,560,530
Missouri,Pemiscot County,5,920,445,475
Missouri,Pemiscot County,6,1025,484,541
Missouri,Pemiscot County,7,933,431,502
Missouri,Pemiscot County,8,895,397,498
Missouri,Pemiscot County,9,964,446,518
Missouri,Pemiscot County,10,931,431,500
Missouri,Pemiscot County,11,1037,492,545
Missouri,Pemiscot County,12,1124,543,581
Missouri,Pemiscot County,13,1101,499,602
Missouri,Pemiscot County,14,885,421,464
Missouri,Pemiscot County,15,702,316,386
Missouri,Pemiscot County,16,512,236,276
Missouri,Pemiscot County,17,304,121,183
Missouri,Pemiscot County,18,378,93,285
Missouri,Perry County,0,19150,9567,9583
Missouri,Perry County,1,1130,589,541
Missouri,Perry County,2,1167,576,591
Missouri,Perry County,3,1371,742,629
Missouri,Perry County,4,1206,662,544
Missouri,Perry County,5,1084,530,554
Missouri,Perry County,6,1202,612,590
Missouri,Perry County,7,1063,544,519
Missouri,Perry County,8,1105,572,533
Missouri,Perry County,9,1158,564,594
Missouri,Perry County,10,1197,596,601
Missouri,Perry County,11,1273,655,618
Missouri,Perry County,12,1425,738,687
Missouri,Perry County,13,1297,604,693
Missouri,Perry County,14,1171,586,585
Missouri,Perry County,15,781,379,402
Missouri,Perry County,16,620,281,339
Missouri,Perry County,17,420,186,234
Missouri,Perry County,18,480,151,329
Missouri,Pettis County,0,42542,21117,21425
Missouri,Pettis County,1,2830,1457,1373
Missouri,Pettis County,2,2867,1534,1333
Missouri,Pettis County,3,3026,1632,1394
Missouri,Pettis County,4,2784,1409,1375
Missouri,Pettis County,5,2521,1266,1255
Missouri,Pettis County,6,2905,1453,1452
Missouri,Pettis County,7,2767,1391,1376
Missouri,Pettis County,8,2720,1345,1375
Missouri,Pettis County,9,2327,1178,1149
Missouri,Pettis County,10,2375,1197,1178
Missouri,Pettis County,11,2529,1268,1261
Missouri,Pettis County,12,3019,1493,1526
Missouri,Pettis County,13,2749,1337,1412
Missouri,Pettis County,14,2233,1093,1140
Missouri,Pettis County,15,1674,792,882
Missouri,Pettis County,16,1223,510,713
Missouri,Pettis County,17,928,393,535
Missouri,Pettis County,18,1065,369,696
Missouri,Phelps County,0,44732,23354,21378
Missouri,Phelps County,1,2506,1316,1190
Missouri,Phelps County,2,2508,1265,1243
Missouri,Phelps County,3,2748,1425,1323
Missouri,Phelps County,4,3636,2187,1449
Missouri,Phelps County,5,5336,3484,1852
Missouri,Phelps County,6,2807,1508,1299
Missouri,Phelps County,7,2445,1260,1185
Missouri,Phelps County,8,2648,1309,1339
Missouri,Phelps County,9,2204,1116,1088
Missouri,Phelps County,10,2401,1237,1164
Missouri,Phelps County,11,2487,1190,1297
Missouri,Phelps County,12,2983,1438,1545
Missouri,Phelps County,13,2671,1288,1383
Missouri,Phelps County,14,2231,1061,1170
Missouri,Phelps County,15,1877,889,988
Missouri,Phelps County,16,1333,599,734
Missouri,Phelps County,17,952,412,540
Missouri,Phelps County,18,959,370,589
Missouri,Pike County,0,18504,10265,8239
Missouri,Pike County,1,1135,609,526
Missouri,Pike County,2,1148,571,577
Missouri,Pike County,3,1107,602,505
Missouri,Pike County,4,1013,537,476
Missouri,Pike County,5,1163,736,427
Missouri,Pike County,6,1363,853,510
Missouri,Pike County,7,1220,773,447
Missouri,Pike County,8,1193,703,490
Missouri,Pike County,9,1093,670,423
Missouri,Pike County,10,1192,726,466
Missouri,Pike County,11,1194,717,477
Missouri,Pike County,12,1273,670,603
Missouri,Pike County,13,1198,606,592
Missouri,Pike County,14,965,483,482
Missouri,Pike County,15,819,393,426
Missouri,Pike County,16,639,303,336
Missouri,Pike County,17,393,173,220
Missouri,Pike County,18,396,140,256
Missouri,Platte County,0,102985,50760,52225
Missouri,Platte County,1,6376,3229,3147
Missouri,Platte County,2,6961,3495,3466
Missouri,Platte County,3,6930,3524,3406
Missouri,Platte County,4,6561,3334,3227
Missouri,Platte County,5,5940,3016,2924
Missouri,Platte County,6,6976,3509,3467
Missouri,Platte County,7,6863,3432,3431
Missouri,Platte County,8,7597,3762,3835
Missouri,Platte County,9,6865,3475,3390
Missouri,Platte County,10,7034,3451,3583
Missouri,Platte County,11,6638,3292,3346
Missouri,Platte County,12,7059,3448,3611
Missouri,Platte County,13,6216,2957,3259
Missouri,Platte County,14,5159,2477,2682
Missouri,Platte County,15,3993,1924,2069
Missouri,Platte County,16,2615,1257,1358
Missouri,Platte County,17,1527,624,903
Missouri,Platte County,18,1675,554,1121
Missouri,Polk County,0,32201,15824,16377
Missouri,Polk County,1,1985,1017,968
Missouri,Polk County,2,1910,972,938
Missouri,Polk County,3,2112,1076,1036
Missouri,Polk County,4,2607,1305,1302
Missouri,Polk County,5,2914,1429,1485
Missouri,Polk County,6,1854,953,901
Missouri,Polk County,7,1649,831,818
Missouri,Polk County,8,1822,921,901
Missouri,Polk County,9,1645,821,824
Missouri,Polk County,10,1888,930,958
Missouri,Polk County,11,1903,911,992
Missouri,Polk County,12,2215,1140,1075
Missouri,Polk County,13,1889,874,1015
Missouri,Polk County,14,1754,854,900
Missouri,Polk County,15,1472,693,779
Missouri,Polk County,16,1121,538,583
Missouri,Polk County,17,705,290,415
Missouri,Polk County,18,756,269,487
Missouri,Pulaski County,0,52014,29387,22627
Missouri,Pulaski County,1,3435,1786,1649
Missouri,Pulaski County,2,3295,1696,1599
Missouri,Pulaski County,3,2942,1520,1422
Missouri,Pulaski County,4,5880,4136,1744
Missouri,Pulaski County,5,7330,5222,2108
Missouri,Pulaski County,6,4926,2907,2019
Missouri,Pulaski County,7,4340,2403,1937
Missouri,Pulaski County,8,3606,1963,1643
Missouri,Pulaski County,9,2648,1369,1279
Missouri,Pulaski County,10,2441,1178,1263
Missouri,Pulaski County,11,2272,1120,1152
Missouri,Pulaski County,12,2260,1057,1203
Missouri,Pulaski County,13,1965,986,979
Missouri,Pulaski County,14,1496,672,824
Missouri,Pulaski County,15,1245,600,645
Missouri,Pulaski County,16,843,353,490
Missouri,Pulaski County,17,574,249,325
Missouri,Pulaski County,18,516,170,346
Missouri,Putnam County,0,4757,2399,2358
Missouri,Putnam County,1,293,151,142
Missouri,Putnam County,2,278,151,127
Missouri,Putnam County,3,297,163,134
Missouri,Putnam County,4,291,139,152
Missouri,Putnam County,5,191,108,83
Missouri,Putnam County,6,264,133,131
Missouri,Putnam County,7,227,117,110
Missouri,Putnam County,8,248,125,123
Missouri,Putnam County,9,225,122,103
Missouri,Putnam County,10,266,126,140
Missouri,Putnam County,11,289,154,135
Missouri,Putnam County,12,367,197,170
Missouri,Putnam County,13,354,163,191
Missouri,Putnam County,14,334,174,160
Missouri,Putnam County,15,294,144,150
Missouri,Putnam County,16,219,100,119
Missouri,Putnam County,17,158,73,85
Missouri,Putnam County,18,162,59,103
Missouri,Ralls County,0,10212,5129,5083
Missouri,Ralls County,1,491,246,245
Missouri,Ralls County,2,571,305,266
Missouri,Ralls County,3,723,365,358
Missouri,Ralls County,4,570,309,261
Missouri,Ralls County,5,487,250,237
Missouri,Ralls County,6,501,252,249
Missouri,Ralls County,7,534,251,283
Missouri,Ralls County,8,554,282,272
Missouri,Ralls County,9,614,311,303
Missouri,Ralls County,10,647,335,312
Missouri,Ralls County,11,696,338,358
Missouri,Ralls County,12,834,432,402
Missouri,Ralls County,13,768,380,388
Missouri,Ralls County,14,772,398,374
Missouri,Ralls County,15,588,285,303
Missouri,Ralls County,16,427,206,221
Missouri,Ralls County,17,230,114,116
Missouri,Ralls County,18,205,70,135
Missouri,Randolph County,0,24763,12919,11844
Missouri,Randolph County,1,1446,763,683
Missouri,Randolph County,2,1458,773,685
Missouri,Randolph County,3,1520,799,721
Missouri,Randolph County,4,1509,760,749
Missouri,Randolph County,5,1690,930,760
Missouri,Randolph County,6,1778,1028,750
Missouri,Randolph County,7,1639,967,672
Missouri,Randolph County,8,1622,898,724
Missouri,Randolph County,9,1509,841,668
Missouri,Randolph County,10,1696,939,757
Missouri,Randolph County,11,1579,812,767
Missouri,Randolph County,12,1705,893,812
Missouri,Randolph County,13,1455,712,743
Missouri,Randolph County,14,1333,635,698
Missouri,Randolph County,15,1013,454,559
Missouri,Randolph County,16,766,351,415
Missouri,Randolph County,17,505,204,301
Missouri,Randolph County,18,540,160,380
Missouri,Ray County,0,22883,11430,11453
Missouri,Ray County,1,1261,662,599
Missouri,Ray County,2,1410,742,668
Missouri,Ray County,3,1510,737,773
Missouri,Ray County,4,1440,782,658
Missouri,Ray County,5,1251,657,594
Missouri,Ray County,6,1330,698,632
Missouri,Ray County,7,1232,627,605
Missouri,Ray County,8,1338,672,666
Missouri,Ray County,9,1296,650,646
Missouri,Ray County,10,1457,769,688
Missouri,Ray County,11,1609,759,850
Missouri,Ray County,12,1814,930,884
Missouri,Ray County,13,1691,831,860
Missouri,Ray County,14,1327,654,673
Missouri,Ray County,15,1061,484,577
Missouri,Ray County,16,874,393,481
Missouri,Ray County,17,486,225,261
Missouri,Ray County,18,496,158,338
Missouri,Reynolds County,0,6254,3221,3033
Missouri,Reynolds County,1,269,137,132
Missouri,Reynolds County,2,331,165,166
Missouri,Reynolds County,3,374,214,160
Missouri,Reynolds County,4,373,226,147
Missouri,Reynolds County,5,295,154,141
Missouri,Reynolds County,6,310,164,146
Missouri,Reynolds County,7,295,144,151
Missouri,Reynolds County,8,372,187,185
Missouri,Reynolds County,9,327,166,161
Missouri,Reynolds County,10,399,200,199
Missouri,Reynolds County,11,434,228,206
Missouri,Reynolds County,12,522,277,245
Missouri,Reynolds County,13,504,245,259
Missouri,Reynolds County,14,406,192,214
Missouri,Reynolds County,15,381,203,178
Missouri,Reynolds County,16,265,131,134
Missouri,Reynolds County,17,212,112,100
Missouri,Reynolds County,18,185,76,109
Missouri,Ripley County,0,13401,6656,6745
Missouri,Ripley County,1,812,423,389
Missouri,Ripley County,2,934,459,475
Missouri,Ripley County,3,802,423,379
Missouri,Ripley County,4,790,421,369
Missouri,Ripley County,5,595,307,288
Missouri,Ripley County,6,828,398,430
Missouri,Ripley County,7,716,358,358
Missouri,Ripley County,8,776,388,388
Missouri,Ripley County,9,775,398,377
Missouri,Ripley County,10,821,414,407
Missouri,Ripley County,11,824,409,415
Missouri,Ripley County,12,1030,520,510
Missouri,Ripley County,13,964,454,510
Missouri,Ripley County,14,853,426,427
Missouri,Ripley County,15,688,328,360
Missouri,Ripley County,16,535,241,294
Missouri,Ripley County,17,343,158,185
Missouri,Ripley County,18,315,131,184
Missouri,St. Charles County,0,399182,196224,202958
Missouri,St. Charles County,1,23483,11904,11579
Missouri,St. Charles County,2,25735,13241,12494
Missouri,St. Charles County,3,27203,13766,13437
Missouri,St. Charles County,4,25881,13312,12569
Missouri,St. Charles County,5,23883,12154,11729
Missouri,St. Charles County,6,24722,12693,12029
Missouri,St. Charles County,7,27012,13394,13618
Missouri,St. Charles County,8,28748,14411,14337
Missouri,St. Charles County,9,25048,12542,12506
Missouri,St. Charles County,10,25733,12680,13053
Missouri,St. Charles County,11,26635,12998,13637
Missouri,St. Charles County,12,29014,14120,14894
Missouri,St. Charles County,13,25306,12233,13073
Missouri,St. Charles County,14,20038,9268,10770
Missouri,St. Charles County,15,15684,7173,8511
Missouri,St. Charles County,16,10736,4745,5991
Missouri,St. Charles County,17,7123,3014,4109
Missouri,St. Charles County,18,7198,2576,4622
Missouri,St. Clair County,0,9395,4721,4674
Missouri,St. Clair County,1,569,310,259
Missouri,St. Clair County,2,435,217,218
Missouri,St. Clair County,3,525,259,266
Missouri,St. Clair County,4,511,260,251
Missouri,St. Clair County,5,395,199,196
Missouri,St. Clair County,6,466,252,214
Missouri,St. Clair County,7,457,225,232
Missouri,St. Clair County,8,441,226,215
Missouri,St. Clair County,9,424,209,215
Missouri,St. Clair County,10,565,289,276
Missouri,St. Clair County,11,566,265,301
Missouri,St. Clair County,12,767,418,349
Missouri,St. Clair County,13,736,379,357
Missouri,St. Clair County,14,715,372,343
Missouri,St. Clair County,15,627,299,328
Missouri,St. Clair County,16,505,249,256
Missouri,St. Clair County,17,358,174,184
Missouri,St. Clair County,18,333,119,214
Missouri,Ste. Genevieve County,0,17888,9067,8821
Missouri,Ste. Genevieve County,1,977,515,462
Missouri,Ste. Genevieve County,2,1061,544,517
Missouri,Ste. Genevieve County,3,1133,591,542
Missouri,Ste. Genevieve County,4,1070,544,526
Missouri,Ste. Genevieve County,5,939,479,460
Missouri,Ste. Genevieve County,6,1055,563,492
Missouri,Ste. Genevieve County,7,920,467,453
Missouri,Ste. Genevieve County,8,1044,527,517
Missouri,Ste. Genevieve County,9,953,501,452
Missouri,Ste. Genevieve County,10,1052,521,531
Missouri,Ste. Genevieve County,11,1229,618,611
Missouri,Ste. Genevieve County,12,1513,778,735
Missouri,Ste. Genevieve County,13,1457,741,716
Missouri,Ste. Genevieve County,14,1148,596,552
Missouri,Ste. Genevieve County,15,848,416,432
Missouri,Ste. Genevieve County,16,611,280,331
Missouri,Ste. Genevieve County,17,433,194,239
Missouri,Ste. Genevieve County,18,445,192,253
Missouri,St. Francois County,0,66692,35620,31072
Missouri,St. Francois County,1,3635,1852,1783
Missouri,St. Francois County,2,3757,1899,1858
Missouri,St. Francois County,3,4163,2109,2054
Missouri,St. Francois County,4,3878,2001,1877
Missouri,St. Francois County,5,4112,2507,1605
Missouri,St. Francois County,6,5054,3034,2020
Missouri,St. Francois County,7,4611,2703,1908
Missouri,St. Francois County,8,4757,2738,2019
Missouri,St. Francois County,9,4303,2458,1845
Missouri,St. Francois County,10,4527,2561,1966
Missouri,St. Francois County,11,4230,2325,1905
Missouri,St. Francois County,12,4622,2432,2190
Missouri,St. Francois County,13,4078,2082,1996
Missouri,St. Francois County,14,3446,1696,1750
Missouri,St. Francois County,15,2758,1253,1505
Missouri,St. Francois County,16,2090,955,1135
Missouri,St. Francois County,17,1426,609,817
Missouri,St. Francois County,18,1245,406,839
Missouri,St. Louis County,0,996945,472887,524058
Missouri,St. Louis County,1,58894,29912,28982
Missouri,St. Louis County,2,59727,30757,28970
Missouri,St. Louis County,3,62236,31515,30721
Missouri,St. Louis County,4,62595,31847,30748
Missouri,St. Louis County,5,60726,30383,30343
Missouri,St. Louis County,6,65446,32089,33357
Missouri,St. Louis County,7,62699,30111,32588
Missouri,St. Louis County,8,63310,30320,32990
Missouri,St. Louis County,9,56158,26413,29745
Missouri,St. Louis County,10,60086,28166,31920
Missouri,St. Louis County,11,63657,29788,33869
Missouri,St. Louis County,12,72280,33889,38391
Missouri,St. Louis County,13,68921,32106,36815
Missouri,St. Louis County,14,56736,25567,31169
Missouri,St. Louis County,15,43891,19290,24601
Missouri,St. Louis County,16,30989,13121,17868
Missouri,St. Louis County,17,21614,8609,13005
Missouri,St. Louis County,18,26980,9004,17976
Missouri,Saline County,0,22895,11420,11475
Missouri,Saline County,1,1294,656,638
Missouri,Saline County,2,1475,753,722
Missouri,Saline County,3,1441,737,704
Missouri,Saline County,4,1757,957,800
Missouri,Saline County,5,1675,922,753
Missouri,Saline County,6,1400,731,669
Missouri,Saline County,7,1306,653,653
Missouri,Saline County,8,1363,688,675
Missouri,Saline County,9,1279,636,643
Missouri,Saline County,10,1264,633,631
Missouri,Saline County,11,1350,689,661
Missouri,Saline County,12,1583,764,819
Missouri,Saline County,13,1526,758,768
Missouri,Saline County,14,1225,610,615
Missouri,Saline County,15,1040,502,538
Missouri,Saline County,16,786,327,459
Missouri,Saline County,17,535,229,306
Missouri,Saline County,18,596,175,421
Missouri,Schuyler County,0,4599,2284,2315
Missouri,Schuyler County,1,366,186,180
Missouri,Schuyler County,2,296,143,153
Missouri,Schuyler County,3,307,149,158
Missouri,Schuyler County,4,293,160,133
Missouri,Schuyler County,5,276,131,145
Missouri,Schuyler County,6,294,155,139
Missouri,Schuyler County,7,236,131,105
Missouri,Schuyler County,8,209,101,108
Missouri,Schuyler County,9,247,119,128
Missouri,Schuyler County,10,252,125,127
Missouri,Schuyler County,11,287,149,138
Missouri,Schuyler County,12,325,168,157
Missouri,Schuyler County,13,301,147,154
Missouri,Schuyler County,14,250,131,119
Missouri,Schuyler County,15,220,98,122
Missouri,Schuyler County,16,189,86,103
Missouri,Schuyler County,17,122,58,64
Missouri,Schuyler County,18,129,47,82
Missouri,Scotland County,0,4966,2457,2509
Missouri,Scotland County,1,439,228,211
Missouri,Scotland County,2,399,207,192
Missouri,Scotland County,3,398,185,213
Missouri,Scotland County,4,342,185,157
Missouri,Scotland County,5,301,153,148
Missouri,Scotland County,6,298,160,138
Missouri,Scotland County,7,256,138,118
Missouri,Scotland County,8,260,131,129
Missouri,Scotland County,9,266,133,133
Missouri,Scotland County,10,230,116,114
Missouri,Scotland County,11,286,137,149
Missouri,Scotland County,12,313,164,149
Missouri,Scotland County,13,279,118,161
Missouri,Scotland County,14,254,133,121
Missouri,Scotland County,15,212,105,107
Missouri,Scotland County,16,167,77,90
Missouri,Scotland County,17,134,49,85
Missouri,Scotland County,18,132,38,94
Missouri,Scott County,0,38458,18682,19776
Missouri,Scott County,1,2444,1289,1155
Missouri,Scott County,2,2650,1397,1253
Missouri,Scott County,3,2634,1341,1293
Missouri,Scott County,4,2286,1182,1104
Missouri,Scott County,5,2126,1090,1036
Missouri,Scott County,6,2664,1309,1355
Missouri,Scott County,7,2242,1079,1163
Missouri,Scott County,8,2320,1109,1211
Missouri,Scott County,9,2117,1038,1079
Missouri,Scott County,10,2396,1153,1243
Missouri,Scott County,11,2472,1210,1262
Missouri,Scott County,12,2706,1318,1388
Missouri,Scott County,13,2461,1139,1322
Missouri,Scott County,14,2208,1034,1174
Missouri,Scott County,15,1766,817,949
Missouri,Scott County,16,1294,547,747
Missouri,Scott County,17,867,354,513
Missouri,Scott County,18,805,276,529
Missouri,Shannon County,0,8189,4097,4092
Missouri,Shannon County,1,426,215,211
Missouri,Shannon County,2,486,241,245
Missouri,Shannon County,3,554,301,253
Missouri,Shannon County,4,456,233,223
Missouri,Shannon County,5,384,191,193
Missouri,Shannon County,6,459,238,221
Missouri,Shannon County,7,433,230,203
Missouri,Shannon County,8,405,206,199
Missouri,Shannon County,9,367,198,169
Missouri,Shannon County,10,485,247,238
Missouri,Shannon County,11,550,277,273
Missouri,Shannon County,12,714,358,356
Missouri,Shannon County,13,660,326,334
Missouri,Shannon County,14,531,264,267
Missouri,Shannon County,15,494,247,247
Missouri,Shannon County,16,370,180,190
Missouri,Shannon County,17,236,95,141
Missouri,Shannon County,18,179,50,129
Missouri,Shelby County,0,6050,3012,3038
Missouri,Shelby County,1,395,219,176
Missouri,Shelby County,2,382,186,196
Missouri,Shelby County,3,436,242,194
Missouri,Shelby County,4,371,193,178
Missouri,Shelby County,5,301,154,147
Missouri,Shelby County,6,294,126,168
Missouri,Shelby County,7,322,158,164
Missouri,Shelby County,8,400,205,195
Missouri,Shelby County,9,330,180,150
Missouri,Shelby County,10,285,142,143
Missouri,Shelby County,11,354,163,191
Missouri,Shelby County,12,462,263,199
Missouri,Shelby County,13,431,207,224
Missouri,Shelby County,14,395,202,193
Missouri,Shelby County,15,293,135,158
Missouri,Shelby County,16,234,103,131
Missouri,Shelby County,17,168,70,98
Missouri,Shelby County,18,197,64,133
Missouri,Stoddard County,0,29206,14415,14791
Missouri,Stoddard County,1,1652,904,748
Missouri,Stoddard County,2,1693,869,824
Missouri,Stoddard County,3,1873,948,925
Missouri,Stoddard County,4,1811,995,816
Missouri,Stoddard County,5,1578,824,754
Missouri,Stoddard County,6,1820,895,925
Missouri,Stoddard County,7,1655,834,821
Missouri,Stoddard County,8,1776,888,888
Missouri,Stoddard County,9,1735,866,869
Missouri,Stoddard County,10,1862,942,920
Missouri,Stoddard County,11,1843,914,929
Missouri,Stoddard County,12,2054,1029,1025
Missouri,Stoddard County,13,2007,929,1078
Missouri,Stoddard County,14,1707,799,908
Missouri,Stoddard County,15,1462,681,781
Missouri,Stoddard County,16,1101,505,596
Missouri,Stoddard County,17,764,319,445
Missouri,Stoddard County,18,813,274,539
Missouri,Stone County,0,31749,15553,16196
Missouri,Stone County,1,1213,613,600
Missouri,Stone County,2,1421,706,715
Missouri,Stone County,3,1538,801,737
Missouri,Stone County,4,1592,815,777
Missouri,Stone County,5,1301,692,609
Missouri,Stone County,6,1275,643,632
Missouri,Stone County,7,1250,609,641
Missouri,Stone County,8,1353,662,691
Missouri,Stone County,9,1481,696,785
Missouri,Stone County,10,1752,827,925
Missouri,Stone County,11,2015,982,1033
Missouri,Stone County,12,2659,1262,1397
Missouri,Stone County,13,3062,1508,1554
Missouri,Stone County,14,3195,1476,1719
Missouri,Stone County,15,2742,1362,1380
Missouri,Stone County,16,1953,970,983
Missouri,Stone County,17,1145,597,548
Missouri,Stone County,18,802,332,470
Missouri,Sullivan County,0,6221,3195,3026
Missouri,Sullivan County,1,410,220,190
Missouri,Sullivan County,2,382,202,180
Missouri,Sullivan County,3,372,204,168
Missouri,Sullivan County,4,382,215,167
Missouri,Sullivan County,5,354,171,183
Missouri,Sullivan County,6,334,183,151
Missouri,Sullivan County,7,291,152,139
Missouri,Sullivan County,8,340,179,161
Missouri,Sullivan County,9,364,181,183
Missouri,Sullivan County,10,436,227,209
Missouri,Sullivan County,11,431,217,214
Missouri,Sullivan County,12,475,256,219
Missouri,Sullivan County,13,391,216,175
Missouri,Sullivan County,14,393,188,205
Missouri,Sullivan County,15,318,158,160
Missouri,Sullivan County,16,230,101,129
Missouri,Sullivan County,17,172,84,88
Missouri,Sullivan County,18,146,41,105
Missouri,Taney County,0,55852,27022,28830
Missouri,Taney County,1,3189,1642,1547
Missouri,Taney County,2,3159,1686,1473
Missouri,Taney County,3,3382,1698,1684
Missouri,Taney County,4,3574,1791,1783
Missouri,Taney County,5,3805,1907,1898
Missouri,Taney County,6,3362,1706,1656
Missouri,Taney County,7,2982,1419,1563
Missouri,Taney County,8,3160,1535,1625
Missouri,Taney County,9,2954,1361,1593
Missouri,Taney County,10,3246,1589,1657
Missouri,Taney County,11,3383,1602,1781
Missouri,Taney County,12,3821,1854,1967
Missouri,Taney County,13,3727,1721,2006
Missouri,Taney County,14,3811,1752,2059
Missouri,Taney County,15,3168,1468,1700
Missouri,Taney County,16,2383,1110,1273
Missouri,Taney County,17,1514,703,811
Missouri,Taney County,18,1232,478,754
Missouri,Texas County,0,25571,13430,12141
Missouri,Texas County,1,1427,730,697
Missouri,Texas County,2,1470,742,728
Missouri,Texas County,3,1563,827,736
Missouri,Texas County,4,1486,787,699
Missouri,Texas County,5,1433,865,568
Missouri,Texas County,6,1511,891,620
Missouri,Texas County,7,1468,828,640
Missouri,Texas County,8,1530,858,672
Missouri,Texas County,9,1416,799,617
Missouri,Texas County,10,1480,796,684
Missouri,Texas County,11,1624,887,737
Missouri,Texas County,12,1974,1009,965
Missouri,Texas County,13,1798,927,871
Missouri,Texas County,14,1616,748,868
Missouri,Texas County,15,1334,639,695
Missouri,Texas County,16,1009,488,521
Missouri,Texas County,17,728,330,398
Missouri,Texas County,18,704,279,425
Missouri,Vernon County,0,20528,10037,10491
Missouri,Vernon County,1,1257,635,622
Missouri,Vernon County,2,1245,671,574
Missouri,Vernon County,3,1447,767,680
Missouri,Vernon County,4,1536,706,830
Missouri,Vernon County,5,1176,530,646
Missouri,Vernon County,6,1165,591,574
Missouri,Vernon County,7,1055,524,531
Missouri,Vernon County,8,1155,581,574
Missouri,Vernon County,9,1105,536,569
Missouri,Vernon County,10,1184,607,577
Missouri,Vernon County,11,1339,660,679
Missouri,Vernon County,12,1459,710,749
Missouri,Vernon County,13,1428,696,732
Missouri,Vernon County,14,1212,588,624
Missouri,Vernon County,15,992,467,525
Missouri,Vernon County,16,709,328,381
Missouri,Vernon County,17,483,208,275
Missouri,Vernon County,18,581,232,349
Missouri,Warren County,0,34711,17325,17386
Missouri,Warren County,1,2209,1142,1067
Missouri,Warren County,2,2237,1158,1079
Missouri,Warren County,3,2392,1190,1202
Missouri,Warren County,4,2135,1100,1035
Missouri,Warren County,5,1802,916,886
Missouri,Warren County,6,2127,1089,1038
Missouri,Warren County,7,2067,1068,999
Missouri,Warren County,8,1977,948,1029
Missouri,Warren County,9,1910,952,958
Missouri,Warren County,10,2058,1019,1039
Missouri,Warren County,11,2364,1168,1196
Missouri,Warren County,12,2832,1434,1398
Missouri,Warren County,13,2498,1254,1244
Missouri,Warren County,14,1903,918,985
Missouri,Warren County,15,1570,755,815
Missouri,Warren County,16,1265,606,659
Missouri,Warren County,17,719,354,365
Missouri,Warren County,18,646,254,392
Missouri,Washington County,0,24943,12838,12105
Missouri,Washington County,1,1451,735,716
Missouri,Washington County,2,1568,752,816
Missouri,Washington County,3,1666,828,838
Missouri,Washington County,4,1529,819,710
Missouri,Washington County,5,1314,712,602
Missouri,Washington County,6,1563,853,710
Missouri,Washington County,7,1483,805,678
Missouri,Washington County,8,1520,806,714
Missouri,Washington County,9,1527,797,730
Missouri,Washington County,10,1784,977,807
Missouri,Washington County,11,1766,926,840
Missouri,Washington County,12,1816,939,877
Missouri,Washington County,13,1795,929,866
Missouri,Washington County,14,1384,646,738
Missouri,Washington County,15,1102,530,572
Missouri,Washington County,16,799,394,405
Missouri,Washington County,17,480,223,257
Missouri,Washington County,18,396,167,229
Missouri,Wayne County,0,13122,6454,6668
Missouri,Wayne County,1,686,335,351
Missouri,Wayne County,2,791,395,396
Missouri,Wayne County,3,752,381,371
Missouri,Wayne County,4,701,352,349
Missouri,Wayne County,5,558,292,266
Missouri,Wayne County,6,672,314,358
Missouri,Wayne County,7,675,336,339
Missouri,Wayne County,8,675,361,314
Missouri,Wayne County,9,634,324,310
Missouri,Wayne County,10,779,373,406
Missouri,Wayne County,11,963,469,494
Missouri,Wayne County,12,1109,537,572
Missouri,Wayne County,13,1041,514,527
Missouri,Wayne County,14,912,428,484
Missouri,Wayne County,15,804,387,417
Missouri,Wayne County,16,657,330,327
Missouri,Wayne County,17,410,194,216
Missouri,Wayne County,18,303,132,171
Missouri,Webster County,0,39109,19965,19144
Missouri,Webster County,1,2974,1507,1467
Missouri,Webster County,2,2835,1519,1316
Missouri,Webster County,3,3063,1591,1472
Missouri,Webster County,4,2667,1401,1266
Missouri,Webster County,5,2093,1081,1012
Missouri,Webster County,6,2475,1334,1141
Missouri,Webster County,7,2343,1221,1122
Missouri,Webster County,8,2436,1264,1172
Missouri,Webster County,9,2290,1203,1087
Missouri,Webster County,10,2451,1233,1218
Missouri,Webster County,11,2497,1311,1186
Missouri,Webster County,12,2591,1284,1307
Missouri,Webster County,13,2380,1187,1193
Missouri,Webster County,14,1886,922,964
Missouri,Webster County,15,1584,800,784
Missouri,Webster County,16,1162,542,620
Missouri,Webster County,17,765,333,432
Missouri,Webster County,18,617,232,385
Missouri,Worth County,0,2040,984,1056
Missouri,Worth County,1,108,49,59
Missouri,Worth County,2,119,52,67
Missouri,Worth County,3,107,59,48
Missouri,Worth County,4,125,61,64
Missouri,Worth County,5,97,50,47
Missouri,Worth County,6,106,42,64
Missouri,Worth County,7,106,50,56
Missouri,Worth County,8,96,54,42
Missouri,Worth County,9,93,55,38
Missouri,Worth County,10,95,45,50
Missouri,Worth County,11,136,71,65
Missouri,Worth County,12,170,86,84
Missouri,Worth County,13,177,88,89
Missouri,Worth County,14,132,74,58
Missouri,Worth County,15,109,50,59
Missouri,Worth County,16,93,38,55
Missouri,Worth County,17,79,34,45
Missouri,Worth County,18,92,26,66
Missouri,Wright County,0,18378,9025,9353
Missouri,Wright County,1,1349,722,627
Missouri,Wright County,2,1181,619,562
Missouri,Wright County,3,1337,634,703
Missouri,Wright County,4,1230,622,608
Missouri,Wright County,5,923,476,447
Missouri,Wright County,6,1017,518,499
Missouri,Wright County,7,941,478,463
Missouri,Wright County,8,1046,503,543
Missouri,Wright County,9,921,453,468
Missouri,Wright County,10,1044,519,525
Missouri,Wright County,11,1154,584,570
Missouri,Wright County,12,1324,610,714
Missouri,Wright County,13,1281,648,633
Missouri,Wright County,14,1081,526,555
Missouri,Wright County,15,929,431,498
Missouri,Wright County,16,713,317,396
Missouri,Wright County,17,444,209,235
Missouri,Wright County,18,463,156,307
Missouri,St. Louis city,0,302838,146552,156286
Missouri,St. Louis city,1,18712,9471,9241
Missouri,St. Louis city,2,15986,8191,7795
Missouri,St. Louis city,3,14541,7344,7197
Missouri,St. Louis city,4,15392,7785,7607
Missouri,St. Louis city,5,20386,9894,10492
Missouri,St. Louis city,6,32883,16020,16863
Missouri,St. Louis city,7,28134,13833,14301
Missouri,St. Louis city,8,22469,11149,11320
Missouri,St. Louis city,9,17523,8539,8984
Missouri,St. Louis city,10,17203,8432,8771
Missouri,St. Louis city,11,18051,9027,9024
Missouri,St. Louis city,12,20204,9953,10251
Missouri,St. Louis city,13,19864,9348,10516
Missouri,St. Louis city,14,15107,7056,8051
Missouri,St. Louis city,15,10004,4476,5528
Missouri,St. Louis city,16,6462,2717,3745
Missouri,St. Louis city,17,4471,1646,2825
Missouri,St. Louis city,18,5446,1671,3775
Montana,Beaverhead County,0,9404,4834,4570
Montana,Beaverhead County,1,437,221,216
Montana,Beaverhead County,2,422,189,233
Montana,Beaverhead County,3,433,225,208
Montana,Beaverhead County,4,746,394,352
Montana,Beaverhead County,5,971,521,450
Montana,Beaverhead County,6,545,289,256
Montana,Beaverhead County,7,461,230,231
Montana,Beaverhead County,8,483,255,228
Montana,Beaverhead County,9,480,275,205
Montana,Beaverhead County,10,444,230,214
Montana,Beaverhead County,11,501,248,253
Montana,Beaverhead County,12,653,318,335
Montana,Beaverhead County,13,758,375,383
Montana,Beaverhead County,14,623,329,294
Montana,Beaverhead County,15,541,279,262
Montana,Beaverhead County,16,421,229,192
Montana,Beaverhead County,17,248,124,124
Montana,Beaverhead County,18,237,103,134
Montana,Big Horn County,0,13338,6641,6697
Montana,Big Horn County,1,1237,635,602
Montana,Big Horn County,2,1273,695,578
Montana,Big Horn County,3,1271,648,623
Montana,Big Horn County,4,1031,536,495
Montana,Big Horn County,5,788,377,411
Montana,Big Horn County,6,877,437,440
Montana,Big Horn County,7,863,446,417
Montana,Big Horn County,8,729,376,353
Montana,Big Horn County,9,662,315,347
Montana,Big Horn County,10,624,270,354
Montana,Big Horn County,11,744,364,380
Montana,Big Horn County,12,788,381,407
Montana,Big Horn County,13,744,354,390
Montana,Big Horn County,14,632,319,313
Montana,Big Horn County,15,454,203,251
Montana,Big Horn County,16,275,127,148
Montana,Big Horn County,17,201,94,107
Montana,Big Horn County,18,145,64,81
Montana,Blaine County,0,6807,3420,3387
Montana,Blaine County,1,562,287,275
Montana,Blaine County,2,574,302,272
Montana,Blaine County,3,566,284,282
Montana,Blaine County,4,507,275,232
Montana,Blaine County,5,387,185,202
Montana,Blaine County,6,442,233,209
Montana,Blaine County,7,416,214,202
Montana,Blaine County,8,398,199,199
Montana,Blaine County,9,357,191,166
Montana,Blaine County,10,329,166,163
Montana,Blaine County,11,385,197,188
Montana,Blaine County,12,462,232,230
Montana,Blaine County,13,373,194,179
Montana,Blaine County,14,336,159,177
Montana,Blaine County,15,259,112,147
Montana,Blaine County,16,190,83,107
Montana,Blaine County,17,120,57,63
Montana,Blaine County,18,144,50,94
Montana,Broadwater County,0,6085,3115,2970
Montana,Broadwater County,1,301,164,137
Montana,Broadwater County,2,321,163,158
Montana,Broadwater County,3,351,179,172
Montana,Broadwater County,4,350,166,184
Montana,Broadwater County,5,266,142,124
Montana,Broadwater County,6,290,150,140
Montana,Broadwater County,7,290,143,147
Montana,Broadwater County,8,328,164,164
Montana,Broadwater County,9,314,167,147
Montana,Broadwater County,10,376,193,183
Montana,Broadwater County,11,419,211,208
Montana,Broadwater County,12,517,231,286
Montana,Broadwater County,13,522,294,228
Montana,Broadwater County,14,508,272,236
Montana,Broadwater County,15,394,208,186
Montana,Broadwater County,16,256,140,116
Montana,Broadwater County,17,154,75,79
Montana,Broadwater County,18,128,53,75
Montana,Carbon County,0,10714,5419,5295
Montana,Carbon County,1,387,169,218
Montana,Carbon County,2,517,267,250
Montana,Carbon County,3,592,307,285
Montana,Carbon County,4,572,315,257
Montana,Carbon County,5,422,220,202
Montana,Carbon County,6,395,208,187
Montana,Carbon County,7,520,253,267
Montana,Carbon County,8,618,299,319
Montana,Carbon County,9,631,309,322
Montana,Carbon County,10,598,318,280
Montana,Carbon County,11,695,358,337
Montana,Carbon County,12,949,493,456
Montana,Carbon County,13,1056,519,537
Montana,Carbon County,14,951,463,488
Montana,Carbon County,15,755,395,360
Montana,Carbon County,16,453,251,202
Montana,Carbon County,17,295,137,158
Montana,Carbon County,18,308,138,170
Montana,Carter County,0,1238,615,623
Montana,Carter County,1,91,41,50
Montana,Carter County,2,76,40,36
Montana,Carter County,3,54,31,23
Montana,Carter County,4,50,28,22
Montana,Carter County,5,54,25,29
Montana,Carter County,6,67,34,33
Montana,Carter County,7,80,37,43
Montana,Carter County,8,63,38,25
Montana,Carter County,9,46,26,20
Montana,Carter County,10,40,21,19
Montana,Carter County,11,73,23,50
Montana,Carter County,12,107,56,51
Montana,Carter County,13,118,63,55
Montana,Carter County,14,98,53,45
Montana,Carter County,15,64,33,31
Montana,Carter County,16,59,32,27
Montana,Carter County,17,46,19,27
Montana,Carter County,18,52,15,37
Montana,Cascade County,0,81643,41285,40358
Montana,Cascade County,1,5436,2800,2636
Montana,Cascade County,2,5100,2660,2440
Montana,Cascade County,3,5012,2655,2357
Montana,Cascade County,4,4465,2371,2094
Montana,Cascade County,5,5846,3218,2628
Montana,Cascade County,6,6372,3430,2942
Montana,Cascade County,7,5390,2738,2652
Montana,Cascade County,8,4982,2614,2368
Montana,Cascade County,9,4082,2098,1984
Montana,Cascade County,10,4159,2100,2059
Montana,Cascade County,11,4628,2251,2377
Montana,Cascade County,12,5638,2791,2847
Montana,Cascade County,13,5373,2555,2818
Montana,Cascade County,14,4774,2267,2507
Montana,Cascade County,15,3728,1838,1890
Montana,Cascade County,16,2697,1240,1457
Montana,Cascade County,17,1963,882,1081
Montana,Cascade County,18,1998,777,1221
Montana,Chouteau County,0,5745,2872,2873
Montana,Chouteau County,1,291,149,142
Montana,Chouteau County,2,323,164,159
Montana,Chouteau County,3,459,216,243
Montana,Chouteau County,4,395,208,187
Montana,Chouteau County,5,285,157,128
Montana,Chouteau County,6,327,169,158
Montana,Chouteau County,7,343,168,175
Montana,Chouteau County,8,331,171,160
Montana,Chouteau County,9,323,163,160
Montana,Chouteau County,10,296,143,153
Montana,Chouteau County,11,286,146,140
Montana,Chouteau County,12,448,214,234
Montana,Chouteau County,13,467,238,229
Montana,Chouteau County,14,411,209,202
Montana,Chouteau County,15,283,140,143
Montana,Chouteau County,16,181,84,97
Montana,Chouteau County,17,149,71,78
Montana,Chouteau County,18,147,62,85
Montana,Custer County,0,11586,5806,5780
Montana,Custer County,1,692,351,341
Montana,Custer County,2,668,352,316
Montana,Custer County,3,629,323,306
Montana,Custer County,4,780,456,324
Montana,Custer County,5,636,327,309
Montana,Custer County,6,707,330,377
Montana,Custer County,7,704,356,348
Montana,Custer County,8,763,398,365
Montana,Custer County,9,594,308,286
Montana,Custer County,10,666,303,363
Montana,Custer County,11,694,361,333
Montana,Custer County,12,896,446,450
Montana,Custer County,13,844,438,406
Montana,Custer County,14,755,363,392
Montana,Custer County,15,520,256,264
Montana,Custer County,16,403,182,221
Montana,Custer County,17,283,115,168
Montana,Custer County,18,352,141,211
Montana,Daniels County,0,1747,901,846
Montana,Daniels County,1,90,44,46
Montana,Daniels County,2,117,63,54
Montana,Daniels County,3,100,51,49
Montana,Daniels County,4,90,52,38
Montana,Daniels County,5,65,34,31
Montana,Daniels County,6,87,47,40
Montana,Daniels County,7,100,56,44
Montana,Daniels County,8,94,51,43
Montana,Daniels County,9,83,46,37
Montana,Daniels County,10,81,37,44
Montana,Daniels County,11,89,52,37
Montana,Daniels County,12,125,65,60
Montana,Daniels County,13,163,83,80
Montana,Daniels County,14,132,72,60
Montana,Daniels County,15,98,49,49
Montana,Daniels County,16,68,34,34
Montana,Daniels County,17,71,31,40
Montana,Daniels County,18,94,34,60
Montana,Dawson County,0,8680,4472,4208
Montana,Dawson County,1,528,255,273
Montana,Dawson County,2,518,270,248
Montana,Dawson County,3,512,272,240
Montana,Dawson County,4,589,318,271
Montana,Dawson County,5,465,265,200
Montana,Dawson County,6,557,286,271
Montana,Dawson County,7,534,297,237
Montana,Dawson County,8,493,263,230
Montana,Dawson County,9,480,249,231
Montana,Dawson County,10,478,266,212
Montana,Dawson County,11,485,245,240
Montana,Dawson County,12,658,335,323
Montana,Dawson County,13,659,330,329
Montana,Dawson County,14,583,315,268
Montana,Dawson County,15,360,181,179
Montana,Dawson County,16,281,144,137
Montana,Dawson County,17,220,80,140
Montana,Dawson County,18,280,101,179
Montana,Deer Lodge County,0,9131,4878,4253
Montana,Deer Lodge County,1,332,172,160
Montana,Deer Lodge County,2,338,175,163
Montana,Deer Lodge County,3,334,158,176
Montana,Deer Lodge County,4,527,343,184
Montana,Deer Lodge County,5,522,327,195
Montana,Deer Lodge County,6,583,325,258
Montana,Deer Lodge County,7,491,285,206
Montana,Deer Lodge County,8,499,275,224
Montana,Deer Lodge County,9,539,305,234
Montana,Deer Lodge County,10,601,316,285
Montana,Deer Lodge County,11,622,354,268
Montana,Deer Lodge County,12,777,378,399
Montana,Deer Lodge County,13,783,381,402
Montana,Deer Lodge County,14,794,411,383
Montana,Deer Lodge County,15,531,280,251
Montana,Deer Lodge County,16,383,193,190
Montana,Deer Lodge County,17,258,117,141
Montana,Deer Lodge County,18,217,83,134
Montana,Fallon County,0,2920,1479,1441
Montana,Fallon County,1,217,112,105
Montana,Fallon County,2,219,119,100
Montana,Fallon County,3,231,109,122
Montana,Fallon County,4,182,89,93
Montana,Fallon County,5,119,58,61
Montana,Fallon County,6,183,95,88
Montana,Fallon County,7,177,104,73
Montana,Fallon County,8,174,89,85
Montana,Fallon County,9,161,83,78
Montana,Fallon County,10,164,85,79
Montana,Fallon County,11,163,84,79
Montana,Fallon County,12,194,95,99
Montana,Fallon County,13,242,128,114
Montana,Fallon County,14,161,78,83
Montana,Fallon County,15,102,58,44
Montana,Fallon County,16,93,45,48
Montana,Fallon County,17,65,29,36
Montana,Fallon County,18,73,19,54
Montana,Fergus County,0,11113,5698,5415
Montana,Fergus County,1,614,339,275
Montana,Fergus County,2,663,365,298
Montana,Fergus County,3,665,335,330
Montana,Fergus County,4,594,315,279
Montana,Fergus County,5,466,240,226
Montana,Fergus County,6,599,342,257
Montana,Fergus County,7,589,294,295
Montana,Fergus County,8,648,349,299
Montana,Fergus County,9,591,300,291
Montana,Fergus County,10,610,308,302
Montana,Fergus County,11,634,308,326
Montana,Fergus County,12,842,431,411
Montana,Fergus County,13,874,428,446
Montana,Fergus County,14,876,430,446
Montana,Fergus County,15,692,377,315
Montana,Fergus County,16,488,250,238
Montana,Fergus County,17,323,147,176
Montana,Fergus County,18,345,140,205
Montana,Flathead County,0,102106,50896,51210
Montana,Flathead County,1,5907,3008,2899
Montana,Flathead County,2,6314,3264,3050
Montana,Flathead County,3,6464,3434,3030
Montana,Flathead County,4,5676,2989,2687
Montana,Flathead County,5,4911,2551,2360
Montana,Flathead County,6,6254,3040,3214
Montana,Flathead County,7,6074,2993,3081
Montana,Flathead County,8,6732,3328,3404
Montana,Flathead County,9,6051,3088,2963
Montana,Flathead County,10,6021,3031,2990
Montana,Flathead County,11,6089,3011,3078
Montana,Flathead County,12,7458,3559,3899
Montana,Flathead County,13,8206,3905,4301
Montana,Flathead County,14,7273,3652,3621
Montana,Flathead County,15,5246,2631,2615
Montana,Flathead County,16,3409,1659,1750
Montana,Flathead County,17,2058,983,1075
Montana,Flathead County,18,1963,770,1193
Montana,Gallatin County,0,111876,58096,53780
Montana,Gallatin County,1,6467,3284,3183
Montana,Gallatin County,2,6329,3234,3095
Montana,Gallatin County,3,6229,3123,3106
Montana,Gallatin County,4,7474,3877,3597
Montana,Gallatin County,5,13651,7602,6049
Montana,Gallatin County,6,9968,5435,4533
Montana,Gallatin County,7,8358,4427,3931
Montana,Gallatin County,8,8231,4372,3859
Montana,Gallatin County,9,6836,3599,3237
Montana,Gallatin County,10,6151,3196,2955
Montana,Gallatin County,11,5594,2918,2676
Montana,Gallatin County,12,6274,3142,3132
Montana,Gallatin County,13,6168,3045,3123
Montana,Gallatin County,14,5410,2654,2756
Montana,Gallatin County,15,3686,1865,1821
Montana,Gallatin County,16,2273,1120,1153
Montana,Gallatin County,17,1300,636,664
Montana,Gallatin County,18,1477,567,910
Montana,Garfield County,0,1268,639,629
Montana,Garfield County,1,74,35,39
Montana,Garfield County,2,85,48,37
Montana,Garfield County,3,78,40,38
Montana,Garfield County,4,64,25,39
Montana,Garfield County,5,68,39,29
Montana,Garfield County,6,59,26,33
Montana,Garfield County,7,57,26,31
Montana,Garfield County,8,103,53,50
Montana,Garfield County,9,64,36,28
Montana,Garfield County,10,69,31,38
Montana,Garfield County,11,66,28,38
Montana,Garfield County,12,78,34,44
Montana,Garfield County,13,108,57,51
Montana,Garfield County,14,99,61,38
Montana,Garfield County,15,70,36,34
Montana,Garfield County,16,64,28,36
Montana,Garfield County,17,40,26,14
Montana,Garfield County,18,22,10,12
Montana,Glacier County,0,13747,6658,7089
Montana,Glacier County,1,1258,601,657
Montana,Glacier County,2,1215,579,636
Montana,Glacier County,3,1143,574,569
Montana,Glacier County,4,1048,538,510
Montana,Glacier County,5,865,451,414
Montana,Glacier County,6,956,466,490
Montana,Glacier County,7,893,426,467
Montana,Glacier County,8,859,417,442
Montana,Glacier County,9,722,390,332
Montana,Glacier County,10,674,333,341
Montana,Glacier County,11,748,328,420
Montana,Glacier County,12,934,451,483
Montana,Glacier County,13,779,355,424
Montana,Glacier County,14,583,280,303
Montana,Glacier County,15,407,197,210
Montana,Glacier County,16,298,129,169
Montana,Glacier County,17,160,62,98
Montana,Glacier County,18,205,81,124
Montana,Golden Valley County,0,826,413,413
Montana,Golden Valley County,1,43,24,19
Montana,Golden Valley County,2,46,27,19
Montana,Golden Valley County,3,52,23,29
Montana,Golden Valley County,4,56,28,28
Montana,Golden Valley County,5,31,12,19
Montana,Golden Valley County,6,36,23,13
Montana,Golden Valley County,7,32,9,23
Montana,Golden Valley County,8,52,26,26
Montana,Golden Valley County,9,37,17,20
Montana,Golden Valley County,10,35,17,18
Montana,Golden Valley County,11,51,21,30
Montana,Golden Valley County,12,66,36,30
Montana,Golden Valley County,13,65,35,30
Montana,Golden Valley County,14,87,41,46
Montana,Golden Valley County,15,47,28,19
Montana,Golden Valley County,16,38,16,22
Montana,Golden Valley County,17,26,12,14
Montana,Golden Valley County,18,26,18,8
Montana,Granite County,0,3378,1723,1655
Montana,Granite County,1,114,47,67
Montana,Granite County,2,141,69,72
Montana,Granite County,3,155,87,68
Montana,Granite County,4,158,66,92
Montana,Granite County,5,128,62,66
Montana,Granite County,6,149,76,73
Montana,Granite County,7,121,62,59
Montana,Granite County,8,180,87,93
Montana,Granite County,9,175,99,76
Montana,Granite County,10,154,83,71
Montana,Granite County,11,200,99,101
Montana,Granite County,12,328,166,162
Montana,Granite County,13,343,176,167
Montana,Granite County,14,345,178,167
Montana,Granite County,15,265,142,123
Montana,Granite County,16,216,119,97
Montana,Granite County,17,103,57,46
Montana,Granite County,18,103,48,55
Montana,Hill County,0,16347,8216,8131
Montana,Hill County,1,1472,705,767
Montana,Hill County,2,1243,650,593
Montana,Hill County,3,1153,594,559
Montana,Hill County,4,1130,575,555
Montana,Hill County,5,1055,545,510
Montana,Hill County,6,1189,622,567
Montana,Hill County,7,1041,530,511
Montana,Hill County,8,1016,535,481
Montana,Hill County,9,844,406,438
Montana,Hill County,10,807,418,389
Montana,Hill County,11,806,407,399
Montana,Hill County,12,1013,513,500
Montana,Hill County,13,1092,527,565
Montana,Hill County,14,853,461,392
Montana,Hill County,15,614,300,314
Montana,Hill County,16,405,183,222
Montana,Hill County,17,302,136,166
Montana,Hill County,18,312,109,203
Montana,Jefferson County,0,12097,6111,5986
Montana,Jefferson County,1,523,249,274
Montana,Jefferson County,2,679,352,327
Montana,Jefferson County,3,747,377,370
Montana,Jefferson County,4,773,403,370
Montana,Jefferson County,5,527,285,242
Montana,Jefferson County,6,470,230,240
Montana,Jefferson County,7,547,287,260
Montana,Jefferson County,8,702,356,346
Montana,Jefferson County,9,671,340,331
Montana,Jefferson County,10,805,404,401
Montana,Jefferson County,11,860,410,450
Montana,Jefferson County,12,1022,493,529
Montana,Jefferson County,13,1177,569,608
Montana,Jefferson County,14,1039,542,497
Montana,Jefferson County,15,743,399,344
Montana,Jefferson County,16,434,230,204
Montana,Jefferson County,17,216,115,101
Montana,Jefferson County,18,162,70,92
Montana,Judith Basin County,0,1952,1009,943
Montana,Judith Basin County,1,88,43,45
Montana,Judith Basin County,2,104,59,45
Montana,Judith Basin County,3,108,59,49
Montana,Judith Basin County,4,103,50,53
Montana,Judith Basin County,5,71,35,36
Montana,Judith Basin County,6,81,38,43
Montana,Judith Basin County,7,77,41,36
Montana,Judith Basin County,8,102,46,56
Montana,Judith Basin County,9,96,53,43
Montana,Judith Basin County,10,95,55,40
Montana,Judith Basin County,11,133,68,65
Montana,Judith Basin County,12,196,90,106
Montana,Judith Basin County,13,169,97,72
Montana,Judith Basin County,14,165,86,79
Montana,Judith Basin County,15,130,73,57
Montana,Judith Basin County,16,116,59,57
Montana,Judith Basin County,17,60,28,32
Montana,Judith Basin County,18,58,29,29
Montana,Lake County,0,30250,14927,15323
Montana,Lake County,1,1859,952,907
Montana,Lake County,2,1932,1010,922
Montana,Lake County,3,2093,1072,1021
Montana,Lake County,4,1896,972,924
Montana,Lake County,5,1542,811,731
Montana,Lake County,6,1637,840,797
Montana,Lake County,7,1559,760,799
Montana,Lake County,8,1647,837,810
Montana,Lake County,9,1561,715,846
Montana,Lake County,10,1516,718,798
Montana,Lake County,11,1730,805,925
Montana,Lake County,12,2183,1033,1150
Montana,Lake County,13,2413,1105,1308
Montana,Lake County,14,2197,1091,1106
Montana,Lake County,15,1805,922,883
Montana,Lake County,16,1264,651,613
Montana,Lake County,17,700,326,374
Montana,Lake County,18,716,307,409
Montana,Lewis and Clark County,0,68700,33960,34740
Montana,Lewis and Clark County,1,4013,2026,1987
Montana,Lewis and Clark County,2,4082,2089,1993
Montana,Lewis and Clark County,3,4162,2136,2026
Montana,Lewis and Clark County,4,4108,2138,1970
Montana,Lewis and Clark County,5,3812,1924,1888
Montana,Lewis and Clark County,6,4139,2053,2086
Montana,Lewis and Clark County,7,4424,2203,2221
Montana,Lewis and Clark County,8,4497,2319,2178
Montana,Lewis and Clark County,9,3880,1945,1935
Montana,Lewis and Clark County,10,3920,1914,2006
Montana,Lewis and Clark County,11,4378,2127,2251
Montana,Lewis and Clark County,12,5127,2467,2660
Montana,Lewis and Clark County,13,5255,2508,2747
Montana,Lewis and Clark County,14,4792,2372,2420
Montana,Lewis and Clark County,15,3237,1638,1599
Montana,Lewis and Clark County,16,2122,1034,1088
Montana,Lewis and Clark County,17,1288,580,708
Montana,Lewis and Clark County,18,1464,487,977
Montana,Liberty County,0,2430,1172,1258
Montana,Liberty County,1,147,79,68
Montana,Liberty County,2,138,63,75
Montana,Liberty County,3,151,82,69
Montana,Liberty County,4,129,71,58
Montana,Liberty County,5,131,67,64
Montana,Liberty County,6,158,70,88
Montana,Liberty County,7,143,68,75
Montana,Liberty County,8,150,71,79
Montana,Liberty County,9,124,59,65
Montana,Liberty County,10,119,55,64
Montana,Liberty County,11,151,63,88
Montana,Liberty County,12,175,89,86
Montana,Liberty County,13,214,104,110
Montana,Liberty County,14,133,66,67
Montana,Liberty County,15,94,50,44
Montana,Liberty County,16,100,46,54
Montana,Liberty County,17,66,25,41
Montana,Liberty County,18,107,44,63
Montana,Lincoln County,0,19794,9985,9809
Montana,Lincoln County,1,883,468,415
Montana,Lincoln County,2,950,491,459
Montana,Lincoln County,3,1077,580,497
Montana,Lincoln County,4,1045,508,537
Montana,Lincoln County,5,643,353,290
Montana,Lincoln County,6,801,412,389
Montana,Lincoln County,7,849,399,450
Montana,Lincoln County,8,948,475,473
Montana,Lincoln County,9,966,477,489
Montana,Lincoln County,10,1043,484,559
Montana,Lincoln County,11,1233,618,615
Montana,Lincoln County,12,1683,822,861
Montana,Lincoln County,13,2003,985,1018
Montana,Lincoln County,14,1946,1011,935
Montana,Lincoln County,15,1508,788,720
Montana,Lincoln County,16,1121,580,541
Montana,Lincoln County,17,601,314,287
Montana,Lincoln County,18,494,220,274
Montana,McCone County,0,1675,860,815
Montana,McCone County,1,94,58,36
Montana,McCone County,2,88,40,48
Montana,McCone County,3,104,45,59
Montana,McCone County,4,83,50,33
Montana,McCone County,5,92,48,44
Montana,McCone County,6,75,41,34
Montana,McCone County,7,91,48,43
Montana,McCone County,8,74,38,36
Montana,McCone County,9,85,42,43
Montana,McCone County,10,75,33,42
Montana,McCone County,11,84,39,45
Montana,McCone County,12,146,87,59
Montana,McCone County,13,146,74,72
Montana,McCone County,14,140,66,74
Montana,McCone County,15,94,51,43
Montana,McCone County,16,84,42,42
Montana,McCone County,17,69,35,34
Montana,McCone County,18,51,23,28
Montana,Madison County,0,8768,4692,4076
Montana,Madison County,1,348,156,192
Montana,Madison County,2,399,216,183
Montana,Madison County,3,379,193,186
Montana,Madison County,4,374,195,179
Montana,Madison County,5,378,225,153
Montana,Madison County,6,457,261,196
Montana,Madison County,7,554,375,179
Montana,Madison County,8,511,286,225
Montana,Madison County,9,400,212,188
Montana,Madison County,10,457,252,205
Montana,Madison County,11,512,265,247
Montana,Madison County,12,681,346,335
Montana,Madison County,13,844,414,430
Montana,Madison County,14,904,465,439
Montana,Madison County,15,704,398,306
Montana,Madison County,16,408,230,178
Montana,Madison County,17,217,107,110
Montana,Madison County,18,241,96,145
Montana,Meagher County,0,1866,943,923
Montana,Meagher County,1,98,51,47
Montana,Meagher County,2,112,59,53
Montana,Meagher County,3,96,57,39
Montana,Meagher County,4,84,45,39
Montana,Meagher County,5,71,37,34
Montana,Meagher County,6,78,38,40
Montana,Meagher County,7,81,36,45
Montana,Meagher County,8,88,45,43
Montana,Meagher County,9,89,45,44
Montana,Meagher County,10,99,49,50
Montana,Meagher County,11,90,46,44
Montana,Meagher County,12,135,64,71
Montana,Meagher County,13,172,78,94
Montana,Meagher County,14,202,112,90
Montana,Meagher County,15,157,88,69
Montana,Meagher County,16,89,40,49
Montana,Meagher County,17,54,32,22
Montana,Meagher County,18,71,21,50
Montana,Mineral County,0,4316,2200,2116
Montana,Mineral County,1,209,113,96
Montana,Mineral County,2,192,93,99
Montana,Mineral County,3,247,105,142
Montana,Mineral County,4,198,116,82
Montana,Mineral County,5,143,79,64
Montana,Mineral County,6,185,98,87
Montana,Mineral County,7,200,105,95
Montana,Mineral County,8,210,118,92
Montana,Mineral County,9,200,92,108
Montana,Mineral County,10,207,96,111
Montana,Mineral County,11,284,142,142
Montana,Mineral County,12,368,167,201
Montana,Mineral County,13,426,223,203
Montana,Mineral County,14,431,227,204
Montana,Mineral County,15,297,156,141
Montana,Mineral County,16,266,153,113
Montana,Mineral County,17,148,74,74
Montana,Mineral County,18,105,43,62
Montana,Missoula County,0,118791,59514,59277
Montana,Missoula County,1,6109,3083,3026
Montana,Missoula County,2,6126,3114,3012
Montana,Missoula County,3,6420,3317,3103
Montana,Missoula County,4,7555,3858,3697
Montana,Missoula County,5,12721,6417,6304
Montana,Missoula County,6,10059,5231,4828
Montana,Missoula County,7,8528,4328,4200
Montana,Missoula County,8,8401,4368,4033
Montana,Missoula County,9,6924,3514,3410
Montana,Missoula County,10,6468,3385,3083
Montana,Missoula County,11,6428,3149,3279
Montana,Missoula County,12,7149,3431,3718
Montana,Missoula County,13,7397,3464,3933
Montana,Missoula County,14,6629,3321,3308
Montana,Missoula County,15,4976,2456,2520
Montana,Missoula County,16,3165,1528,1637
Montana,Missoula County,17,1886,848,1038
Montana,Missoula County,18,1850,702,1148
Montana,Musselshell County,0,4651,2342,2309
Montana,Musselshell County,1,201,104,97
Montana,Musselshell County,2,233,128,105
Montana,Musselshell County,3,258,139,119
Montana,Musselshell County,4,267,135,132
Montana,Musselshell County,5,168,86,82
Montana,Musselshell County,6,217,90,127
Montana,Musselshell County,7,208,95,113
Montana,Musselshell County,8,218,115,103
Montana,Musselshell County,9,201,91,110
Montana,Musselshell County,10,300,170,130
Montana,Musselshell County,11,274,136,138
Montana,Musselshell County,12,410,201,209
Montana,Musselshell County,13,461,230,231
Montana,Musselshell County,14,475,235,240
Montana,Musselshell County,15,290,155,135
Montana,Musselshell County,16,220,113,107
Montana,Musselshell County,17,127,62,65
Montana,Musselshell County,18,123,57,66
Montana,Park County,0,16736,8436,8300
Montana,Park County,1,752,398,354
Montana,Park County,2,824,440,384
Montana,Park County,3,843,438,405
Montana,Park County,4,816,428,388
Montana,Park County,5,649,317,332
Montana,Park County,6,935,448,487
Montana,Park County,7,1038,576,462
Montana,Park County,8,1036,518,518
Montana,Park County,9,1046,527,519
Montana,Park County,10,1065,523,542
Montana,Park County,11,1065,560,505
Montana,Park County,12,1430,687,743
Montana,Park County,13,1438,708,730
Montana,Park County,14,1369,719,650
Montana,Park County,15,1020,528,492
Montana,Park County,16,636,299,337
Montana,Park County,17,371,143,228
Montana,Park County,18,403,179,224
Montana,Petroleum County,0,513,279,234
Montana,Petroleum County,1,19,14,5
Montana,Petroleum County,2,31,19,12
Montana,Petroleum County,3,25,14,11
Montana,Petroleum County,4,30,16,14
Montana,Petroleum County,5,29,13,16
Montana,Petroleum County,6,15,6,9
Montana,Petroleum County,7,26,16,10
Montana,Petroleum County,8,21,10,11
Montana,Petroleum County,9,22,12,10
Montana,Petroleum County,10,29,10,19
Montana,Petroleum County,11,40,22,18
Montana,Petroleum County,12,44,29,15
Montana,Petroleum County,13,54,28,26
Montana,Petroleum County,14,31,19,12
Montana,Petroleum County,15,23,13,10
Montana,Petroleum County,16,39,18,21
Montana,Petroleum County,17,19,10,9
Montana,Petroleum County,18,16,10,6
Montana,Phillips County,0,4074,2047,2027
Montana,Phillips County,1,289,147,142
Montana,Phillips County,2,263,151,112
Montana,Phillips County,3,273,131,142
Montana,Phillips County,4,223,116,107
Montana,Phillips County,5,199,109,90
Montana,Phillips County,6,200,113,87
Montana,Phillips County,7,166,73,93
Montana,Phillips County,8,228,113,115
Montana,Phillips County,9,199,112,87
Montana,Phillips County,10,169,83,86
Montana,Phillips County,11,262,134,128
Montana,Phillips County,12,372,171,201
Montana,Phillips County,13,321,158,163
Montana,Phillips County,14,284,153,131
Montana,Phillips County,15,201,98,103
Montana,Phillips County,16,159,67,92
Montana,Phillips County,17,128,62,66
Montana,Phillips County,18,138,56,82
Montana,Pondera County,0,5972,2975,2997
Montana,Pondera County,1,434,235,199
Montana,Pondera County,2,385,193,192
Montana,Pondera County,3,395,208,187
Montana,Pondera County,4,371,186,185
Montana,Pondera County,5,316,149,167
Montana,Pondera County,6,358,191,167
Montana,Pondera County,7,362,184,178
Montana,Pondera County,8,304,155,149
Montana,Pondera County,9,282,137,145
Montana,Pondera County,10,312,157,155
Montana,Pondera County,11,343,164,179
Montana,Pondera County,12,450,217,233
Montana,Pondera County,13,441,222,219
Montana,Pondera County,14,373,194,179
Montana,Pondera County,15,285,143,142
Montana,Pondera County,16,193,96,97
Montana,Pondera County,17,137,63,74
Montana,Pondera County,18,231,81,150
Montana,Powder River County,0,1716,850,866
Montana,Powder River County,1,76,37,39
Montana,Powder River County,2,66,31,35
Montana,Powder River County,3,90,46,44
Montana,Powder River County,4,92,46,46
Montana,Powder River County,5,86,43,43
Montana,Powder River County,6,94,51,43
Montana,Powder River County,7,65,33,32
Montana,Powder River County,8,85,45,40
Montana,Powder River County,9,80,36,44
Montana,Powder River County,10,78,34,44
Montana,Powder River County,11,113,61,52
Montana,Powder River County,12,161,77,84
Montana,Powder River County,13,164,75,89
Montana,Powder River County,14,157,93,64
Montana,Powder River County,15,112,63,49
Montana,Powder River County,16,71,30,41
Montana,Powder River County,17,56,25,31
Montana,Powder River County,18,70,24,46
Montana,Powell County,0,6968,4351,2617
Montana,Powell County,1,275,135,140
Montana,Powell County,2,281,145,136
Montana,Powell County,3,292,141,151
Montana,Powell County,4,291,150,141
Montana,Powell County,5,445,334,111
Montana,Powell County,6,476,374,102
Montana,Powell County,7,417,308,109
Montana,Powell County,8,502,346,156
Montana,Powell County,9,440,325,115
Montana,Powell County,10,509,361,148
Montana,Powell County,11,534,368,166
Montana,Powell County,12,565,339,226
Montana,Powell County,13,505,284,221
Montana,Powell County,14,498,276,222
Montana,Powell County,15,345,182,163
Montana,Powell County,16,271,149,122
Montana,Powell County,17,160,70,90
Montana,Powell County,18,162,64,98
Montana,Prairie County,0,1087,553,534
Montana,Prairie County,1,49,24,25
Montana,Prairie County,2,55,33,22
Montana,Prairie County,3,50,22,28
Montana,Prairie County,4,49,26,23
Montana,Prairie County,5,43,24,19
Montana,Prairie County,6,41,19,22
Montana,Prairie County,7,49,29,20
Montana,Prairie County,8,46,20,26
Montana,Prairie County,9,59,31,28
Montana,Prairie County,10,63,35,28
Montana,Prairie County,11,50,25,25
Montana,Prairie County,12,78,36,42
Montana,Prairie County,13,109,60,49
Montana,Prairie County,14,110,49,61
Montana,Prairie County,15,100,51,49
Montana,Prairie County,16,50,28,22
Montana,Prairie County,17,32,15,17
Montana,Prairie County,18,54,26,28
Montana,Ravalli County,0,43172,21410,21762
Montana,Ravalli County,1,2070,1073,997
Montana,Ravalli County,2,2112,1070,1042
Montana,Ravalli County,3,2478,1308,1170
Montana,Ravalli County,4,2462,1290,1172
Montana,Ravalli County,5,1877,1032,845
Montana,Ravalli County,6,1944,983,961
Montana,Ravalli County,7,2059,1046,1013
Montana,Ravalli County,8,2381,1184,1197
Montana,Ravalli County,9,2230,1103,1127
Montana,Ravalli County,10,2535,1194,1341
Montana,Ravalli County,11,2723,1376,1347
Montana,Ravalli County,12,3358,1593,1765
Montana,Ravalli County,13,3805,1783,2022
Montana,Ravalli County,14,3700,1773,1927
Montana,Ravalli County,15,3096,1551,1545
Montana,Ravalli County,16,2046,1013,1033
Montana,Ravalli County,17,1269,621,648
Montana,Ravalli County,18,1027,417,610
Montana,Richland County,0,10913,5694,5219
Montana,Richland County,1,737,390,347
Montana,Richland County,2,795,389,406
Montana,Richland County,3,794,410,384
Montana,Richland County,4,662,344,318
Montana,Richland County,5,605,344,261
Montana,Richland County,6,752,407,345
Montana,Richland County,7,719,397,322
Montana,Richland County,8,712,359,353
Montana,Richland County,9,639,332,307
Montana,Richland County,10,634,331,303
Montana,Richland County,11,664,336,328
Montana,Richland County,12,793,431,362
Montana,Richland County,13,775,415,360
Montana,Richland County,14,548,295,253
Montana,Richland County,15,434,215,219
Montana,Richland County,16,277,129,148
Montana,Richland County,17,184,93,91
Montana,Richland County,18,189,77,112
Montana,Roosevelt County,0,11059,5528,5531
Montana,Roosevelt County,1,1132,596,536
Montana,Roosevelt County,2,1061,579,482
Montana,Roosevelt County,3,976,481,495
Montana,Roosevelt County,4,829,406,423
Montana,Roosevelt County,5,644,342,302
Montana,Roosevelt County,6,788,400,388
Montana,Roosevelt County,7,740,384,356
Montana,Roosevelt County,8,664,324,340
Montana,Roosevelt County,9,547,284,263
Montana,Roosevelt County,10,524,246,278
Montana,Roosevelt County,11,546,286,260
Montana,Roosevelt County,12,690,332,358
Montana,Roosevelt County,13,652,284,368
Montana,Roosevelt County,14,478,249,229
Montana,Roosevelt County,15,287,132,155
Montana,Roosevelt County,16,197,93,104
Montana,Roosevelt County,17,153,70,83
Montana,Roosevelt County,18,151,40,111
Montana,Rosebud County,0,9063,4564,4499
Montana,Rosebud County,1,761,410,351
Montana,Rosebud County,2,713,360,353
Montana,Rosebud County,3,731,382,349
Montana,Rosebud County,4,651,315,336
Montana,Rosebud County,5,516,265,251
Montana,Rosebud County,6,553,281,272
Montana,Rosebud County,7,517,255,262
Montana,Rosebud County,8,454,220,234
Montana,Rosebud County,9,453,235,218
Montana,Rosebud County,10,513,274,239
Montana,Rosebud County,11,509,243,266
Montana,Rosebud County,12,627,311,316
Montana,Rosebud County,13,634,318,316
Montana,Rosebud County,14,521,243,278
Montana,Rosebud County,15,388,209,179
Montana,Rosebud County,16,217,108,109
Montana,Rosebud County,17,166,76,90
Montana,Rosebud County,18,139,59,80
Montana,Sanders County,0,11844,6070,5774
Montana,Sanders County,1,564,300,264
Montana,Sanders County,2,538,276,262
Montana,Sanders County,3,586,329,257
Montana,Sanders County,4,613,317,296
Montana,Sanders County,5,411,240,171
Montana,Sanders County,6,439,216,223
Montana,Sanders County,7,488,238,250
Montana,Sanders County,8,506,258,248
Montana,Sanders County,9,541,268,273
Montana,Sanders County,10,604,330,274
Montana,Sanders County,11,640,308,332
Montana,Sanders County,12,986,489,497
Montana,Sanders County,13,1227,567,660
Montana,Sanders County,14,1299,663,636
Montana,Sanders County,15,984,546,438
Montana,Sanders County,16,707,379,328
Montana,Sanders County,17,388,204,184
Montana,Sanders County,18,323,142,181
Montana,Sheridan County,0,3424,1735,1689
Montana,Sheridan County,1,178,101,77
Montana,Sheridan County,2,212,127,85
Montana,Sheridan County,3,205,94,111
Montana,Sheridan County,4,159,89,70
Montana,Sheridan County,5,163,81,82
Montana,Sheridan County,6,158,87,71
Montana,Sheridan County,7,179,90,89
Montana,Sheridan County,8,270,122,148
Montana,Sheridan County,9,179,80,99
Montana,Sheridan County,10,163,73,90
Montana,Sheridan County,11,202,90,112
Montana,Sheridan County,12,259,149,110
Montana,Sheridan County,13,323,178,145
Montana,Sheridan County,14,257,141,116
Montana,Sheridan County,15,151,67,84
Montana,Sheridan County,16,131,62,69
Montana,Sheridan County,17,114,54,60
Montana,Sheridan County,18,121,50,71
Montana,Silver Bow County,0,34993,17567,17426
Montana,Silver Bow County,1,2017,1042,975
Montana,Silver Bow County,2,1975,999,976
Montana,Silver Bow County,3,1955,1016,939
Montana,Silver Bow County,4,2034,1053,981
Montana,Silver Bow County,5,3140,1547,1593
Montana,Silver Bow County,6,2350,1275,1075
Montana,Silver Bow County,7,1953,1024,929
Montana,Silver Bow County,8,2072,1105,967
Montana,Silver Bow County,9,1792,944,848
Montana,Silver Bow County,10,1873,923,950
Montana,Silver Bow County,11,2092,1060,1032
Montana,Silver Bow County,12,2519,1245,1274
Montana,Silver Bow County,13,2554,1255,1299
Montana,Silver Bow County,14,2208,1062,1146
Montana,Silver Bow County,15,1569,776,793
Montana,Silver Bow County,16,1258,600,658
Montana,Silver Bow County,17,785,361,424
Montana,Silver Bow County,18,847,280,567
Montana,Stillwater County,0,9534,4882,4652
Montana,Stillwater County,1,428,225,203
Montana,Stillwater County,2,529,291,238
Montana,Stillwater County,3,667,352,315
Montana,Stillwater County,4,638,343,295
Montana,Stillwater County,5,405,200,205
Montana,Stillwater County,6,396,215,181
Montana,Stillwater County,7,407,204,203
Montana,Stillwater County,8,510,235,275
Montana,Stillwater County,9,555,287,268
Montana,Stillwater County,10,578,301,277
Montana,Stillwater County,11,605,306,299
Montana,Stillwater County,12,798,395,403
Montana,Stillwater County,13,858,445,413
Montana,Stillwater County,14,800,405,395
Montana,Stillwater County,15,570,298,272
Montana,Stillwater County,16,393,195,198
Montana,Stillwater County,17,221,122,99
Montana,Stillwater County,18,176,63,113
Montana,Sweet Grass County,0,3710,1895,1815
Montana,Sweet Grass County,1,170,93,77
Montana,Sweet Grass County,2,183,88,95
Montana,Sweet Grass County,3,249,128,121
Montana,Sweet Grass County,4,221,121,100
Montana,Sweet Grass County,5,203,117,86
Montana,Sweet Grass County,6,154,80,74
Montana,Sweet Grass County,7,167,88,79
Montana,Sweet Grass County,8,171,83,88
Montana,Sweet Grass County,9,195,104,91
Montana,Sweet Grass County,10,212,107,105
Montana,Sweet Grass County,11,230,110,120
Montana,Sweet Grass County,12,259,129,130
Montana,Sweet Grass County,13,310,139,171
Montana,Sweet Grass County,14,289,170,119
Montana,Sweet Grass County,15,254,115,139
Montana,Sweet Grass County,16,179,101,78
Montana,Sweet Grass County,17,120,64,56
Montana,Sweet Grass County,18,144,58,86
Montana,Teton County,0,6162,3032,3130
Montana,Teton County,1,425,209,216
Montana,Teton County,2,409,197,212
Montana,Teton County,3,416,210,206
Montana,Teton County,4,377,200,177
Montana,Teton County,5,300,156,144
Montana,Teton County,6,294,157,137
Montana,Teton County,7,318,150,168
Montana,Teton County,8,347,161,186
Montana,Teton County,9,289,142,147
Montana,Teton County,10,320,158,162
Montana,Teton County,11,379,186,193
Montana,Teton County,12,468,230,238
Montana,Teton County,13,422,208,214
Montana,Teton County,14,398,207,191
Montana,Teton County,15,326,162,164
Montana,Teton County,16,252,120,132
Montana,Teton County,17,206,98,108
Montana,Teton County,18,216,81,135
Montana,Toole County,0,4853,2711,2142
Montana,Toole County,1,319,160,159
Montana,Toole County,2,264,148,116
Montana,Toole County,3,263,124,139
Montana,Toole County,4,234,126,108
Montana,Toole County,5,272,177,95
Montana,Toole County,6,328,211,117
Montana,Toole County,7,312,211,101
Montana,Toole County,8,329,208,121
Montana,Toole County,9,304,182,122
Montana,Toole County,10,266,147,119
Montana,Toole County,11,297,173,124
Montana,Toole County,12,418,223,195
Montana,Toole County,13,351,197,154
Montana,Toole County,14,300,154,146
Montana,Toole County,15,200,112,88
Montana,Toole County,16,145,65,80
Montana,Toole County,17,96,37,59
Montana,Toole County,18,155,56,99
Montana,Treasure County,0,679,340,339
Montana,Treasure County,1,55,28,27
Montana,Treasure County,2,41,19,22
Montana,Treasure County,3,25,12,13
Montana,Treasure County,4,29,13,16
Montana,Treasure County,5,26,15,11
Montana,Treasure County,6,28,18,10
Montana,Treasure County,7,38,19,19
Montana,Treasure County,8,38,21,17
Montana,Treasure County,9,22,8,14
Montana,Treasure County,10,17,6,11
Montana,Treasure County,11,40,21,19
Montana,Treasure County,12,54,30,24
Montana,Treasure County,13,72,36,36
Montana,Treasure County,14,53,26,27
Montana,Treasure County,15,55,30,25
Montana,Treasure County,16,33,18,15
Montana,Treasure County,17,30,9,21
Montana,Treasure County,18,23,11,12
Montana,Valley County,0,7437,3727,3710
Montana,Valley County,1,437,223,214
Montana,Valley County,2,459,229,230
Montana,Valley County,3,493,246,247
Montana,Valley County,4,457,251,206
Montana,Valley County,5,335,171,164
Montana,Valley County,6,401,199,202
Montana,Valley County,7,382,188,194
Montana,Valley County,8,405,213,192
Montana,Valley County,9,391,207,184
Montana,Valley County,10,373,187,186
Montana,Valley County,11,428,217,211
Montana,Valley County,12,571,276,295
Montana,Valley County,13,567,306,261
Montana,Valley County,14,562,294,268
Montana,Valley County,15,325,164,161
Montana,Valley County,16,316,142,174
Montana,Valley County,17,254,109,145
Montana,Valley County,18,281,105,176
Montana,Wheatland County,0,2236,1151,1085
Montana,Wheatland County,1,140,74,66
Montana,Wheatland County,2,157,78,79
Montana,Wheatland County,3,151,82,69
Montana,Wheatland County,4,200,131,69
Montana,Wheatland County,5,118,65,53
Montana,Wheatland County,6,92,43,49
Montana,Wheatland County,7,97,47,50
Montana,Wheatland County,8,90,35,55
Montana,Wheatland County,9,116,62,54
Montana,Wheatland County,10,134,76,58
Montana,Wheatland County,11,90,57,33
Montana,Wheatland County,12,129,58,71
Montana,Wheatland County,13,188,95,93
Montana,Wheatland County,14,171,83,88
Montana,Wheatland County,15,130,69,61
Montana,Wheatland County,16,101,46,55
Montana,Wheatland County,17,53,21,32
Montana,Wheatland County,18,79,29,50
Montana,Wibaux County,0,1034,535,499
Montana,Wibaux County,1,64,32,32
Montana,Wibaux County,2,65,37,28
Montana,Wibaux County,3,55,30,25
Montana,Wibaux County,4,62,31,31
Montana,Wibaux County,5,50,25,25
Montana,Wibaux County,6,40,23,17
Montana,Wibaux County,7,48,20,28
Montana,Wibaux County,8,69,40,29
Montana,Wibaux County,9,49,26,23
Montana,Wibaux County,10,45,25,20
Montana,Wibaux County,11,71,35,36
Montana,Wibaux County,12,81,50,31
Montana,Wibaux County,13,84,45,39
Montana,Wibaux County,14,85,38,47
Montana,Wibaux County,15,51,26,25
Montana,Wibaux County,16,43,20,23
Montana,Wibaux County,17,39,19,20
Montana,Wibaux County,18,33,13,20
Montana,Yellowstone County,0,160137,78729,81408
Montana,Yellowstone County,1,10023,5188,4835
Montana,Yellowstone County,2,10571,5367,5204
Montana,Yellowstone County,3,10944,5530,5414
Montana,Yellowstone County,4,9424,4733,4691
Montana,Yellowstone County,5,9381,4735,4646
Montana,Yellowstone County,6,11285,5610,5675
Montana,Yellowstone County,7,11001,5516,5485
Montana,Yellowstone County,8,10830,5509,5321
Montana,Yellowstone County,9,9303,4581,4722
Montana,Yellowstone County,10,9389,4733,4656
Montana,Yellowstone County,11,9340,4582,4758
Montana,Yellowstone County,12,10933,5286,5647
Montana,Yellowstone County,13,10596,5123,5473
Montana,Yellowstone County,14,8894,4267,4627
Montana,Yellowstone County,15,6804,3198,3606
Montana,Yellowstone County,16,4624,2185,2439
Montana,Yellowstone County,17,3148,1327,1821
Montana,Yellowstone County,18,3647,1259,2388
Nebraska,Adams County,0,31511,15706,15805
Nebraska,Adams County,1,2085,1016,1069
Nebraska,Adams County,2,2035,1013,1022
Nebraska,Adams County,3,2069,1046,1023
Nebraska,Adams County,4,2378,1253,1125
Nebraska,Adams County,5,2351,1285,1066
Nebraska,Adams County,6,1947,986,961
Nebraska,Adams County,7,1773,923,850
Nebraska,Adams County,8,1725,904,821
Nebraska,Adams County,9,1702,832,870
Nebraska,Adams County,10,1658,843,815
Nebraska,Adams County,11,1800,898,902
Nebraska,Adams County,12,2164,1106,1058
Nebraska,Adams County,13,2088,1039,1049
Nebraska,Adams County,14,1845,905,940
Nebraska,Adams County,15,1363,622,741
Nebraska,Adams County,16,1003,462,541
Nebraska,Adams County,17,665,262,403
Nebraska,Adams County,18,860,311,549
Nebraska,Antelope County,0,6336,3184,3152
Nebraska,Antelope County,1,440,230,210
Nebraska,Antelope County,2,416,220,196
Nebraska,Antelope County,3,417,209,208
Nebraska,Antelope County,4,371,190,181
Nebraska,Antelope County,5,319,173,146
Nebraska,Antelope County,6,287,153,134
Nebraska,Antelope County,7,321,159,162
Nebraska,Antelope County,8,337,186,151
Nebraska,Antelope County,9,305,154,151
Nebraska,Antelope County,10,287,146,141
Nebraska,Antelope County,11,346,167,179
Nebraska,Antelope County,12,517,264,253
Nebraska,Antelope County,13,480,245,235
Nebraska,Antelope County,14,427,213,214
Nebraska,Antelope County,15,340,175,165
Nebraska,Antelope County,16,273,125,148
Nebraska,Antelope County,17,226,98,128
Nebraska,Antelope County,18,227,77,150
Nebraska,Arthur County,0,465,230,235
Nebraska,Arthur County,1,24,14,10
Nebraska,Arthur County,2,37,23,14
Nebraska,Arthur County,3,35,13,22
Nebraska,Arthur County,4,35,18,17
Nebraska,Arthur County,5,30,9,21
Nebraska,Arthur County,6,22,16,6
Nebraska,Arthur County,7,29,16,13
Nebraska,Arthur County,8,22,7,15
Nebraska,Arthur County,9,32,17,15
Nebraska,Arthur County,10,22,12,10
Nebraska,Arthur County,11,23,11,12
Nebraska,Arthur County,12,23,13,10
Nebraska,Arthur County,13,29,13,16
Nebraska,Arthur County,14,34,16,18
Nebraska,Arthur County,15,20,9,11
Nebraska,Arthur County,16,21,10,11
Nebraska,Arthur County,17,20,9,11
Nebraska,Arthur County,18,7,4,3
Nebraska,Banner County,0,730,350,380
Nebraska,Banner County,1,49,25,24
Nebraska,Banner County,2,51,23,28
Nebraska,Banner County,3,43,20,23
Nebraska,Banner County,4,39,10,29
Nebraska,Banner County,5,38,19,19
Nebraska,Banner County,6,41,19,22
Nebraska,Banner County,7,29,15,14
Nebraska,Banner County,8,50,25,25
Nebraska,Banner County,9,24,13,11
Nebraska,Banner County,10,25,9,16
Nebraska,Banner County,11,41,17,24
Nebraska,Banner County,12,60,29,31
Nebraska,Banner County,13,66,35,31
Nebraska,Banner County,14,63,37,26
Nebraska,Banner County,15,51,25,26
Nebraska,Banner County,16,25,12,13
Nebraska,Banner County,17,18,10,8
Nebraska,Banner County,18,17,7,10
Nebraska,Blaine County,0,476,240,236
Nebraska,Blaine County,1,26,11,15
Nebraska,Blaine County,2,29,22,7
Nebraska,Blaine County,3,25,14,11
Nebraska,Blaine County,4,22,9,13
Nebraska,Blaine County,5,27,15,12
Nebraska,Blaine County,6,36,16,20
Nebraska,Blaine County,7,16,10,6
Nebraska,Blaine County,8,21,11,10
Nebraska,Blaine County,9,15,8,7
Nebraska,Blaine County,10,24,8,16
Nebraska,Blaine County,11,33,16,17
Nebraska,Blaine County,12,45,21,24
Nebraska,Blaine County,13,36,18,18
Nebraska,Blaine County,14,43,19,24
Nebraska,Blaine County,15,21,17,4
Nebraska,Blaine County,16,28,11,17
Nebraska,Blaine County,17,15,6,9
Nebraska,Blaine County,18,14,8,6
Nebraska,Boone County,0,5239,2623,2616
Nebraska,Boone County,1,327,161,166
Nebraska,Boone County,2,347,168,179
Nebraska,Boone County,3,343,182,161
Nebraska,Boone County,4,295,141,154
Nebraska,Boone County,5,287,166,121
Nebraska,Boone County,6,262,131,131
Nebraska,Boone County,7,259,138,121
Nebraska,Boone County,8,280,153,127
Nebraska,Boone County,9,238,127,111
Nebraska,Boone County,10,240,119,121
Nebraska,Boone County,11,311,148,163
Nebraska,Boone County,12,422,221,201
Nebraska,Boone County,13,432,237,195
Nebraska,Boone County,14,316,157,159
Nebraska,Boone County,15,249,118,131
Nebraska,Boone County,16,207,107,100
Nebraska,Boone County,17,187,79,108
Nebraska,Boone County,18,237,70,167
Nebraska,Box Butte County,0,10772,5356,5416
Nebraska,Box Butte County,1,727,349,378
Nebraska,Box Butte County,2,797,390,407
Nebraska,Box Butte County,3,731,375,356
Nebraska,Box Butte County,4,685,364,321
Nebraska,Box Butte County,5,550,286,264
Nebraska,Box Butte County,6,624,301,323
Nebraska,Box Butte County,7,608,301,307
Nebraska,Box Butte County,8,618,310,308
Nebraska,Box Butte County,9,644,348,296
Nebraska,Box Butte County,10,564,266,298
Nebraska,Box Butte County,11,524,260,264
Nebraska,Box Butte County,12,758,372,386
Nebraska,Box Butte County,13,900,486,414
Nebraska,Box Butte County,14,705,361,344
Nebraska,Box Butte County,15,510,260,250
Nebraska,Box Butte County,16,314,143,171
Nebraska,Box Butte County,17,205,71,134
Nebraska,Box Butte County,18,308,113,195
Nebraska,Boyd County,0,1955,981,974
Nebraska,Boyd County,1,88,42,46
Nebraska,Boyd County,2,107,53,54
Nebraska,Boyd County,3,100,48,52
Nebraska,Boyd County,4,114,60,54
Nebraska,Boyd County,5,105,51,54
Nebraska,Boyd County,6,73,42,31
Nebraska,Boyd County,7,77,39,38
Nebraska,Boyd County,8,85,45,40
Nebraska,Boyd County,9,84,44,40
Nebraska,Boyd County,10,89,50,39
Nebraska,Boyd County,11,107,56,51
Nebraska,Boyd County,12,176,88,88
Nebraska,Boyd County,13,152,81,71
Nebraska,Boyd County,14,177,92,85
Nebraska,Boyd County,15,131,72,59
Nebraska,Boyd County,16,110,50,60
Nebraska,Boyd County,17,69,30,39
Nebraska,Boyd County,18,111,38,73
Nebraska,Brown County,0,2973,1450,1523
Nebraska,Brown County,1,131,74,57
Nebraska,Brown County,2,181,96,85
Nebraska,Brown County,3,189,89,100
Nebraska,Brown County,4,195,89,106
Nebraska,Brown County,5,144,75,69
Nebraska,Brown County,6,125,62,63
Nebraska,Brown County,7,133,69,64
Nebraska,Brown County,8,125,64,61
Nebraska,Brown County,9,165,80,85
Nebraska,Brown County,10,165,79,86
Nebraska,Brown County,11,167,90,77
Nebraska,Brown County,12,237,109,128
Nebraska,Brown County,13,240,118,122
Nebraska,Brown County,14,230,110,120
Nebraska,Brown County,15,163,80,83
Nebraska,Brown County,16,148,67,81
Nebraska,Brown County,17,110,54,56
Nebraska,Brown County,18,125,45,80
Nebraska,Buffalo County,0,49615,24823,24792
Nebraska,Buffalo County,1,3476,1792,1684
Nebraska,Buffalo County,2,3185,1668,1517
Nebraska,Buffalo County,3,3117,1605,1512
Nebraska,Buffalo County,4,3807,1983,1824
Nebraska,Buffalo County,5,5554,2787,2767
Nebraska,Buffalo County,6,3403,1728,1675
Nebraska,Buffalo County,7,3300,1735,1565
Nebraska,Buffalo County,8,3203,1704,1499
Nebraska,Buffalo County,9,2681,1362,1319
Nebraska,Buffalo County,10,2556,1305,1251
Nebraska,Buffalo County,11,2491,1226,1265
Nebraska,Buffalo County,12,2848,1376,1472
Nebraska,Buffalo County,13,2797,1342,1455
Nebraska,Buffalo County,14,2391,1181,1210
Nebraska,Buffalo County,15,1726,824,902
Nebraska,Buffalo County,16,1193,512,681
Nebraska,Buffalo County,17,841,355,486
Nebraska,Buffalo County,18,1046,338,708
Nebraska,Burt County,0,6488,3220,3268
Nebraska,Burt County,1,349,190,159
Nebraska,Burt County,2,395,197,198
Nebraska,Burt County,3,461,237,224
Nebraska,Burt County,4,377,217,160
Nebraska,Burt County,5,308,155,153
Nebraska,Burt County,6,309,153,156
Nebraska,Burt County,7,351,166,185
Nebraska,Burt County,8,330,166,164
Nebraska,Burt County,9,310,154,156
Nebraska,Burt County,10,343,167,176
Nebraska,Burt County,11,414,207,207
Nebraska,Burt County,12,466,235,231
Nebraska,Burt County,13,509,267,242
Nebraska,Burt County,14,451,229,222
Nebraska,Burt County,15,349,163,186
Nebraska,Burt County,16,273,135,138
Nebraska,Burt County,17,216,91,125
Nebraska,Burt County,18,277,91,186
Nebraska,Butler County,0,8058,4074,3984
Nebraska,Butler County,1,464,205,259
Nebraska,Butler County,2,509,256,253
Nebraska,Butler County,3,533,278,255
Nebraska,Butler County,4,544,292,252
Nebraska,Butler County,5,421,234,187
Nebraska,Butler County,6,396,205,191
Nebraska,Butler County,7,440,243,197
Nebraska,Butler County,8,444,225,219
Nebraska,Butler County,9,430,239,191
Nebraska,Butler County,10,438,235,203
Nebraska,Butler County,11,530,271,259
Nebraska,Butler County,12,649,323,326
Nebraska,Butler County,13,573,293,280
Nebraska,Butler County,14,528,274,254
Nebraska,Butler County,15,378,172,206
Nebraska,Butler County,16,273,118,155
Nebraska,Butler County,17,238,118,120
Nebraska,Butler County,18,270,93,177
Nebraska,Cass County,0,26159,13179,12980
Nebraska,Cass County,1,1544,801,743
Nebraska,Cass County,2,1752,914,838
Nebraska,Cass County,3,1867,993,874
Nebraska,Cass County,4,1695,888,807
Nebraska,Cass County,5,1313,693,620
Nebraska,Cass County,6,1235,647,588
Nebraska,Cass County,7,1481,750,731
Nebraska,Cass County,8,1656,824,832
Nebraska,Cass County,9,1577,806,771
Nebraska,Cass County,10,1655,805,850
Nebraska,Cass County,11,1808,909,899
Nebraska,Cass County,12,2146,1086,1060
Nebraska,Cass County,13,1853,912,941
Nebraska,Cass County,14,1615,800,815
Nebraska,Cass County,15,1175,591,584
Nebraska,Cass County,16,713,324,389
Nebraska,Cass County,17,530,256,274
Nebraska,Cass County,18,544,180,364
Nebraska,Cedar County,0,8446,4275,4171
Nebraska,Cedar County,1,567,297,270
Nebraska,Cedar County,2,599,336,263
Nebraska,Cedar County,3,617,327,290
Nebraska,Cedar County,4,546,281,265
Nebraska,Cedar County,5,433,225,208
Nebraska,Cedar County,6,361,186,175
Nebraska,Cedar County,7,426,215,211
Nebraska,Cedar County,8,416,226,190
Nebraska,Cedar County,9,382,187,195
Nebraska,Cedar County,10,442,207,235
Nebraska,Cedar County,11,501,255,246
Nebraska,Cedar County,12,661,342,319
Nebraska,Cedar County,13,687,352,335
Nebraska,Cedar County,14,494,262,232
Nebraska,Cedar County,15,396,204,192
Nebraska,Cedar County,16,319,150,169
Nebraska,Cedar County,17,258,104,154
Nebraska,Cedar County,18,341,119,222
Nebraska,Chase County,0,3977,1970,2007
Nebraska,Chase County,1,259,140,119
Nebraska,Chase County,2,283,146,137
Nebraska,Chase County,3,302,152,150
Nebraska,Chase County,4,255,124,131
Nebraska,Chase County,5,183,87,96
Nebraska,Chase County,6,186,94,92
Nebraska,Chase County,7,209,112,97
Nebraska,Chase County,8,224,117,107
Nebraska,Chase County,9,235,118,117
Nebraska,Chase County,10,217,112,105
Nebraska,Chase County,11,217,116,101
Nebraska,Chase County,12,285,146,139
Nebraska,Chase County,13,308,142,166
Nebraska,Chase County,14,217,112,105
Nebraska,Chase County,15,172,89,83
Nebraska,Chase County,16,156,71,85
Nebraska,Chase County,17,111,44,67
Nebraska,Chase County,18,158,48,110
Nebraska,Cherry County,0,5761,2921,2840
Nebraska,Cherry County,1,392,204,188
Nebraska,Cherry County,2,359,188,171
Nebraska,Cherry County,3,384,206,178
Nebraska,Cherry County,4,324,170,154
Nebraska,Cherry County,5,298,160,138
Nebraska,Cherry County,6,290,156,134
Nebraska,Cherry County,7,292,143,149
Nebraska,Cherry County,8,367,198,169
Nebraska,Cherry County,9,321,171,150
Nebraska,Cherry County,10,325,162,163
Nebraska,Cherry County,11,318,148,170
Nebraska,Cherry County,12,402,205,197
Nebraska,Cherry County,13,433,223,210
Nebraska,Cherry County,14,352,172,180
Nebraska,Cherry County,15,291,128,163
Nebraska,Cherry County,16,241,130,111
Nebraska,Cherry County,17,172,83,89
Nebraska,Cherry County,18,200,74,126
Nebraska,Cheyenne County,0,9310,4682,4628
Nebraska,Cheyenne County,1,571,288,283
Nebraska,Cheyenne County,2,625,315,310
Nebraska,Cheyenne County,3,624,320,304
Nebraska,Cheyenne County,4,567,297,270
Nebraska,Cheyenne County,5,418,228,190
Nebraska,Cheyenne County,6,546,288,258
Nebraska,Cheyenne County,7,578,283,295
Nebraska,Cheyenne County,8,584,304,280
Nebraska,Cheyenne County,9,532,254,278
Nebraska,Cheyenne County,10,549,288,261
Nebraska,Cheyenne County,11,560,301,259
Nebraska,Cheyenne County,12,702,362,340
Nebraska,Cheyenne County,13,646,332,314
Nebraska,Cheyenne County,14,568,286,282
Nebraska,Cheyenne County,15,410,209,201
Nebraska,Cheyenne County,16,298,132,166
Nebraska,Cheyenne County,17,234,91,143
Nebraska,Cheyenne County,18,298,104,194
Nebraska,Clay County,0,6214,3190,3024
Nebraska,Clay County,1,440,223,217
Nebraska,Clay County,2,397,216,181
Nebraska,Clay County,3,430,214,216
Nebraska,Clay County,4,392,217,175
Nebraska,Clay County,5,316,172,144
Nebraska,Clay County,6,332,166,166
Nebraska,Clay County,7,362,193,169
Nebraska,Clay County,8,315,163,152
Nebraska,Clay County,9,321,160,161
Nebraska,Clay County,10,330,163,167
Nebraska,Clay County,11,358,188,170
Nebraska,Clay County,12,487,251,236
Nebraska,Clay County,13,472,234,238
Nebraska,Clay County,14,387,216,171
Nebraska,Clay County,15,321,170,151
Nebraska,Clay County,16,208,100,108
Nebraska,Clay County,17,143,63,80
Nebraska,Clay County,18,203,81,122
Nebraska,Colfax County,0,10881,5796,5085
Nebraska,Colfax County,1,979,455,524
Nebraska,Colfax County,2,871,399,472
Nebraska,Colfax County,3,886,438,448
Nebraska,Colfax County,4,764,442,322
Nebraska,Colfax County,5,636,371,265
Nebraska,Colfax County,6,616,319,297
Nebraska,Colfax County,7,756,466,290
Nebraska,Colfax County,8,779,491,288
Nebraska,Colfax County,9,661,384,277
Nebraska,Colfax County,10,598,327,271
Nebraska,Colfax County,11,603,344,259
Nebraska,Colfax County,12,685,368,317
Nebraska,Colfax County,13,582,297,285
Nebraska,Colfax County,14,464,242,222
Nebraska,Colfax County,15,334,176,158
Nebraska,Colfax County,16,230,111,119
Nebraska,Colfax County,17,205,94,111
Nebraska,Colfax County,18,232,72,160
Nebraska,Cuming County,0,8940,4479,4461
Nebraska,Cuming County,1,596,313,283
Nebraska,Cuming County,2,551,279,272
Nebraska,Cuming County,3,654,328,326
Nebraska,Cuming County,4,611,296,315
Nebraska,Cuming County,5,503,266,237
Nebraska,Cuming County,6,428,234,194
Nebraska,Cuming County,7,451,221,230
Nebraska,Cuming County,8,478,236,242
Nebraska,Cuming County,9,453,218,235
Nebraska,Cuming County,10,434,221,213
Nebraska,Cuming County,11,565,296,269
Nebraska,Cuming County,12,625,340,285
Nebraska,Cuming County,13,626,330,296
Nebraska,Cuming County,14,500,262,238
Nebraska,Cuming County,15,434,203,231
Nebraska,Cuming County,16,344,167,177
Nebraska,Cuming County,17,297,135,162
Nebraska,Cuming County,18,390,134,256
Nebraska,Custer County,0,10840,5396,5444
Nebraska,Custer County,1,701,362,339
Nebraska,Custer County,2,705,347,358
Nebraska,Custer County,3,763,374,389
Nebraska,Custer County,4,634,342,292
Nebraska,Custer County,5,543,284,259
Nebraska,Custer County,6,577,275,302
Nebraska,Custer County,7,577,315,262
Nebraska,Custer County,8,565,284,281
Nebraska,Custer County,9,597,309,288
Nebraska,Custer County,10,566,282,284
Nebraska,Custer County,11,603,294,309
Nebraska,Custer County,12,834,431,403
Nebraska,Custer County,13,744,368,376
Nebraska,Custer County,14,716,359,357
Nebraska,Custer County,15,585,284,301
Nebraska,Custer County,16,391,189,202
Nebraska,Custer County,17,327,156,171
Nebraska,Custer County,18,412,141,271
Nebraska,Dakota County,0,20083,10177,9906
Nebraska,Dakota County,1,1744,934,810
Nebraska,Dakota County,2,1575,777,798
Nebraska,Dakota County,3,1502,803,699
Nebraska,Dakota County,4,1448,734,714
Nebraska,Dakota County,5,1370,713,657
Nebraska,Dakota County,6,1376,699,677
Nebraska,Dakota County,7,1353,701,652
Nebraska,Dakota County,8,1210,636,574
Nebraska,Dakota County,9,1079,534,545
Nebraska,Dakota County,10,1121,546,575
Nebraska,Dakota County,11,1223,659,564
Nebraska,Dakota County,12,1252,630,622
Nebraska,Dakota County,13,1095,544,551
Nebraska,Dakota County,14,880,437,443
Nebraska,Dakota County,15,695,331,364
Nebraska,Dakota County,16,504,235,269
Nebraska,Dakota County,17,355,162,193
Nebraska,Dakota County,18,301,102,199
Nebraska,Dawes County,0,8716,4348,4368
Nebraska,Dawes County,1,433,239,194
Nebraska,Dawes County,2,435,215,220
Nebraska,Dawes County,3,395,197,198
Nebraska,Dawes County,4,874,432,442
Nebraska,Dawes County,5,1370,724,646
Nebraska,Dawes County,6,495,242,253
Nebraska,Dawes County,7,390,218,172
Nebraska,Dawes County,8,452,225,227
Nebraska,Dawes County,9,364,187,177
Nebraska,Dawes County,10,375,193,182
Nebraska,Dawes County,11,412,196,216
Nebraska,Dawes County,12,557,257,300
Nebraska,Dawes County,13,548,276,272
Nebraska,Dawes County,14,455,225,230
Nebraska,Dawes County,15,354,177,177
Nebraska,Dawes County,16,313,136,177
Nebraska,Dawes County,17,219,113,106
Nebraska,Dawes County,18,275,96,179
Nebraska,Dawson County,0,23709,12326,11383
Nebraska,Dawson County,1,1895,988,907
Nebraska,Dawson County,2,1691,881,810
Nebraska,Dawson County,3,1765,931,834
Nebraska,Dawson County,4,1676,857,819
Nebraska,Dawson County,5,1401,723,678
Nebraska,Dawson County,6,1546,887,659
Nebraska,Dawson County,7,1463,815,648
Nebraska,Dawson County,8,1439,770,669
Nebraska,Dawson County,9,1348,706,642
Nebraska,Dawson County,10,1383,703,680
Nebraska,Dawson County,11,1274,713,561
Nebraska,Dawson County,12,1412,746,666
Nebraska,Dawson County,13,1469,766,703
Nebraska,Dawson County,14,1252,625,627
Nebraska,Dawson County,15,989,491,498
Nebraska,Dawson County,16,675,315,360
Nebraska,Dawson County,17,454,190,264
Nebraska,Dawson County,18,577,219,358
Nebraska,Deuel County,0,1825,905,920
Nebraska,Deuel County,1,97,45,52
Nebraska,Deuel County,2,100,53,47
Nebraska,Deuel County,3,132,69,63
Nebraska,Deuel County,4,94,43,51
Nebraska,Deuel County,5,67,30,37
Nebraska,Deuel County,6,77,41,36
Nebraska,Deuel County,7,91,40,51
Nebraska,Deuel County,8,100,46,54
Nebraska,Deuel County,9,95,54,41
Nebraska,Deuel County,10,99,54,45
Nebraska,Deuel County,11,123,67,56
Nebraska,Deuel County,12,168,80,88
Nebraska,Deuel County,13,153,81,72
Nebraska,Deuel County,14,126,59,67
Nebraska,Deuel County,15,104,55,49
Nebraska,Deuel County,16,87,40,47
Nebraska,Deuel County,17,62,26,36
Nebraska,Deuel County,18,50,22,28
Nebraska,Dixon County,0,5709,2908,2801
Nebraska,Dixon County,1,409,211,198
Nebraska,Dixon County,2,378,206,172
Nebraska,Dixon County,3,410,225,185
Nebraska,Dixon County,4,400,200,200
Nebraska,Dixon County,5,316,157,159
Nebraska,Dixon County,6,266,133,133
Nebraska,Dixon County,7,287,152,135
Nebraska,Dixon County,8,307,157,150
Nebraska,Dixon County,9,300,149,151
Nebraska,Dixon County,10,320,175,145
Nebraska,Dixon County,11,336,177,159
Nebraska,Dixon County,12,392,198,194
Nebraska,Dixon County,13,442,229,213
Nebraska,Dixon County,14,374,202,172
Nebraska,Dixon County,15,282,143,139
Nebraska,Dixon County,16,214,103,111
Nebraska,Dixon County,17,137,57,80
Nebraska,Dixon County,18,139,34,105
Nebraska,Dodge County,0,36791,18257,18534
Nebraska,Dodge County,1,2515,1271,1244
Nebraska,Dodge County,2,2453,1249,1204
Nebraska,Dodge County,3,2489,1242,1247
Nebraska,Dodge County,4,2455,1259,1196
Nebraska,Dodge County,5,2368,1221,1147
Nebraska,Dodge County,6,2053,1067,986
Nebraska,Dodge County,7,2031,1046,985
Nebraska,Dodge County,8,2269,1173,1096
Nebraska,Dodge County,9,1982,1032,950
Nebraska,Dodge County,10,2058,1067,991
Nebraska,Dodge County,11,2198,1091,1107
Nebraska,Dodge County,12,2540,1243,1297
Nebraska,Dodge County,13,2303,1139,1164
Nebraska,Dodge County,14,2027,983,1044
Nebraska,Dodge County,15,1628,770,858
Nebraska,Dodge County,16,1278,586,692
Nebraska,Dodge County,17,905,361,544
Nebraska,Dodge County,18,1239,457,782
Nebraska,Douglas County,0,566880,279878,287002
Nebraska,Douglas County,1,42731,21966,20765
Nebraska,Douglas County,2,40230,20506,19724
Nebraska,Douglas County,3,39311,20067,19244
Nebraska,Douglas County,4,37690,19044,18646
Nebraska,Douglas County,5,37043,18448,18595
Nebraska,Douglas County,6,43893,22143,21750
Nebraska,Douglas County,7,44108,22307,21801
Nebraska,Douglas County,8,41660,21073,20587
Nebraska,Douglas County,9,34228,17144,17084
Nebraska,Douglas County,10,33452,16755,16697
Nebraska,Douglas County,11,32660,16317,16343
Nebraska,Douglas County,12,34764,16988,17776
Nebraska,Douglas County,13,31358,14878,16480
Nebraska,Douglas County,14,26052,12120,13932
Nebraska,Douglas County,15,18299,8371,9928
Nebraska,Douglas County,16,12221,5316,6905
Nebraska,Douglas County,17,8039,3256,4783
Nebraska,Douglas County,18,9141,3179,5962
Nebraska,Dundy County,0,1770,885,885
Nebraska,Dundy County,1,86,44,42
Nebraska,Dundy County,2,99,52,47
Nebraska,Dundy County,3,93,56,37
Nebraska,Dundy County,4,97,50,47
Nebraska,Dundy County,5,115,56,59
Nebraska,Dundy County,6,64,28,36
Nebraska,Dundy County,7,87,48,39
Nebraska,Dundy County,8,92,51,41
Nebraska,Dundy County,9,93,47,46
Nebraska,Dundy County,10,116,61,55
Nebraska,Dundy County,11,86,40,46
Nebraska,Dundy County,12,147,72,75
Nebraska,Dundy County,13,148,77,71
Nebraska,Dundy County,14,139,71,68
Nebraska,Dundy County,15,97,44,53
Nebraska,Dundy County,16,71,40,31
Nebraska,Dundy County,17,58,15,43
Nebraska,Dundy County,18,82,33,49
Nebraska,Fillmore County,0,5527,2764,2763
Nebraska,Fillmore County,1,297,151,146
Nebraska,Fillmore County,2,270,145,125
Nebraska,Fillmore County,3,295,149,146
Nebraska,Fillmore County,4,345,155,190
Nebraska,Fillmore County,5,271,137,134
Nebraska,Fillmore County,6,305,161,144
Nebraska,Fillmore County,7,332,176,156
Nebraska,Fillmore County,8,330,178,152
Nebraska,Fillmore County,9,279,140,139
Nebraska,Fillmore County,10,280,146,134
Nebraska,Fillmore County,11,389,199,190
Nebraska,Fillmore County,12,464,236,228
Nebraska,Fillmore County,13,420,218,202
Nebraska,Fillmore County,14,367,181,186
Nebraska,Fillmore County,15,266,132,134
Nebraska,Fillmore County,16,209,96,113
Nebraska,Fillmore County,17,193,80,113
Nebraska,Fillmore County,18,215,84,131
Nebraska,Franklin County,0,3023,1488,1535
Nebraska,Franklin County,1,155,70,85
Nebraska,Franklin County,2,162,94,68
Nebraska,Franklin County,3,168,91,77
Nebraska,Franklin County,4,156,78,78
Nebraska,Franklin County,5,132,57,75
Nebraska,Franklin County,6,149,77,72
Nebraska,Franklin County,7,141,74,67
Nebraska,Franklin County,8,131,60,71
Nebraska,Franklin County,9,147,71,76
Nebraska,Franklin County,10,148,71,77
Nebraska,Franklin County,11,170,91,79
Nebraska,Franklin County,12,262,131,131
Nebraska,Franklin County,13,249,130,119
Nebraska,Franklin County,14,254,124,130
Nebraska,Franklin County,15,189,94,95
Nebraska,Franklin County,16,165,74,91
Nebraska,Franklin County,17,119,55,64
Nebraska,Franklin County,18,126,46,80
Nebraska,Frontier County,0,2608,1333,1275
Nebraska,Frontier County,1,130,67,63
Nebraska,Frontier County,2,134,80,54
Nebraska,Frontier County,3,150,83,67
Nebraska,Frontier County,4,210,114,96
Nebraska,Frontier County,5,161,82,79
Nebraska,Frontier County,6,130,68,62
Nebraska,Frontier County,7,131,63,68
Nebraska,Frontier County,8,125,70,55
Nebraska,Frontier County,9,122,65,57
Nebraska,Frontier County,10,147,62,85
Nebraska,Frontier County,11,134,62,72
Nebraska,Frontier County,12,179,94,85
Nebraska,Frontier County,13,232,134,98
Nebraska,Frontier County,14,181,79,102
Nebraska,Frontier County,15,147,80,67
Nebraska,Frontier County,16,112,56,56
Nebraska,Frontier County,17,86,41,45
Nebraska,Frontier County,18,97,33,64
Nebraska,Furnas County,0,4715,2348,2367
Nebraska,Furnas County,1,271,140,131
Nebraska,Furnas County,2,242,131,111
Nebraska,Furnas County,3,307,152,155
Nebraska,Furnas County,4,315,165,150
Nebraska,Furnas County,5,229,134,95
Nebraska,Furnas County,6,257,136,121
Nebraska,Furnas County,7,191,94,97
Nebraska,Furnas County,8,242,124,118
Nebraska,Furnas County,9,236,109,127
Nebraska,Furnas County,10,264,147,117
Nebraska,Furnas County,11,261,132,129
Nebraska,Furnas County,12,336,175,161
Nebraska,Furnas County,13,383,192,191
Nebraska,Furnas County,14,344,152,192
Nebraska,Furnas County,15,305,149,156
Nebraska,Furnas County,16,204,92,112
Nebraska,Furnas County,17,158,73,85
Nebraska,Furnas County,18,170,51,119
Nebraska,Gage County,0,21493,10735,10758
Nebraska,Gage County,1,1265,661,604
Nebraska,Gage County,2,1338,707,631
Nebraska,Gage County,3,1417,741,676
Nebraska,Gage County,4,1269,673,596
Nebraska,Gage County,5,1055,568,487
Nebraska,Gage County,6,1075,532,543
Nebraska,Gage County,7,1169,584,585
Nebraska,Gage County,8,1246,639,607
Nebraska,Gage County,9,1216,617,599
Nebraska,Gage County,10,1222,630,592
Nebraska,Gage County,11,1383,677,706
Nebraska,Gage County,12,1741,870,871
Nebraska,Gage County,13,1624,809,815
Nebraska,Gage County,14,1274,631,643
Nebraska,Gage County,15,1006,482,524
Nebraska,Gage County,16,796,352,444
Nebraska,Gage County,17,621,264,357
Nebraska,Gage County,18,776,298,478
Nebraska,Garden County,0,1897,992,905
Nebraska,Garden County,1,88,43,45
Nebraska,Garden County,2,112,58,54
Nebraska,Garden County,3,114,78,36
Nebraska,Garden County,4,90,60,30
Nebraska,Garden County,5,83,46,37
Nebraska,Garden County,6,81,48,33
Nebraska,Garden County,7,113,51,62
Nebraska,Garden County,8,81,46,35
Nebraska,Garden County,9,70,37,33
Nebraska,Garden County,10,101,51,50
Nebraska,Garden County,11,107,50,57
Nebraska,Garden County,12,169,85,84
Nebraska,Garden County,13,158,93,65
Nebraska,Garden County,14,140,66,74
Nebraska,Garden County,15,113,54,59
Nebraska,Garden County,16,114,60,54
Nebraska,Garden County,17,90,35,55
Nebraska,Garden County,18,73,31,42
Nebraska,Garfield County,0,1987,992,995
Nebraska,Garfield County,1,95,50,45
Nebraska,Garfield County,2,79,46,33
Nebraska,Garfield County,3,111,48,63
Nebraska,Garfield County,4,122,62,60
Nebraska,Garfield County,5,119,60,59
Nebraska,Garfield County,6,77,43,34
Nebraska,Garfield County,7,92,51,41
Nebraska,Garfield County,8,77,42,35
Nebraska,Garfield County,9,105,51,54
Nebraska,Garfield County,10,84,38,46
Nebraska,Garfield County,11,106,48,58
Nebraska,Garfield County,12,163,85,78
Nebraska,Garfield County,13,186,102,84
Nebraska,Garfield County,14,144,78,66
Nebraska,Garfield County,15,132,62,70
Nebraska,Garfield County,16,93,48,45
Nebraska,Garfield County,17,100,51,49
Nebraska,Garfield County,18,102,27,75
Nebraska,Gosper County,0,1996,1023,973
Nebraska,Gosper County,1,117,63,54
Nebraska,Gosper County,2,113,60,53
Nebraska,Gosper County,3,119,73,46
Nebraska,Gosper County,4,134,69,65
Nebraska,Gosper County,5,86,42,44
Nebraska,Gosper County,6,79,38,41
Nebraska,Gosper County,7,111,64,47
Nebraska,Gosper County,8,117,48,69
Nebraska,Gosper County,9,81,46,35
Nebraska,Gosper County,10,115,64,51
Nebraska,Gosper County,11,114,56,58
Nebraska,Gosper County,12,171,86,85
Nebraska,Gosper County,13,162,83,79
Nebraska,Gosper County,14,132,64,68
Nebraska,Gosper County,15,118,62,56
Nebraska,Gosper County,16,71,31,40
Nebraska,Gosper County,17,76,47,29
Nebraska,Gosper County,18,80,27,53
Nebraska,Grant County,0,660,349,311
Nebraska,Grant County,1,56,26,30
Nebraska,Grant County,2,47,26,21
Nebraska,Grant County,3,37,25,12
Nebraska,Grant County,4,33,16,17
Nebraska,Grant County,5,22,12,10
Nebraska,Grant County,6,30,20,10
Nebraska,Grant County,7,42,22,20
Nebraska,Grant County,8,40,21,19
Nebraska,Grant County,9,37,19,18
Nebraska,Grant County,10,19,10,9
Nebraska,Grant County,11,35,15,20
Nebraska,Grant County,12,64,32,32
Nebraska,Grant County,13,49,28,21
Nebraska,Grant County,14,53,26,27
Nebraska,Grant County,15,35,16,19
Nebraska,Grant County,16,34,16,18
Nebraska,Grant County,17,21,15,6
Nebraska,Grant County,18,6,4,2
Nebraska,Greeley County,0,2356,1160,1196
Nebraska,Greeley County,1,150,75,75
Nebraska,Greeley County,2,148,70,78
Nebraska,Greeley County,3,165,85,80
Nebraska,Greeley County,4,126,67,59
Nebraska,Greeley County,5,116,53,63
Nebraska,Greeley County,6,99,40,59
Nebraska,Greeley County,7,134,70,64
Nebraska,Greeley County,8,113,52,61
Nebraska,Greeley County,9,133,72,61
Nebraska,Greeley County,10,82,45,37
Nebraska,Greeley County,11,141,64,77
Nebraska,Greeley County,12,183,93,90
Nebraska,Greeley County,13,162,80,82
Nebraska,Greeley County,14,161,85,76
Nebraska,Greeley County,15,122,73,49
Nebraska,Greeley County,16,108,55,53
Nebraska,Greeley County,17,97,44,53
Nebraska,Greeley County,18,116,37,79
Nebraska,Hall County,0,61607,31080,30527
Nebraska,Hall County,1,4818,2558,2260
Nebraska,Hall County,2,4558,2353,2205
Nebraska,Hall County,3,4826,2466,2360
Nebraska,Hall County,4,4156,2200,1956
Nebraska,Hall County,5,3652,1888,1764
Nebraska,Hall County,6,4072,2142,1930
Nebraska,Hall County,7,4017,2009,2008
Nebraska,Hall County,8,4028,2042,1986
Nebraska,Hall County,9,3644,1863,1781
Nebraska,Hall County,10,3585,1850,1735
Nebraska,Hall County,11,3573,1785,1788
Nebraska,Hall County,12,3951,2024,1927
Nebraska,Hall County,13,3577,1757,1820
Nebraska,Hall County,14,2887,1364,1523
Nebraska,Hall County,15,2293,1112,1181
Nebraska,Hall County,16,1554,707,847
Nebraska,Hall County,17,1089,467,622
Nebraska,Hall County,18,1327,493,834
Nebraska,Hamilton County,0,9280,4658,4622
Nebraska,Hamilton County,1,584,297,287
Nebraska,Hamilton County,2,610,343,267
Nebraska,Hamilton County,3,630,340,290
Nebraska,Hamilton County,4,624,309,315
Nebraska,Hamilton County,5,517,277,240
Nebraska,Hamilton County,6,507,251,256
Nebraska,Hamilton County,7,487,253,234
Nebraska,Hamilton County,8,551,278,273
Nebraska,Hamilton County,9,481,238,243
Nebraska,Hamilton County,10,559,275,284
Nebraska,Hamilton County,11,570,289,281
Nebraska,Hamilton County,12,644,327,317
Nebraska,Hamilton County,13,669,305,364
Nebraska,Hamilton County,14,559,292,267
Nebraska,Hamilton County,15,441,211,230
Nebraska,Hamilton County,16,320,155,165
Nebraska,Hamilton County,17,245,118,127
Nebraska,Hamilton County,18,282,100,182
Nebraska,Harlan County,0,3401,1762,1639
Nebraska,Harlan County,1,184,105,79
Nebraska,Harlan County,2,207,111,96
Nebraska,Harlan County,3,202,113,89
Nebraska,Harlan County,4,204,105,99
Nebraska,Harlan County,5,139,74,65
Nebraska,Harlan County,6,155,72,83
Nebraska,Harlan County,7,128,70,58
Nebraska,Harlan County,8,169,84,85
Nebraska,Harlan County,9,157,81,76
Nebraska,Harlan County,10,189,100,89
Nebraska,Harlan County,11,200,109,91
Nebraska,Harlan County,12,283,144,139
Nebraska,Harlan County,13,293,151,142
Nebraska,Harlan County,14,262,138,124
Nebraska,Harlan County,15,222,123,99
Nebraska,Harlan County,16,154,75,79
Nebraska,Harlan County,17,122,55,67
Nebraska,Harlan County,18,131,52,79
Nebraska,Hayes County,0,916,474,442
Nebraska,Hayes County,1,68,35,33
Nebraska,Hayes County,2,62,26,36
Nebraska,Hayes County,3,46,27,19
Nebraska,Hayes County,4,39,20,19
Nebraska,Hayes County,5,55,30,25
Nebraska,Hayes County,6,45,19,26
Nebraska,Hayes County,7,40,26,14
Nebraska,Hayes County,8,45,23,22
Nebraska,Hayes County,9,35,17,18
Nebraska,Hayes County,10,24,11,13
Nebraska,Hayes County,11,39,24,15
Nebraska,Hayes County,12,80,41,39
Nebraska,Hayes County,13,86,46,40
Nebraska,Hayes County,14,69,34,35
Nebraska,Hayes County,15,55,35,20
Nebraska,Hayes County,16,38,15,23
Nebraska,Hayes County,17,43,22,21
Nebraska,Hayes County,18,47,23,24
Nebraska,Hitchcock County,0,2806,1413,1393
Nebraska,Hitchcock County,1,152,77,75
Nebraska,Hitchcock County,2,164,82,82
Nebraska,Hitchcock County,3,214,112,102
Nebraska,Hitchcock County,4,160,89,71
Nebraska,Hitchcock County,5,119,61,58
Nebraska,Hitchcock County,6,115,65,50
Nebraska,Hitchcock County,7,125,62,63
Nebraska,Hitchcock County,8,202,105,97
Nebraska,Hitchcock County,9,128,64,64
Nebraska,Hitchcock County,10,154,78,76
Nebraska,Hitchcock County,11,129,61,68
Nebraska,Hitchcock County,12,222,113,109
Nebraska,Hitchcock County,13,211,112,99
Nebraska,Hitchcock County,14,228,111,117
Nebraska,Hitchcock County,15,149,77,72
Nebraska,Hitchcock County,16,128,62,66
Nebraska,Hitchcock County,17,94,38,56
Nebraska,Hitchcock County,18,112,44,68
Nebraska,Holt County,0,10178,5088,5090
Nebraska,Holt County,1,717,373,344
Nebraska,Holt County,2,748,380,368
Nebraska,Holt County,3,727,376,351
Nebraska,Holt County,4,567,281,286
Nebraska,Holt County,5,509,255,254
Nebraska,Holt County,6,481,251,230
Nebraska,Holt County,7,504,266,238
Nebraska,Holt County,8,556,279,277
Nebraska,Holt County,9,475,255,220
Nebraska,Holt County,10,477,244,233
Nebraska,Holt County,11,575,280,295
Nebraska,Holt County,12,850,426,424
Nebraska,Holt County,13,795,404,391
Nebraska,Holt County,14,666,347,319
Nebraska,Holt County,15,490,237,253
Nebraska,Holt County,16,405,189,216
Nebraska,Holt County,17,282,108,174
Nebraska,Holt County,18,354,137,217
Nebraska,Hooker County,0,682,329,353
Nebraska,Hooker County,1,42,21,21
Nebraska,Hooker County,2,35,15,20
Nebraska,Hooker County,3,50,29,21
Nebraska,Hooker County,4,40,21,19
Nebraska,Hooker County,5,23,9,14
Nebraska,Hooker County,6,33,19,14
Nebraska,Hooker County,7,25,11,14
Nebraska,Hooker County,8,34,13,21
Nebraska,Hooker County,9,39,26,13
Nebraska,Hooker County,10,30,12,18
Nebraska,Hooker County,11,26,13,13
Nebraska,Hooker County,12,35,20,15
Nebraska,Hooker County,13,62,27,35
Nebraska,Hooker County,14,56,29,27
Nebraska,Hooker County,15,41,19,22
Nebraska,Hooker County,16,38,19,19
Nebraska,Hooker County,17,22,7,15
Nebraska,Hooker County,18,51,19,32
Nebraska,Howard County,0,6468,3281,3187
Nebraska,Howard County,1,402,226,176
Nebraska,Howard County,2,444,216,228
Nebraska,Howard County,3,469,259,210
Nebraska,Howard County,4,379,206,173
Nebraska,Howard County,5,275,141,134
Nebraska,Howard County,6,348,175,173
Nebraska,Howard County,7,338,168,170
Nebraska,Howard County,8,362,187,175
Nebraska,Howard County,9,362,186,176
Nebraska,Howard County,10,369,196,173
Nebraska,Howard County,11,428,203,225
Nebraska,Howard County,12,453,231,222
Nebraska,Howard County,13,475,244,231
Nebraska,Howard County,14,373,182,191
Nebraska,Howard County,15,363,177,186
Nebraska,Howard County,16,217,106,111
Nebraska,Howard County,17,186,93,93
Nebraska,Howard County,18,225,85,140
Nebraska,Jefferson County,0,7097,3511,3586
Nebraska,Jefferson County,1,398,200,198
Nebraska,Jefferson County,2,422,224,198
Nebraska,Jefferson County,3,460,241,219
Nebraska,Jefferson County,4,416,199,217
Nebraska,Jefferson County,5,315,150,165
Nebraska,Jefferson County,6,333,170,163
Nebraska,Jefferson County,7,368,198,170
Nebraska,Jefferson County,8,381,185,196
Nebraska,Jefferson County,9,363,201,162
Nebraska,Jefferson County,10,392,193,199
Nebraska,Jefferson County,11,410,197,213
Nebraska,Jefferson County,12,548,269,279
Nebraska,Jefferson County,13,593,312,281
Nebraska,Jefferson County,14,509,251,258
Nebraska,Jefferson County,15,386,186,200
Nebraska,Jefferson County,16,289,138,151
Nebraska,Jefferson County,17,238,105,133
Nebraska,Jefferson County,18,276,92,184
Nebraska,Johnson County,0,5134,3019,2115
Nebraska,Johnson County,1,240,121,119
Nebraska,Johnson County,2,248,124,124
Nebraska,Johnson County,3,310,141,169
Nebraska,Johnson County,4,258,146,112
Nebraska,Johnson County,5,305,201,104
Nebraska,Johnson County,6,350,252,98
Nebraska,Johnson County,7,362,280,82
Nebraska,Johnson County,8,390,274,116
Nebraska,Johnson County,9,293,191,102
Nebraska,Johnson County,10,337,234,103
Nebraska,Johnson County,11,329,204,125
Nebraska,Johnson County,12,379,212,167
Nebraska,Johnson County,13,370,208,162
Nebraska,Johnson County,14,270,140,130
Nebraska,Johnson County,15,226,107,119
Nebraska,Johnson County,16,159,77,82
Nebraska,Johnson County,17,122,51,71
Nebraska,Johnson County,18,186,56,130
Nebraska,Kearney County,0,6544,3264,3280
Nebraska,Kearney County,1,415,201,214
Nebraska,Kearney County,2,422,220,202
Nebraska,Kearney County,3,514,255,259
Nebraska,Kearney County,4,386,195,191
Nebraska,Kearney County,5,346,193,153
Nebraska,Kearney County,6,371,181,190
Nebraska,Kearney County,7,361,184,177
Nebraska,Kearney County,8,387,195,192
Nebraska,Kearney County,9,360,175,185
Nebraska,Kearney County,10,393,210,183
Nebraska,Kearney County,11,369,190,179
Nebraska,Kearney County,12,507,251,256
Nebraska,Kearney County,13,432,217,215
Nebraska,Kearney County,14,384,187,197
Nebraska,Kearney County,15,296,145,151
Nebraska,Kearney County,16,237,117,120
Nebraska,Kearney County,17,173,74,99
Nebraska,Kearney County,18,191,74,117
Nebraska,Keith County,0,8021,4046,3975
Nebraska,Keith County,1,447,237,210
Nebraska,Keith County,2,415,229,186
Nebraska,Keith County,3,475,261,214
Nebraska,Keith County,4,395,198,197
Nebraska,Keith County,5,361,182,179
Nebraska,Keith County,6,371,174,197
Nebraska,Keith County,7,409,216,193
Nebraska,Keith County,8,391,194,197
Nebraska,Keith County,9,386,204,182
Nebraska,Keith County,10,426,202,224
Nebraska,Keith County,11,480,257,223
Nebraska,Keith County,12,701,363,338
Nebraska,Keith County,13,622,307,315
Nebraska,Keith County,14,660,314,346
Nebraska,Keith County,15,550,281,269
Nebraska,Keith County,16,402,181,221
Nebraska,Keith County,17,301,154,147
Nebraska,Keith County,18,229,92,137
Nebraska,Keya Paha County,0,810,393,417
Nebraska,Keya Paha County,1,33,15,18
Nebraska,Keya Paha County,2,45,18,27
Nebraska,Keya Paha County,3,53,26,27
Nebraska,Keya Paha County,4,36,17,19
Nebraska,Keya Paha County,5,34,16,18
Nebraska,Keya Paha County,6,33,18,15
Nebraska,Keya Paha County,7,22,11,11
Nebraska,Keya Paha County,8,44,23,21
Nebraska,Keya Paha County,9,37,20,17
Nebraska,Keya Paha County,10,29,14,15
Nebraska,Keya Paha County,11,42,23,19
Nebraska,Keya Paha County,12,76,38,38
Nebraska,Keya Paha County,13,75,41,34
Nebraska,Keya Paha County,14,55,30,25
Nebraska,Keya Paha County,15,63,26,37
Nebraska,Keya Paha County,16,41,20,21
Nebraska,Keya Paha County,17,52,24,28
Nebraska,Keya Paha County,18,40,13,27
Nebraska,Kimball County,0,3618,1816,1802
Nebraska,Kimball County,1,218,99,119
Nebraska,Kimball County,2,213,113,100
Nebraska,Kimball County,3,211,106,105
Nebraska,Kimball County,4,222,129,93
Nebraska,Kimball County,5,168,101,67
Nebraska,Kimball County,6,180,93,87
Nebraska,Kimball County,7,178,96,82
Nebraska,Kimball County,8,190,100,90
Nebraska,Kimball County,9,173,94,79
Nebraska,Kimball County,10,191,87,104
Nebraska,Kimball County,11,217,110,107
Nebraska,Kimball County,12,294,142,152
Nebraska,Kimball County,13,280,153,127
Nebraska,Kimball County,14,225,106,119
Nebraska,Kimball County,15,209,90,119
Nebraska,Kimball County,16,188,90,98
Nebraska,Kimball County,17,124,56,68
Nebraska,Kimball County,18,137,51,86
Nebraska,Knox County,0,8419,4167,4252
Nebraska,Knox County,1,544,292,252
Nebraska,Knox County,2,570,273,297
Nebraska,Knox County,3,570,267,303
Nebraska,Knox County,4,545,275,270
Nebraska,Knox County,5,385,210,175
Nebraska,Knox County,6,380,203,177
Nebraska,Knox County,7,364,175,189
Nebraska,Knox County,8,419,245,174
Nebraska,Knox County,9,381,191,190
Nebraska,Knox County,10,399,212,187
Nebraska,Knox County,11,467,233,234
Nebraska,Knox County,12,632,317,315
Nebraska,Knox County,13,685,351,334
Nebraska,Knox County,14,573,280,293
Nebraska,Knox County,15,455,224,231
Nebraska,Knox County,16,353,165,188
Nebraska,Knox County,17,304,120,184
Nebraska,Knox County,18,393,134,259
Nebraska,Lancaster County,0,317272,159223,158049
Nebraska,Lancaster County,1,20112,10476,9636
Nebraska,Lancaster County,2,20394,10389,10005
Nebraska,Lancaster County,3,20374,10386,9988
Nebraska,Lancaster County,4,23538,11800,11738
Nebraska,Lancaster County,5,35462,17825,17637
Nebraska,Lancaster County,6,23479,12684,10795
Nebraska,Lancaster County,7,20609,10854,9755
Nebraska,Lancaster County,8,21364,11072,10292
Nebraska,Lancaster County,9,18344,9530,8814
Nebraska,Lancaster County,10,17439,8959,8480
Nebraska,Lancaster County,11,16355,8333,8022
Nebraska,Lancaster County,12,18105,8819,9286
Nebraska,Lancaster County,13,17558,8474,9084
Nebraska,Lancaster County,14,15634,7386,8248
Nebraska,Lancaster County,15,11014,5100,5914
Nebraska,Lancaster County,16,7136,3210,3926
Nebraska,Lancaster County,17,4837,2018,2819
Nebraska,Lancaster County,18,5518,1908,3610
Nebraska,Lincoln County,0,35185,17409,17776
Nebraska,Lincoln County,1,2110,1073,1037
Nebraska,Lincoln County,2,2248,1152,1096
Nebraska,Lincoln County,3,2517,1257,1260
Nebraska,Lincoln County,4,2187,1126,1061
Nebraska,Lincoln County,5,1798,939,859
Nebraska,Lincoln County,6,2061,1062,999
Nebraska,Lincoln County,7,2025,995,1030
Nebraska,Lincoln County,8,2316,1158,1158
Nebraska,Lincoln County,9,2107,1014,1093
Nebraska,Lincoln County,10,2078,1109,969
Nebraska,Lincoln County,11,1953,988,965
Nebraska,Lincoln County,12,2454,1197,1257
Nebraska,Lincoln County,13,2526,1275,1251
Nebraska,Lincoln County,14,2189,1078,1111
Nebraska,Lincoln County,15,1602,762,840
Nebraska,Lincoln County,16,1148,536,612
Nebraska,Lincoln County,17,871,347,524
Nebraska,Lincoln County,18,995,341,654
Nebraska,Logan County,0,749,396,353
Nebraska,Logan County,1,48,28,20
Nebraska,Logan County,2,43,24,19
Nebraska,Logan County,3,68,41,27
Nebraska,Logan County,4,49,22,27
Nebraska,Logan County,5,26,16,10
Nebraska,Logan County,6,27,13,14
Nebraska,Logan County,7,30,19,11
Nebraska,Logan County,8,50,25,25
Nebraska,Logan County,9,51,28,23
Nebraska,Logan County,10,36,16,20
Nebraska,Logan County,11,35,20,15
Nebraska,Logan County,12,59,30,29
Nebraska,Logan County,13,58,31,27
Nebraska,Logan County,14,59,30,29
Nebraska,Logan County,15,36,18,18
Nebraska,Logan County,16,35,13,22
Nebraska,Logan County,17,17,11,6
Nebraska,Logan County,18,22,11,11
Nebraska,Loup County,0,618,315,303
Nebraska,Loup County,1,30,16,14
Nebraska,Loup County,2,31,18,13
Nebraska,Loup County,3,31,22,9
Nebraska,Loup County,4,36,20,16
Nebraska,Loup County,5,33,17,16
Nebraska,Loup County,6,23,11,12
Nebraska,Loup County,7,30,16,14
Nebraska,Loup County,8,26,12,14
Nebraska,Loup County,9,23,14,9
Nebraska,Loup County,10,26,12,14
Nebraska,Loup County,11,30,15,15
Nebraska,Loup County,12,58,29,29
Nebraska,Loup County,13,76,37,39
Nebraska,Loup County,14,51,24,27
Nebraska,Loup County,15,46,23,23
Nebraska,Loup County,16,35,19,16
Nebraska,Loup County,17,21,8,13
Nebraska,Loup County,18,12,2,10
Nebraska,McPherson County,0,492,251,241
Nebraska,McPherson County,1,16,7,9
Nebraska,McPherson County,2,14,9,5
Nebraska,McPherson County,3,34,18,16
Nebraska,McPherson County,4,43,21,22
Nebraska,McPherson County,5,26,15,11
Nebraska,McPherson County,6,14,7,7
Nebraska,McPherson County,7,15,8,7
Nebraska,McPherson County,8,21,8,13
Nebraska,McPherson County,9,27,14,13
Nebraska,McPherson County,10,34,25,9
Nebraska,McPherson County,11,39,20,19
Nebraska,McPherson County,12,46,20,26
Nebraska,McPherson County,13,44,19,25
Nebraska,McPherson County,14,34,20,14
Nebraska,McPherson County,15,31,12,19
Nebraska,McPherson County,16,20,11,9
Nebraska,McPherson County,17,16,9,7
Nebraska,McPherson County,18,18,8,10
Nebraska,Madison County,0,35392,17509,17883
Nebraska,Madison County,1,2598,1257,1341
Nebraska,Madison County,2,2574,1256,1318
Nebraska,Madison County,3,2437,1244,1193
Nebraska,Madison County,4,2400,1222,1178
Nebraska,Madison County,5,2326,1196,1130
Nebraska,Madison County,6,2253,1184,1069
Nebraska,Madison County,7,2275,1168,1107
Nebraska,Madison County,8,2255,1169,1086
Nebraska,Madison County,9,1897,939,958
Nebraska,Madison County,10,1816,920,896
Nebraska,Madison County,11,2014,1000,1014
Nebraska,Madison County,12,2508,1249,1259
Nebraska,Madison County,13,2396,1202,1194
Nebraska,Madison County,14,1749,839,910
Nebraska,Madison County,15,1254,581,673
Nebraska,Madison County,16,939,414,525
Nebraska,Madison County,17,683,286,397
Nebraska,Madison County,18,1018,383,635
Nebraska,Merrick County,0,7733,3875,3858
Nebraska,Merrick County,1,456,219,237
Nebraska,Merrick County,2,485,230,255
Nebraska,Merrick County,3,465,254,211
Nebraska,Merrick County,4,496,250,246
Nebraska,Merrick County,5,412,206,206
Nebraska,Merrick County,6,418,222,196
Nebraska,Merrick County,7,433,210,223
Nebraska,Merrick County,8,445,237,208
Nebraska,Merrick County,9,408,200,208
Nebraska,Merrick County,10,468,248,220
Nebraska,Merrick County,11,503,239,264
Nebraska,Merrick County,12,611,327,284
Nebraska,Merrick County,13,543,278,265
Nebraska,Merrick County,14,460,247,213
Nebraska,Merrick County,15,356,183,173
Nebraska,Merrick County,16,305,137,168
Nebraska,Merrick County,17,214,93,121
Nebraska,Merrick County,18,255,95,160
Nebraska,Morrill County,0,4686,2405,2281
Nebraska,Morrill County,1,259,137,122
Nebraska,Morrill County,2,301,159,142
Nebraska,Morrill County,3,318,157,161
Nebraska,Morrill County,4,303,162,141
Nebraska,Morrill County,5,239,135,104
Nebraska,Morrill County,6,237,125,112
Nebraska,Morrill County,7,264,131,133
Nebraska,Morrill County,8,264,138,126
Nebraska,Morrill County,9,272,142,130
Nebraska,Morrill County,10,273,124,149
Nebraska,Morrill County,11,276,159,117
Nebraska,Morrill County,12,323,161,162
Nebraska,Morrill County,13,364,180,184
Nebraska,Morrill County,14,301,173,128
Nebraska,Morrill County,15,207,105,102
Nebraska,Morrill County,16,205,102,103
Nebraska,Morrill County,17,133,56,77
Nebraska,Morrill County,18,147,59,88
Nebraska,Nance County,0,3532,1754,1778
Nebraska,Nance County,1,195,106,89
Nebraska,Nance County,2,222,118,104
Nebraska,Nance County,3,226,115,111
Nebraska,Nance County,4,215,108,107
Nebraska,Nance County,5,160,83,77
Nebraska,Nance County,6,198,101,97
Nebraska,Nance County,7,169,99,70
Nebraska,Nance County,8,199,101,98
Nebraska,Nance County,9,187,95,92
Nebraska,Nance County,10,176,91,85
Nebraska,Nance County,11,224,106,118
Nebraska,Nance County,12,311,161,150
Nebraska,Nance County,13,295,158,137
Nebraska,Nance County,14,254,128,126
Nebraska,Nance County,15,147,62,85
Nebraska,Nance County,16,98,36,62
Nebraska,Nance County,17,116,38,78
Nebraska,Nance County,18,140,48,92
Nebraska,Nemaha County,0,6958,3479,3479
Nebraska,Nemaha County,1,411,224,187
Nebraska,Nemaha County,2,430,215,215
Nebraska,Nemaha County,3,423,228,195
Nebraska,Nemaha County,4,559,265,294
Nebraska,Nemaha County,5,524,263,261
Nebraska,Nemaha County,6,389,202,187
Nebraska,Nemaha County,7,419,228,191
Nebraska,Nemaha County,8,442,232,210
Nebraska,Nemaha County,9,307,146,161
Nebraska,Nemaha County,10,316,154,162
Nebraska,Nemaha County,11,387,184,203
Nebraska,Nemaha County,12,469,235,234
Nebraska,Nemaha County,13,485,239,246
Nebraska,Nemaha County,14,457,223,234
Nebraska,Nemaha County,15,323,178,145
Nebraska,Nemaha County,16,229,110,119
Nebraska,Nemaha County,17,181,82,99
Nebraska,Nemaha County,18,207,71,136
Nebraska,Nuckolls County,0,4195,2085,2110
Nebraska,Nuckolls County,1,214,105,109
Nebraska,Nuckolls County,2,206,101,105
Nebraska,Nuckolls County,3,251,137,114
Nebraska,Nuckolls County,4,249,139,110
Nebraska,Nuckolls County,5,203,104,99
Nebraska,Nuckolls County,6,192,94,98
Nebraska,Nuckolls County,7,193,108,85
Nebraska,Nuckolls County,8,235,117,118
Nebraska,Nuckolls County,9,188,100,88
Nebraska,Nuckolls County,10,205,104,101
Nebraska,Nuckolls County,11,228,121,107
Nebraska,Nuckolls County,12,333,163,170
Nebraska,Nuckolls County,13,361,175,186
Nebraska,Nuckolls County,14,304,151,153
Nebraska,Nuckolls County,15,285,134,151
Nebraska,Nuckolls County,16,195,85,110
Nebraska,Nuckolls County,17,157,69,88
Nebraska,Nuckolls County,18,196,78,118
Nebraska,Otoe County,0,15985,7929,8056
Nebraska,Otoe County,1,1053,568,485
Nebraska,Otoe County,2,1039,529,510
Nebraska,Otoe County,3,1102,557,545
Nebraska,Otoe County,4,987,481,506
Nebraska,Otoe County,5,854,464,390
Nebraska,Otoe County,6,818,431,387
Nebraska,Otoe County,7,903,454,449
Nebraska,Otoe County,8,927,455,472
Nebraska,Otoe County,9,892,448,444
Nebraska,Otoe County,10,933,503,430
Nebraska,Otoe County,11,1010,485,525
Nebraska,Otoe County,12,1191,610,581
Nebraska,Otoe County,13,1166,568,598
Nebraska,Otoe County,14,879,426,453
Nebraska,Otoe County,15,710,329,381
Nebraska,Otoe County,16,550,253,297
Nebraska,Otoe County,17,391,178,213
Nebraska,Otoe County,18,580,190,390
Nebraska,Pawnee County,0,2632,1296,1336
Nebraska,Pawnee County,1,168,87,81
Nebraska,Pawnee County,2,155,87,68
Nebraska,Pawnee County,3,149,77,72
Nebraska,Pawnee County,4,145,66,79
Nebraska,Pawnee County,5,115,61,54
Nebraska,Pawnee County,6,115,64,51
Nebraska,Pawnee County,7,113,57,56
Nebraska,Pawnee County,8,126,59,67
Nebraska,Pawnee County,9,108,46,62
Nebraska,Pawnee County,10,125,64,61
Nebraska,Pawnee County,11,141,73,68
Nebraska,Pawnee County,12,213,99,114
Nebraska,Pawnee County,13,204,106,98
Nebraska,Pawnee County,14,200,107,93
Nebraska,Pawnee County,15,178,85,93
Nebraska,Pawnee County,16,119,54,65
Nebraska,Pawnee County,17,100,42,58
Nebraska,Pawnee County,18,158,62,96
Nebraska,Perkins County,0,2929,1492,1437
Nebraska,Perkins County,1,198,98,100
Nebraska,Perkins County,2,198,100,98
Nebraska,Perkins County,3,215,101,114
Nebraska,Perkins County,4,188,119,69
Nebraska,Perkins County,5,131,75,56
Nebraska,Perkins County,6,112,61,51
Nebraska,Perkins County,7,176,92,84
Nebraska,Perkins County,8,176,93,83
Nebraska,Perkins County,9,171,90,81
Nebraska,Perkins County,10,128,64,64
Nebraska,Perkins County,11,141,75,66
Nebraska,Perkins County,12,205,99,106
Nebraska,Perkins County,13,203,96,107
Nebraska,Perkins County,14,223,125,98
Nebraska,Perkins County,15,149,76,73
Nebraska,Perkins County,16,99,48,51
Nebraska,Perkins County,17,90,33,57
Nebraska,Perkins County,18,126,47,79
Nebraska,Phelps County,0,8996,4511,4485
Nebraska,Phelps County,1,534,274,260
Nebraska,Phelps County,2,621,332,289
Nebraska,Phelps County,3,600,314,286
Nebraska,Phelps County,4,584,298,286
Nebraska,Phelps County,5,494,256,238
Nebraska,Phelps County,6,487,261,226
Nebraska,Phelps County,7,509,262,247
Nebraska,Phelps County,8,507,277,230
Nebraska,Phelps County,9,462,228,234
Nebraska,Phelps County,10,517,271,246
Nebraska,Phelps County,11,562,277,285
Nebraska,Phelps County,12,689,344,345
Nebraska,Phelps County,13,566,309,257
Nebraska,Phelps County,14,500,250,250
Nebraska,Phelps County,15,426,183,243
Nebraska,Phelps County,16,335,155,180
Nebraska,Phelps County,17,277,103,174
Nebraska,Phelps County,18,326,117,209
Nebraska,Pierce County,0,7142,3615,3527
Nebraska,Pierce County,1,447,224,223
Nebraska,Pierce County,2,498,251,247
Nebraska,Pierce County,3,519,261,258
Nebraska,Pierce County,4,451,237,214
Nebraska,Pierce County,5,363,192,171
Nebraska,Pierce County,6,359,194,165
Nebraska,Pierce County,7,383,203,180
Nebraska,Pierce County,8,444,232,212
Nebraska,Pierce County,9,363,189,174
Nebraska,Pierce County,10,398,204,194
Nebraska,Pierce County,11,464,221,243
Nebraska,Pierce County,12,590,300,290
Nebraska,Pierce County,13,485,256,229
Nebraska,Pierce County,14,405,207,198
Nebraska,Pierce County,15,309,152,157
Nebraska,Pierce County,16,255,120,135
Nebraska,Pierce County,17,184,77,107
Nebraska,Pierce County,18,225,95,130
Nebraska,Platte County,0,33363,16904,16459
Nebraska,Platte County,1,2444,1254,1190
Nebraska,Platte County,2,2424,1244,1180
Nebraska,Platte County,3,2423,1274,1149
Nebraska,Platte County,4,2210,1137,1073
Nebraska,Platte County,5,1956,1062,894
Nebraska,Platte County,6,2005,1061,944
Nebraska,Platte County,7,2018,1074,944
Nebraska,Platte County,8,2070,1071,999
Nebraska,Platte County,9,1832,918,914
Nebraska,Platte County,10,1752,908,844
Nebraska,Platte County,11,1945,1003,942
Nebraska,Platte County,12,2309,1153,1156
Nebraska,Platte County,13,2248,1123,1125
Nebraska,Platte County,14,1766,910,856
Nebraska,Platte County,15,1300,617,683
Nebraska,Platte County,16,993,426,567
Nebraska,Platte County,17,764,342,422
Nebraska,Platte County,18,904,327,577
Nebraska,Polk County,0,5278,2605,2673
Nebraska,Polk County,1,261,136,125
Nebraska,Polk County,2,322,150,172
Nebraska,Polk County,3,385,190,195
Nebraska,Polk County,4,356,193,163
Nebraska,Polk County,5,262,113,149
Nebraska,Polk County,6,243,124,119
Nebraska,Polk County,7,226,115,111
Nebraska,Polk County,8,265,121,144
Nebraska,Polk County,9,289,142,147
Nebraska,Polk County,10,328,167,161
Nebraska,Polk County,11,343,197,146
Nebraska,Polk County,12,379,199,180
Nebraska,Polk County,13,411,196,215
Nebraska,Polk County,14,398,205,193
Nebraska,Polk County,15,268,134,134
Nebraska,Polk County,16,187,82,105
Nebraska,Polk County,17,142,67,75
Nebraska,Polk County,18,213,74,139
Nebraska,Red Willow County,0,10726,5337,5389
Nebraska,Red Willow County,1,636,324,312
Nebraska,Red Willow County,2,646,340,306
Nebraska,Red Willow County,3,650,307,343
Nebraska,Red Willow County,4,756,412,344
Nebraska,Red Willow County,5,668,367,301
Nebraska,Red Willow County,6,617,325,292
Nebraska,Red Willow County,7,569,280,289
Nebraska,Red Willow County,8,664,344,320
Nebraska,Red Willow County,9,517,244,273
Nebraska,Red Willow County,10,581,296,285
Nebraska,Red Willow County,11,579,310,269
Nebraska,Red Willow County,12,833,401,432
Nebraska,Red Willow County,13,779,375,404
Nebraska,Red Willow County,14,696,348,348
Nebraska,Red Willow County,15,419,212,207
Nebraska,Red Willow County,16,394,176,218
Nebraska,Red Willow County,17,341,132,209
Nebraska,Red Willow County,18,381,144,237
Nebraska,Richardson County,0,7937,3990,3947
Nebraska,Richardson County,1,453,244,209
Nebraska,Richardson County,2,463,233,230
Nebraska,Richardson County,3,462,247,215
Nebraska,Richardson County,4,471,264,207
Nebraska,Richardson County,5,370,180,190
Nebraska,Richardson County,6,355,189,166
Nebraska,Richardson County,7,417,209,208
Nebraska,Richardson County,8,408,201,207
Nebraska,Richardson County,9,363,204,159
Nebraska,Richardson County,10,424,199,225
Nebraska,Richardson County,11,504,257,247
Nebraska,Richardson County,12,654,332,322
Nebraska,Richardson County,13,635,319,316
Nebraska,Richardson County,14,572,289,283
Nebraska,Richardson County,15,429,201,228
Nebraska,Richardson County,16,319,158,161
Nebraska,Richardson County,17,273,125,148
Nebraska,Richardson County,18,365,139,226
Nebraska,Rock County,0,1360,685,675
Nebraska,Rock County,1,81,36,45
Nebraska,Rock County,2,65,39,26
Nebraska,Rock County,3,90,53,37
Nebraska,Rock County,4,56,30,26
Nebraska,Rock County,5,62,31,31
Nebraska,Rock County,6,48,26,22
Nebraska,Rock County,7,76,43,33
Nebraska,Rock County,8,74,40,34
Nebraska,Rock County,9,68,34,34
Nebraska,Rock County,10,55,24,31
Nebraska,Rock County,11,45,23,22
Nebraska,Rock County,12,122,58,64
Nebraska,Rock County,13,155,84,71
Nebraska,Rock County,14,133,66,67
Nebraska,Rock County,15,71,39,32
Nebraska,Rock County,16,53,27,26
Nebraska,Rock County,17,43,17,26
Nebraska,Rock County,18,63,15,48
Nebraska,Saline County,0,14350,7344,7006
Nebraska,Saline County,1,962,493,469
Nebraska,Saline County,2,1050,520,530
Nebraska,Saline County,3,1047,557,490
Nebraska,Saline County,4,1195,601,594
Nebraska,Saline County,5,1188,651,537
Nebraska,Saline County,6,760,407,353
Nebraska,Saline County,7,850,486,364
Nebraska,Saline County,8,854,445,409
Nebraska,Saline County,9,826,409,417
Nebraska,Saline County,10,920,473,447
Nebraska,Saline County,11,821,427,394
Nebraska,Saline County,12,920,484,436
Nebraska,Saline County,13,802,401,401
Nebraska,Saline County,14,652,328,324
Nebraska,Saline County,15,520,248,272
Nebraska,Saline County,16,367,175,192
Nebraska,Saline County,17,273,125,148
Nebraska,Saline County,18,343,114,229
Nebraska,Sarpy County,0,184459,92307,92152
Nebraska,Sarpy County,1,13311,6768,6543
Nebraska,Sarpy County,2,14427,7454,6973
Nebraska,Sarpy County,3,14450,7380,7070
Nebraska,Sarpy County,4,12549,6436,6113
Nebraska,Sarpy County,5,11474,6120,5354
Nebraska,Sarpy County,6,12869,6732,6137
Nebraska,Sarpy County,7,13684,6872,6812
Nebraska,Sarpy County,8,14279,7151,7128
Nebraska,Sarpy County,9,12122,6085,6037
Nebraska,Sarpy County,10,11792,5939,5853
Nebraska,Sarpy County,11,11121,5540,5581
Nebraska,Sarpy County,12,11268,5545,5723
Nebraska,Sarpy County,13,9436,4635,4801
Nebraska,Sarpy County,14,7459,3464,3995
Nebraska,Sarpy County,15,5582,2641,2941
Nebraska,Sarpy County,16,3661,1603,2058
Nebraska,Sarpy County,17,2514,1082,1432
Nebraska,Sarpy County,18,2461,860,1601
Nebraska,Saunders County,0,21303,10772,10531
Nebraska,Saunders County,1,1327,657,670
Nebraska,Saunders County,2,1434,738,696
Nebraska,Saunders County,3,1525,815,710
Nebraska,Saunders County,4,1347,740,607
Nebraska,Saunders County,5,1057,524,533
Nebraska,Saunders County,6,1114,570,544
Nebraska,Saunders County,7,1200,615,585
Nebraska,Saunders County,8,1304,653,651
Nebraska,Saunders County,9,1127,568,559
Nebraska,Saunders County,10,1196,599,597
Nebraska,Saunders County,11,1497,772,725
Nebraska,Saunders County,12,1749,871,878
Nebraska,Saunders County,13,1434,736,698
Nebraska,Saunders County,14,1305,668,637
Nebraska,Saunders County,15,985,519,466
Nebraska,Saunders County,16,672,329,343
Nebraska,Saunders County,17,534,225,309
Nebraska,Saunders County,18,496,173,323
Nebraska,Scotts Bluff County,0,35989,17515,18474
Nebraska,Scotts Bluff County,1,2448,1256,1192
Nebraska,Scotts Bluff County,2,2488,1291,1197
Nebraska,Scotts Bluff County,3,2571,1287,1284
Nebraska,Scotts Bluff County,4,2388,1218,1170
Nebraska,Scotts Bluff County,5,2037,1052,985
Nebraska,Scotts Bluff County,6,2233,1135,1098
Nebraska,Scotts Bluff County,7,2039,998,1041
Nebraska,Scotts Bluff County,8,2156,1054,1102
Nebraska,Scotts Bluff County,9,2048,1061,987
Nebraska,Scotts Bluff County,10,1946,924,1022
Nebraska,Scotts Bluff County,11,1915,943,972
Nebraska,Scotts Bluff County,12,2400,1187,1213
Nebraska,Scotts Bluff County,13,2471,1168,1303
Nebraska,Scotts Bluff County,14,2144,1008,1136
Nebraska,Scotts Bluff County,15,1576,719,857
Nebraska,Scotts Bluff County,16,1115,474,641
Nebraska,Scotts Bluff County,17,885,365,520
Nebraska,Scotts Bluff County,18,1129,375,754
Nebraska,Seward County,0,17318,8857,8461
Nebraska,Seward County,1,1003,536,467
Nebraska,Seward County,2,1188,606,582
Nebraska,Seward County,3,1196,630,566
Nebraska,Seward County,4,1544,831,713
Nebraska,Seward County,5,1439,763,676
Nebraska,Seward County,6,846,458,388
Nebraska,Seward County,7,996,528,468
Nebraska,Seward County,8,1061,523,538
Nebraska,Seward County,9,891,471,420
Nebraska,Seward County,10,953,492,461
Nebraska,Seward County,11,1021,525,496
Nebraska,Seward County,12,1171,578,593
Nebraska,Seward County,13,1093,566,527
Nebraska,Seward County,14,887,440,447
Nebraska,Seward County,15,726,365,361
Nebraska,Seward County,16,469,231,238
Nebraska,Seward County,17,404,169,235
Nebraska,Seward County,18,430,145,285
Nebraska,Sheridan County,0,5190,2546,2644
Nebraska,Sheridan County,1,333,173,160
Nebraska,Sheridan County,2,291,143,148
Nebraska,Sheridan County,3,328,182,146
Nebraska,Sheridan County,4,302,160,142
Nebraska,Sheridan County,5,235,113,122
Nebraska,Sheridan County,6,197,107,90
Nebraska,Sheridan County,7,244,112,132
Nebraska,Sheridan County,8,283,138,145
Nebraska,Sheridan County,9,267,144,123
Nebraska,Sheridan County,10,285,144,141
Nebraska,Sheridan County,11,282,156,126
Nebraska,Sheridan County,12,344,172,172
Nebraska,Sheridan County,13,406,184,222
Nebraska,Sheridan County,14,435,222,213
Nebraska,Sheridan County,15,307,145,162
Nebraska,Sheridan County,16,232,98,134
Nebraska,Sheridan County,17,177,67,110
Nebraska,Sheridan County,18,242,86,156
Nebraska,Sherman County,0,3038,1492,1546
Nebraska,Sherman County,1,162,81,81
Nebraska,Sherman County,2,169,94,75
Nebraska,Sherman County,3,196,92,104
Nebraska,Sherman County,4,175,81,94
Nebraska,Sherman County,5,135,70,65
Nebraska,Sherman County,6,137,75,62
Nebraska,Sherman County,7,122,54,68
Nebraska,Sherman County,8,133,73,60
Nebraska,Sherman County,9,139,80,59
Nebraska,Sherman County,10,161,78,83
Nebraska,Sherman County,11,194,91,103
Nebraska,Sherman County,12,231,118,113
Nebraska,Sherman County,13,261,129,132
Nebraska,Sherman County,14,230,121,109
Nebraska,Sherman County,15,193,89,104
Nebraska,Sherman County,16,138,66,72
Nebraska,Sherman County,17,130,49,81
Nebraska,Sherman County,18,132,51,81
Nebraska,Sioux County,0,1187,609,578
Nebraska,Sioux County,1,45,19,26
Nebraska,Sioux County,2,54,29,25
Nebraska,Sioux County,3,70,37,33
Nebraska,Sioux County,4,74,37,37
Nebraska,Sioux County,5,65,36,29
Nebraska,Sioux County,6,39,18,21
Nebraska,Sioux County,7,45,20,25
Nebraska,Sioux County,8,61,31,30
Nebraska,Sioux County,9,60,31,29
Nebraska,Sioux County,10,50,26,24
Nebraska,Sioux County,11,65,27,38
Nebraska,Sioux County,12,110,63,47
Nebraska,Sioux County,13,110,61,49
Nebraska,Sioux County,14,109,61,48
Nebraska,Sioux County,15,63,30,33
Nebraska,Sioux County,16,57,24,33
Nebraska,Sioux County,17,48,22,26
Nebraska,Sioux County,18,62,37,25
Nebraska,Stanton County,0,5970,3026,2944
Nebraska,Stanton County,1,380,189,191
Nebraska,Stanton County,2,411,236,175
Nebraska,Stanton County,3,424,214,210
Nebraska,Stanton County,4,398,200,198
Nebraska,Stanton County,5,327,158,169
Nebraska,Stanton County,6,325,173,152
Nebraska,Stanton County,7,313,163,150
Nebraska,Stanton County,8,376,196,180
Nebraska,Stanton County,9,325,164,161
Nebraska,Stanton County,10,333,173,160
Nebraska,Stanton County,11,374,203,171
Nebraska,Stanton County,12,471,230,241
Nebraska,Stanton County,13,447,232,215
Nebraska,Stanton County,14,353,166,187
Nebraska,Stanton County,15,236,120,116
Nebraska,Stanton County,16,176,79,97
Nebraska,Stanton County,17,155,61,94
Nebraska,Stanton County,18,146,69,77
Nebraska,Thayer County,0,5039,2507,2532
Nebraska,Thayer County,1,314,164,150
Nebraska,Thayer County,2,308,146,162
Nebraska,Thayer County,3,346,163,183
Nebraska,Thayer County,4,289,150,139
Nebraska,Thayer County,5,219,114,105
Nebraska,Thayer County,6,263,148,115
Nebraska,Thayer County,7,229,117,112
Nebraska,Thayer County,8,241,124,117
Nebraska,Thayer County,9,248,145,103
Nebraska,Thayer County,10,259,132,127
Nebraska,Thayer County,11,297,133,164
Nebraska,Thayer County,12,361,192,169
Nebraska,Thayer County,13,392,202,190
Nebraska,Thayer County,14,370,180,190
Nebraska,Thayer County,15,273,134,139
Nebraska,Thayer County,16,219,98,121
Nebraska,Thayer County,17,168,72,96
Nebraska,Thayer County,18,243,93,150
Nebraska,Thomas County,0,720,370,350
Nebraska,Thomas County,1,43,26,17
Nebraska,Thomas County,2,50,26,24
Nebraska,Thomas County,3,48,24,24
Nebraska,Thomas County,4,42,27,15
Nebraska,Thomas County,5,26,14,12
Nebraska,Thomas County,6,33,17,16
Nebraska,Thomas County,7,44,24,20
Nebraska,Thomas County,8,28,15,13
Nebraska,Thomas County,9,39,19,20
Nebraska,Thomas County,10,43,24,19
Nebraska,Thomas County,11,39,19,20
Nebraska,Thomas County,12,36,16,20
Nebraska,Thomas County,13,62,30,32
Nebraska,Thomas County,14,71,39,32
Nebraska,Thomas County,15,41,15,26
Nebraska,Thomas County,16,33,17,16
Nebraska,Thomas County,17,21,10,11
Nebraska,Thomas County,18,21,8,13
Nebraska,Thurston County,0,7303,3605,3698
Nebraska,Thurston County,1,782,393,389
Nebraska,Thurston County,2,724,349,375
Nebraska,Thurston County,3,733,398,335
Nebraska,Thurston County,4,640,324,316
Nebraska,Thurston County,5,492,245,247
Nebraska,Thurston County,6,528,273,255
Nebraska,Thurston County,7,408,218,190
Nebraska,Thurston County,8,373,184,189
Nebraska,Thurston County,9,315,146,169
Nebraska,Thurston County,10,327,147,180
Nebraska,Thurston County,11,348,157,191
Nebraska,Thurston County,12,408,197,211
Nebraska,Thurston County,13,360,188,172
Nebraska,Thurston County,14,276,141,135
Nebraska,Thurston County,15,190,76,114
Nebraska,Thurston County,16,152,74,78
Nebraska,Thurston County,17,113,43,70
Nebraska,Thurston County,18,134,52,82
Nebraska,Valley County,0,4190,2079,2111
Nebraska,Valley County,1,257,127,130
Nebraska,Valley County,2,280,141,139
Nebraska,Valley County,3,256,131,125
Nebraska,Valley County,4,245,124,121
Nebraska,Valley County,5,203,94,109
Nebraska,Valley County,6,196,100,96
Nebraska,Valley County,7,212,101,111
Nebraska,Valley County,8,246,127,119
Nebraska,Valley County,9,184,93,91
Nebraska,Valley County,10,221,117,104
Nebraska,Valley County,11,262,144,118
Nebraska,Valley County,12,282,133,149
Nebraska,Valley County,13,285,148,137
Nebraska,Valley County,14,279,137,142
Nebraska,Valley County,15,271,131,140
Nebraska,Valley County,16,198,97,101
Nebraska,Valley County,17,146,66,80
Nebraska,Valley County,18,167,68,99
Nebraska,Washington County,0,20667,10357,10310
Nebraska,Washington County,1,1217,627,590
Nebraska,Washington County,2,1380,707,673
Nebraska,Washington County,3,1467,760,707
Nebraska,Washington County,4,1432,761,671
Nebraska,Washington County,5,1038,520,518
Nebraska,Washington County,6,957,484,473
Nebraska,Washington County,7,1085,562,523
Nebraska,Washington County,8,1372,704,668
Nebraska,Washington County,9,1208,609,599
Nebraska,Washington County,10,1283,647,636
Nebraska,Washington County,11,1450,718,732
Nebraska,Washington County,12,1630,819,811
Nebraska,Washington County,13,1475,728,747
Nebraska,Washington County,14,1253,615,638
Nebraska,Washington County,15,955,499,456
Nebraska,Washington County,16,588,248,340
Nebraska,Washington County,17,419,189,230
Nebraska,Washington County,18,458,160,298
Nebraska,Wayne County,0,9403,4726,4677
Nebraska,Wayne County,1,511,245,266
Nebraska,Wayne County,2,529,306,223
Nebraska,Wayne County,3,548,281,267
Nebraska,Wayne County,4,942,445,497
Nebraska,Wayne County,5,1365,677,688
Nebraska,Wayne County,6,529,295,234
Nebraska,Wayne County,7,471,248,223
Nebraska,Wayne County,8,479,229,250
Nebraska,Wayne County,9,446,216,230
Nebraska,Wayne County,10,407,222,185
Nebraska,Wayne County,11,482,234,248
Nebraska,Wayne County,12,573,292,281
Nebraska,Wayne County,13,585,321,264
Nebraska,Wayne County,14,454,226,228
Nebraska,Wayne County,15,320,156,164
Nebraska,Wayne County,16,251,124,127
Nebraska,Wayne County,17,200,93,107
Nebraska,Wayne County,18,311,116,195
Nebraska,Webster County,0,3533,1758,1775
Nebraska,Webster County,1,169,102,67
Nebraska,Webster County,2,242,124,118
Nebraska,Webster County,3,230,106,124
Nebraska,Webster County,4,200,89,111
Nebraska,Webster County,5,188,103,85
Nebraska,Webster County,6,203,111,92
Nebraska,Webster County,7,147,71,76
Nebraska,Webster County,8,189,104,85
Nebraska,Webster County,9,172,96,76
Nebraska,Webster County,10,201,94,107
Nebraska,Webster County,11,212,104,108
Nebraska,Webster County,12,292,155,137
Nebraska,Webster County,13,278,142,136
Nebraska,Webster County,14,229,117,112
Nebraska,Webster County,15,180,89,91
Nebraska,Webster County,16,149,67,82
Nebraska,Webster County,17,125,41,84
Nebraska,Webster County,18,127,43,84
Nebraska,Wheeler County,0,805,411,394
Nebraska,Wheeler County,1,47,15,32
Nebraska,Wheeler County,2,48,28,20
Nebraska,Wheeler County,3,43,30,13
Nebraska,Wheeler County,4,33,17,16
Nebraska,Wheeler County,5,42,17,25
Nebraska,Wheeler County,6,32,23,9
Nebraska,Wheeler County,7,38,17,21
Nebraska,Wheeler County,8,33,17,16
Nebraska,Wheeler County,9,41,24,17
Nebraska,Wheeler County,10,37,20,17
Nebraska,Wheeler County,11,47,25,22
Nebraska,Wheeler County,12,67,31,36
Nebraska,Wheeler County,13,89,55,34
Nebraska,Wheeler County,14,57,24,33
Nebraska,Wheeler County,15,46,28,18
Nebraska,Wheeler County,16,37,18,19
Nebraska,Wheeler County,17,36,14,22
Nebraska,Wheeler County,18,32,8,24
Nebraska,York County,0,13772,6742,7030
Nebraska,York County,1,902,460,442
Nebraska,York County,2,888,461,427
Nebraska,York County,3,938,472,466
Nebraska,York County,4,894,466,428
Nebraska,York County,5,862,456,406
Nebraska,York County,6,842,396,446
Nebraska,York County,7,807,393,414
Nebraska,York County,8,789,391,398
Nebraska,York County,9,700,350,350
Nebraska,York County,10,701,348,353
Nebraska,York County,11,750,374,376
Nebraska,York County,12,961,467,494
Nebraska,York County,13,938,463,475
Nebraska,York County,14,831,396,435
Nebraska,York County,15,652,307,345
Nebraska,York County,16,471,203,268
Nebraska,York County,17,394,162,232
Nebraska,York County,18,452,177,275
Nevada,Churchill County,0,24440,12410,12030
Nevada,Churchill County,1,1589,816,773
Nevada,Churchill County,2,1509,800,709
Nevada,Churchill County,3,1534,781,753
Nevada,Churchill County,4,1467,756,711
Nevada,Churchill County,5,1438,764,674
Nevada,Churchill County,6,1666,897,769
Nevada,Churchill County,7,1658,866,792
Nevada,Churchill County,8,1441,764,677
Nevada,Churchill County,9,1205,606,599
Nevada,Churchill County,10,1376,674,702
Nevada,Churchill County,11,1519,779,740
Nevada,Churchill County,12,1754,872,882
Nevada,Churchill County,13,1656,808,848
Nevada,Churchill County,14,1492,731,761
Nevada,Churchill County,15,1284,634,650
Nevada,Churchill County,16,914,450,464
Nevada,Churchill County,17,523,249,274
Nevada,Churchill County,18,415,163,252
Nevada,Clark County,0,2231647,1112805,1118842
Nevada,Clark County,1,139917,71558,68359
Nevada,Clark County,2,144447,73879,70568
Nevada,Clark County,3,147719,75133,72586
Nevada,Clark County,4,134845,69293,65552
Nevada,Clark County,5,134281,68186,66095
Nevada,Clark County,6,169721,85371,84350
Nevada,Clark County,7,163189,82683,80506
Nevada,Clark County,8,160607,80608,79999
Nevada,Clark County,9,147764,73848,73916
Nevada,Clark County,10,153294,77039,76255
Nevada,Clark County,11,143013,72529,70484
Nevada,Clark County,12,137962,68919,69043
Nevada,Clark County,13,126196,60797,65399
Nevada,Clark County,14,110631,52040,58591
Nevada,Clark County,15,91366,43243,48123
Nevada,Clark County,16,61054,28757,32297
Nevada,Clark County,17,35658,16541,19117
Nevada,Clark County,18,29983,12381,17602
Nevada,Douglas County,0,48467,24356,24111
Nevada,Douglas County,1,1641,833,808
Nevada,Douglas County,2,2188,1150,1038
Nevada,Douglas County,3,2500,1327,1173
Nevada,Douglas County,4,2436,1283,1153
Nevada,Douglas County,5,1923,1029,894
Nevada,Douglas County,6,2269,1151,1118
Nevada,Douglas County,7,2352,1254,1098
Nevada,Douglas County,8,2550,1300,1250
Nevada,Douglas County,9,2273,1167,1106
Nevada,Douglas County,10,2618,1295,1323
Nevada,Douglas County,11,2994,1408,1586
Nevada,Douglas County,12,4183,1964,2219
Nevada,Douglas County,13,4732,2295,2437
Nevada,Douglas County,14,4390,2179,2211
Nevada,Douglas County,15,3931,2023,1908
Nevada,Douglas County,16,2623,1334,1289
Nevada,Douglas County,17,1533,789,744
Nevada,Douglas County,18,1331,575,756
Nevada,Elko County,0,52460,27242,25218
Nevada,Elko County,1,3861,2007,1854
Nevada,Elko County,2,3920,2002,1918
Nevada,Elko County,3,4159,2113,2046
Nevada,Elko County,4,3605,1938,1667
Nevada,Elko County,5,3198,1707,1491
Nevada,Elko County,6,3993,2075,1918
Nevada,Elko County,7,3929,2071,1858
Nevada,Elko County,8,3645,1956,1689
Nevada,Elko County,9,3145,1640,1505
Nevada,Elko County,10,3260,1638,1622
Nevada,Elko County,11,3294,1718,1576
Nevada,Elko County,12,3461,1821,1640
Nevada,Elko County,13,3047,1593,1454
Nevada,Elko County,14,2176,1138,1038
Nevada,Elko County,15,1536,773,763
Nevada,Elko County,16,1058,545,513
Nevada,Elko County,17,564,265,299
Nevada,Elko County,18,609,242,367
Nevada,Esmeralda County,0,826,456,370
Nevada,Esmeralda County,1,27,10,17
Nevada,Esmeralda County,2,38,21,17
Nevada,Esmeralda County,3,42,23,19
Nevada,Esmeralda County,4,27,17,10
Nevada,Esmeralda County,5,23,16,7
Nevada,Esmeralda County,6,35,19,16
Nevada,Esmeralda County,7,44,22,22
Nevada,Esmeralda County,8,46,21,25
Nevada,Esmeralda County,9,41,25,16
Nevada,Esmeralda County,10,45,27,18
Nevada,Esmeralda County,11,32,17,15
Nevada,Esmeralda County,12,71,38,33
Nevada,Esmeralda County,13,51,28,23
Nevada,Esmeralda County,14,84,47,37
Nevada,Esmeralda County,15,89,45,44
Nevada,Esmeralda County,16,54,32,22
Nevada,Esmeralda County,17,35,23,12
Nevada,Esmeralda County,18,42,25,17
Nevada,Eureka County,0,2003,1058,945
Nevada,Eureka County,1,100,41,59
Nevada,Eureka County,2,145,79,66
Nevada,Eureka County,3,169,92,77
Nevada,Eureka County,4,102,53,49
Nevada,Eureka County,5,82,38,44
Nevada,Eureka County,6,89,49,40
Nevada,Eureka County,7,122,57,65
Nevada,Eureka County,8,114,65,49
Nevada,Eureka County,9,127,68,59
Nevada,Eureka County,10,145,84,61
Nevada,Eureka County,11,142,74,68
Nevada,Eureka County,12,192,106,86
Nevada,Eureka County,13,148,79,69
Nevada,Eureka County,14,115,66,49
Nevada,Eureka County,15,87,39,48
Nevada,Eureka County,16,63,39,24
Nevada,Eureka County,17,31,15,16
Nevada,Eureka County,18,30,14,16
Nevada,Humboldt County,0,16786,8749,8037
Nevada,Humboldt County,1,1195,582,613
Nevada,Humboldt County,2,1348,691,657
Nevada,Humboldt County,3,1274,641,633
Nevada,Humboldt County,4,1100,580,520
Nevada,Humboldt County,5,909,491,418
Nevada,Humboldt County,6,1129,594,535
Nevada,Humboldt County,7,1189,630,559
Nevada,Humboldt County,8,1093,576,517
Nevada,Humboldt County,9,989,546,443
Nevada,Humboldt County,10,987,525,462
Nevada,Humboldt County,11,1036,536,500
Nevada,Humboldt County,12,1133,599,534
Nevada,Humboldt County,13,1110,587,523
Nevada,Humboldt County,14,852,465,387
Nevada,Humboldt County,15,605,327,278
Nevada,Humboldt County,16,399,186,213
Nevada,Humboldt County,17,236,108,128
Nevada,Humboldt County,18,202,85,117
Nevada,Lander County,0,5575,2855,2720
Nevada,Lander County,1,430,215,215
Nevada,Lander County,2,421,223,198
Nevada,Lander County,3,418,198,220
Nevada,Lander County,4,331,166,165
Nevada,Lander County,5,267,151,116
Nevada,Lander County,6,366,185,181
Nevada,Lander County,7,397,188,209
Nevada,Lander County,8,356,187,169
Nevada,Lander County,9,291,169,122
Nevada,Lander County,10,325,167,158
Nevada,Lander County,11,392,202,190
Nevada,Lander County,12,376,207,169
Nevada,Lander County,13,323,186,137
Nevada,Lander County,14,274,126,148
Nevada,Lander County,15,236,124,112
Nevada,Lander County,16,180,86,94
Nevada,Lander County,17,105,48,57
Nevada,Lander County,18,87,27,60
Nevada,Lincoln County,0,5201,2791,2410
Nevada,Lincoln County,1,215,114,101
Nevada,Lincoln County,2,269,143,126
Nevada,Lincoln County,3,344,179,165
Nevada,Lincoln County,4,351,207,144
Nevada,Lincoln County,5,293,176,117
Nevada,Lincoln County,6,298,174,124
Nevada,Lincoln County,7,278,156,122
Nevada,Lincoln County,8,318,183,135
Nevada,Lincoln County,9,282,152,130
Nevada,Lincoln County,10,308,162,146
Nevada,Lincoln County,11,287,157,130
Nevada,Lincoln County,12,362,186,176
Nevada,Lincoln County,13,308,145,163
Nevada,Lincoln County,14,429,231,198
Nevada,Lincoln County,15,324,168,156
Nevada,Lincoln County,16,255,123,132
Nevada,Lincoln County,17,160,85,75
Nevada,Lincoln County,18,120,50,70
Nevada,Lyon County,0,55808,28540,27268
Nevada,Lyon County,1,3053,1574,1479
Nevada,Lyon County,2,3317,1727,1590
Nevada,Lyon County,3,3446,1762,1684
Nevada,Lyon County,4,3220,1701,1519
Nevada,Lyon County,5,2576,1302,1274
Nevada,Lyon County,6,3556,1869,1687
Nevada,Lyon County,7,3539,1867,1672
Nevada,Lyon County,8,3423,1765,1658
Nevada,Lyon County,9,2940,1495,1445
Nevada,Lyon County,10,3210,1637,1573
Nevada,Lyon County,11,3472,1778,1694
Nevada,Lyon County,12,4076,2116,1960
Nevada,Lyon County,13,4167,2082,2085
Nevada,Lyon County,14,4047,1959,2088
Nevada,Lyon County,15,3431,1746,1685
Nevada,Lyon County,16,2268,1177,1091
Nevada,Lyon County,17,1234,613,621
Nevada,Lyon County,18,833,370,463
Nevada,Mineral County,0,4514,2235,2279
Nevada,Mineral County,1,252,148,104
Nevada,Mineral County,2,260,114,146
Nevada,Mineral County,3,244,133,111
Nevada,Mineral County,4,210,110,100
Nevada,Mineral County,5,211,96,115
Nevada,Mineral County,6,266,134,132
Nevada,Mineral County,7,283,154,129
Nevada,Mineral County,8,260,138,122
Nevada,Mineral County,9,191,103,88
Nevada,Mineral County,10,214,97,117
Nevada,Mineral County,11,252,125,127
Nevada,Mineral County,12,368,176,192
Nevada,Mineral County,13,389,178,211
Nevada,Mineral County,14,320,170,150
Nevada,Mineral County,15,290,141,149
Nevada,Mineral County,16,222,95,127
Nevada,Mineral County,17,159,71,88
Nevada,Mineral County,18,123,52,71
Nevada,Nye County,0,45346,23201,22145
Nevada,Nye County,1,1992,1035,957
Nevada,Nye County,2,2039,1002,1037
Nevada,Nye County,3,2212,1129,1083
Nevada,Nye County,4,2134,1109,1025
Nevada,Nye County,5,2101,1219,882
Nevada,Nye County,6,2287,1308,979
Nevada,Nye County,7,1985,1054,931
Nevada,Nye County,8,1994,998,996
Nevada,Nye County,9,1994,1027,967
Nevada,Nye County,10,2292,1124,1168
Nevada,Nye County,11,2855,1413,1442
Nevada,Nye County,12,3635,1784,1851
Nevada,Nye County,13,4192,2033,2159
Nevada,Nye County,14,4146,2054,2092
Nevada,Nye County,15,3918,2008,1910
Nevada,Nye County,16,2835,1534,1301
Nevada,Nye County,17,1651,873,778
Nevada,Nye County,18,1084,497,587
Nevada,Pershing County,0,6666,4294,2372
Nevada,Pershing County,1,267,125,142
Nevada,Pershing County,2,322,172,150
Nevada,Pershing County,3,316,158,158
Nevada,Pershing County,4,311,178,133
Nevada,Pershing County,5,399,286,113
Nevada,Pershing County,6,519,366,153
Nevada,Pershing County,7,488,362,126
Nevada,Pershing County,8,478,354,124
Nevada,Pershing County,9,500,386,114
Nevada,Pershing County,10,556,398,158
Nevada,Pershing County,11,514,362,152
Nevada,Pershing County,12,495,310,185
Nevada,Pershing County,13,438,261,177
Nevada,Pershing County,14,333,179,154
Nevada,Pershing County,15,286,153,133
Nevada,Pershing County,16,246,153,93
Nevada,Pershing County,17,115,55,60
Nevada,Pershing County,18,83,36,47
Nevada,Storey County,0,4029,2061,1968
Nevada,Storey County,1,98,48,50
Nevada,Storey County,2,116,59,57
Nevada,Storey County,3,176,81,95
Nevada,Storey County,4,152,73,79
Nevada,Storey County,5,136,79,57
Nevada,Storey County,6,156,87,69
Nevada,Storey County,7,169,91,78
Nevada,Storey County,8,172,84,88
Nevada,Storey County,9,187,98,89
Nevada,Storey County,10,252,129,123
Nevada,Storey County,11,267,127,140
Nevada,Storey County,12,422,217,205
Nevada,Storey County,13,458,226,232
Nevada,Storey County,14,438,212,226
Nevada,Storey County,15,412,219,193
Nevada,Storey County,16,223,137,86
Nevada,Storey County,17,99,57,42
Nevada,Storey County,18,96,37,59
Nevada,Washoe County,0,465735,234560,231175
Nevada,Washoe County,1,27705,14098,13607
Nevada,Washoe County,2,27739,14140,13599
Nevada,Washoe County,3,28722,14779,13943
Nevada,Washoe County,4,27268,14167,13101
Nevada,Washoe County,5,30484,15535,14949
Nevada,Washoe County,6,36670,18742,17928
Nevada,Washoe County,7,34000,17760,16240
Nevada,Washoe County,8,30489,15422,15067
Nevada,Washoe County,9,26787,13566,13221
Nevada,Washoe County,10,28834,14778,14056
Nevada,Washoe County,11,29420,14791,14629
Nevada,Washoe County,12,31098,15493,15605
Nevada,Washoe County,13,30358,14844,15514
Nevada,Washoe County,14,26634,12902,13732
Nevada,Washoe County,15,21551,10611,10940
Nevada,Washoe County,16,13408,6633,6775
Nevada,Washoe County,17,7698,3526,4172
Nevada,Washoe County,18,6870,2773,4097
Nevada,White Pine County,0,9475,5503,3972
Nevada,White Pine County,1,503,232,271
Nevada,White Pine County,2,530,280,250
Nevada,White Pine County,3,507,257,250
Nevada,White Pine County,4,512,258,254
Nevada,White Pine County,5,540,368,172
Nevada,White Pine County,6,689,460,229
Nevada,White Pine County,7,749,504,245
Nevada,White Pine County,8,679,448,231
Nevada,White Pine County,9,596,387,209
Nevada,White Pine County,10,549,337,212
Nevada,White Pine County,11,587,346,241
Nevada,White Pine County,12,714,408,306
Nevada,White Pine County,13,618,339,279
Nevada,White Pine County,14,543,312,231
Nevada,White Pine County,15,424,210,214
Nevada,White Pine County,16,313,157,156
Nevada,White Pine County,17,224,118,106
Nevada,White Pine County,18,198,82,116
Nevada,Carson City,0,55414,28439,26975
Nevada,Carson City,1,3150,1598,1552
Nevada,Carson City,2,2999,1519,1480
Nevada,Carson City,3,3240,1679,1561
Nevada,Carson City,4,3027,1518,1509
Nevada,Carson City,5,3203,1758,1445
Nevada,Carson City,6,3755,2069,1686
Nevada,Carson City,7,3537,2013,1524
Nevada,Carson City,8,3173,1703,1470
Nevada,Carson City,9,3003,1650,1353
Nevada,Carson City,10,3360,1848,1512
Nevada,Carson City,11,3638,1922,1716
Nevada,Carson City,12,3979,1995,1984
Nevada,Carson City,13,4089,2027,2062
Nevada,Carson City,14,3523,1683,1840
Nevada,Carson City,15,3055,1452,1603
Nevada,Carson City,16,2097,979,1118
Nevada,Carson City,17,1330,554,776
Nevada,Carson City,18,1256,472,784
New Hampshire,Belknap County,0,61022,30141,30881
New Hampshire,Belknap County,1,2707,1386,1321
New Hampshire,Belknap County,2,3019,1520,1499
New Hampshire,Belknap County,3,3421,1728,1693
New Hampshire,Belknap County,4,3242,1732,1510
New Hampshire,Belknap County,5,3059,1557,1502
New Hampshire,Belknap County,6,3319,1732,1587
New Hampshire,Belknap County,7,3204,1617,1587
New Hampshire,Belknap County,8,3388,1631,1757
New Hampshire,Belknap County,9,3265,1636,1629
New Hampshire,Belknap County,10,3771,1849,1922
New Hampshire,Belknap County,11,4421,2136,2285
New Hampshire,Belknap County,12,5386,2651,2735
New Hampshire,Belknap County,13,5315,2562,2753
New Hampshire,Belknap County,14,4504,2201,2303
New Hampshire,Belknap County,15,3645,1802,1843
New Hampshire,Belknap County,16,2320,1113,1207
New Hampshire,Belknap County,17,1383,629,754
New Hampshire,Belknap County,18,1653,659,994
New Hampshire,Carroll County,0,48779,24201,24578
New Hampshire,Carroll County,1,1813,966,847
New Hampshire,Carroll County,2,2079,1063,1016
New Hampshire,Carroll County,3,2308,1243,1065
New Hampshire,Carroll County,4,2281,1204,1077
New Hampshire,Carroll County,5,2153,1131,1022
New Hampshire,Carroll County,6,2235,1151,1084
New Hampshire,Carroll County,7,2208,1091,1117
New Hampshire,Carroll County,8,2303,1142,1161
New Hampshire,Carroll County,9,2164,1032,1132
New Hampshire,Carroll County,10,2908,1451,1457
New Hampshire,Carroll County,11,3479,1675,1804
New Hampshire,Carroll County,12,4376,2081,2295
New Hampshire,Carroll County,13,4860,2351,2509
New Hampshire,Carroll County,14,4600,2264,2336
New Hampshire,Carroll County,15,3726,1885,1841
New Hampshire,Carroll County,16,2350,1206,1144
New Hampshire,Carroll County,17,1407,669,738
New Hampshire,Carroll County,18,1529,596,933
New Hampshire,Cheshire County,0,76493,37437,39056
New Hampshire,Cheshire County,1,3397,1697,1700
New Hampshire,Cheshire County,2,3877,1992,1885
New Hampshire,Cheshire County,3,3909,1987,1922
New Hampshire,Cheshire County,4,5603,2717,2886
New Hampshire,Cheshire County,5,5753,2884,2869
New Hampshire,Cheshire County,6,4581,2356,2225
New Hampshire,Cheshire County,7,4614,2320,2294
New Hampshire,Cheshire County,8,4246,2175,2071
New Hampshire,Cheshire County,9,3674,1755,1919
New Hampshire,Cheshire County,10,4465,2185,2280
New Hampshire,Cheshire County,11,5193,2614,2579
New Hampshire,Cheshire County,12,6030,2871,3159
New Hampshire,Cheshire County,13,5927,2900,3027
New Hampshire,Cheshire County,14,5156,2558,2598
New Hampshire,Cheshire County,15,3991,1906,2085
New Hampshire,Cheshire County,16,2636,1181,1455
New Hampshire,Cheshire County,17,1659,718,941
New Hampshire,Cheshire County,18,1782,621,1161
New Hampshire,Coos County,0,31589,16683,14906
New Hampshire,Coos County,1,1256,644,612
New Hampshire,Coos County,2,1312,658,654
New Hampshire,Coos County,3,1557,815,742
New Hampshire,Coos County,4,1560,833,727
New Hampshire,Coos County,5,1648,971,677
New Hampshire,Coos County,6,1815,1101,714
New Hampshire,Coos County,7,1674,972,702
New Hampshire,Coos County,8,1687,959,728
New Hampshire,Coos County,9,1729,939,790
New Hampshire,Coos County,10,2102,1165,937
New Hampshire,Coos County,11,2333,1263,1070
New Hampshire,Coos County,12,2639,1320,1319
New Hampshire,Coos County,13,2783,1454,1329
New Hampshire,Coos County,14,2524,1305,1219
New Hampshire,Coos County,15,1828,936,892
New Hampshire,Coos County,16,1294,627,667
New Hampshire,Coos County,17,856,375,481
New Hampshire,Coos County,18,992,346,646
New Hampshire,Grafton County,0,89786,44377,45409
New Hampshire,Grafton County,1,3664,1846,1818
New Hampshire,Grafton County,2,3894,2057,1837
New Hampshire,Grafton County,3,4295,2173,2122
New Hampshire,Grafton County,4,6773,3532,3241
New Hampshire,Grafton County,5,7685,3966,3719
New Hampshire,Grafton County,6,5636,2930,2706
New Hampshire,Grafton County,7,5347,2683,2664
New Hampshire,Grafton County,8,4758,2353,2405
New Hampshire,Grafton County,9,4373,2194,2179
New Hampshire,Grafton County,10,5115,2435,2680
New Hampshire,Grafton County,11,5739,2790,2949
New Hampshire,Grafton County,12,6860,3281,3579
New Hampshire,Grafton County,13,7081,3422,3659
New Hampshire,Grafton County,14,6053,2962,3091
New Hampshire,Grafton County,15,4801,2331,2470
New Hampshire,Grafton County,16,3314,1627,1687
New Hampshire,Grafton County,17,2005,926,1079
New Hampshire,Grafton County,18,2393,869,1524
New Hampshire,Hillsborough County,0,415247,206632,208615
New Hampshire,Hillsborough County,1,21458,11076,10382
New Hampshire,Hillsborough County,2,22833,11715,11118
New Hampshire,Hillsborough County,3,24561,12488,12073
New Hampshire,Hillsborough County,4,25253,12968,12285
New Hampshire,Hillsborough County,5,26227,13518,12709
New Hampshire,Hillsborough County,6,29134,15250,13884
New Hampshire,Hillsborough County,7,27860,14213,13647
New Hampshire,Hillsborough County,8,26172,13268,12904
New Hampshire,Hillsborough County,9,24510,12209,12301
New Hampshire,Hillsborough County,10,28556,14190,14366
New Hampshire,Hillsborough County,11,31351,15639,15712
New Hampshire,Hillsborough County,12,33486,16628,16858
New Hampshire,Hillsborough County,13,28498,14096,14402
New Hampshire,Hillsborough County,14,21747,10547,11200
New Hampshire,Hillsborough County,15,16956,7997,8959
New Hampshire,Hillsborough County,16,10853,4855,5998
New Hampshire,Hillsborough County,17,7314,3077,4237
New Hampshire,Hillsborough County,18,8478,2898,5580
New Hampshire,Merrimack County,0,151132,74440,76692
New Hampshire,Merrimack County,1,7167,3596,3571
New Hampshire,Merrimack County,2,7803,3945,3858
New Hampshire,Merrimack County,3,8528,4322,4206
New Hampshire,Merrimack County,4,9666,4881,4785
New Hampshire,Merrimack County,5,9609,4962,4647
New Hampshire,Merrimack County,6,9414,4960,4454
New Hampshire,Merrimack County,7,9206,4725,4481
New Hampshire,Merrimack County,8,9223,4642,4581
New Hampshire,Merrimack County,9,8508,4374,4134
New Hampshire,Merrimack County,10,9896,4929,4967
New Hampshire,Merrimack County,11,11117,5404,5713
New Hampshire,Merrimack County,12,12040,5898,6142
New Hampshire,Merrimack County,13,11389,5444,5945
New Hampshire,Merrimack County,14,9337,4501,4836
New Hampshire,Merrimack County,15,6843,3221,3622
New Hampshire,Merrimack County,16,4603,2145,2458
New Hampshire,Merrimack County,17,3064,1273,1791
New Hampshire,Merrimack County,18,3719,1218,2501
New Hampshire,Rockingham County,0,309176,153319,155857
New Hampshire,Rockingham County,1,14304,7456,6848
New Hampshire,Rockingham County,2,15713,8053,7660
New Hampshire,Rockingham County,3,18181,9289,8892
New Hampshire,Rockingham County,4,17874,9299,8575
New Hampshire,Rockingham County,5,17210,9014,8196
New Hampshire,Rockingham County,6,18107,9500,8607
New Hampshire,Rockingham County,7,18540,9315,9225
New Hampshire,Rockingham County,8,18052,9126,8926
New Hampshire,Rockingham County,9,17490,8526,8964
New Hampshire,Rockingham County,10,22235,10906,11329
New Hampshire,Rockingham County,11,24940,12264,12676
New Hampshire,Rockingham County,12,27190,13317,13873
New Hampshire,Rockingham County,13,23802,11764,12038
New Hampshire,Rockingham County,14,19202,9372,9830
New Hampshire,Rockingham County,15,14785,6966,7819
New Hampshire,Rockingham County,16,9280,4324,4956
New Hampshire,Rockingham County,17,5935,2602,3333
New Hampshire,Rockingham County,18,6336,2226,4110
New Hampshire,Strafford County,0,130090,63739,66351
New Hampshire,Strafford County,1,6217,3224,2993
New Hampshire,Strafford County,2,6681,3446,3235
New Hampshire,Strafford County,3,6934,3561,3373
New Hampshire,Strafford County,4,10561,4937,5624
New Hampshire,Strafford County,5,14216,6818,7398
New Hampshire,Strafford County,6,9122,4750,4372
New Hampshire,Strafford County,7,8148,4234,3914
New Hampshire,Strafford County,8,7633,3854,3779
New Hampshire,Strafford County,9,6756,3347,3409
New Hampshire,Strafford County,10,7969,3989,3980
New Hampshire,Strafford County,11,8630,4220,4410
New Hampshire,Strafford County,12,9313,4513,4800
New Hampshire,Strafford County,13,8375,4141,4234
New Hampshire,Strafford County,14,6608,3150,3458
New Hampshire,Strafford County,15,5061,2392,2669
New Hampshire,Strafford County,16,3295,1492,1803
New Hampshire,Strafford County,17,2130,860,1270
New Hampshire,Strafford County,18,2441,811,1630
New Hampshire,Sullivan County,0,43144,21297,21847
New Hampshire,Sullivan County,1,2037,1031,1006
New Hampshire,Sullivan County,2,2149,1088,1061
New Hampshire,Sullivan County,3,2420,1233,1187
New Hampshire,Sullivan County,4,2318,1164,1154
New Hampshire,Sullivan County,5,2122,1114,1008
New Hampshire,Sullivan County,6,2481,1265,1216
New Hampshire,Sullivan County,7,2430,1231,1199
New Hampshire,Sullivan County,8,2385,1161,1224
New Hampshire,Sullivan County,9,2358,1143,1215
New Hampshire,Sullivan County,10,2851,1448,1403
New Hampshire,Sullivan County,11,3171,1597,1574
New Hampshire,Sullivan County,12,3601,1785,1816
New Hampshire,Sullivan County,13,3564,1756,1808
New Hampshire,Sullivan County,14,3148,1529,1619
New Hampshire,Sullivan County,15,2418,1224,1194
New Hampshire,Sullivan County,16,1570,750,820
New Hampshire,Sullivan County,17,956,399,557
New Hampshire,Sullivan County,18,1165,379,786
New Jersey,Atlantic County,0,265429,128539,136890
New Jersey,Atlantic County,1,14367,7281,7086
New Jersey,Atlantic County,2,15688,7981,7707
New Jersey,Atlantic County,3,16247,8282,7965
New Jersey,Atlantic County,4,16771,8583,8188
New Jersey,Atlantic County,5,17168,8640,8528
New Jersey,Atlantic County,6,16641,8486,8155
New Jersey,Atlantic County,7,15278,7639,7639
New Jersey,Atlantic County,8,14877,7159,7718
New Jersey,Atlantic County,9,14645,7067,7578
New Jersey,Atlantic County,10,17307,8129,9178
New Jersey,Atlantic County,11,18953,9020,9933
New Jersey,Atlantic County,12,20604,9948,10656
New Jersey,Atlantic County,13,19272,9192,10080
New Jersey,Atlantic County,14,15106,7113,7993
New Jersey,Atlantic County,15,12276,5752,6524
New Jersey,Atlantic County,16,8684,3820,4864
New Jersey,Atlantic County,17,5638,2416,3222
New Jersey,Atlantic County,18,5907,2031,3876
New Jersey,Bergen County,0,936692,454688,482004
New Jersey,Bergen County,1,49659,25218,24441
New Jersey,Bergen County,2,53507,27376,26131
New Jersey,Bergen County,3,58766,30009,28757
New Jersey,Bergen County,4,57900,29590,28310
New Jersey,Bergen County,5,54820,27713,27107
New Jersey,Bergen County,6,52263,26612,25651
New Jersey,Bergen County,7,56248,27928,28320
New Jersey,Bergen County,8,62033,30464,31569
New Jersey,Bergen County,9,61731,30195,31536
New Jersey,Bergen County,10,66649,32460,34189
New Jersey,Bergen County,11,69419,33385,36034
New Jersey,Bergen County,12,70156,34268,35888
New Jersey,Bergen County,13,62455,29780,32675
New Jersey,Bergen County,14,48504,22822,25682
New Jersey,Bergen County,15,39041,17712,21329
New Jersey,Bergen County,16,28256,12216,16040
New Jersey,Bergen County,17,20337,8334,12003
New Jersey,Bergen County,18,24948,8606,16342
New Jersey,Burlington County,0,445384,219438,225946
New Jersey,Burlington County,1,22802,11700,11102
New Jersey,Burlington County,2,24973,12751,12222
New Jersey,Burlington County,3,27759,14064,13695
New Jersey,Burlington County,4,26676,13817,12859
New Jersey,Burlington County,5,27586,15016,12570
New Jersey,Burlington County,6,28677,15343,13334
New Jersey,Burlington County,7,27176,13708,13468
New Jersey,Burlington County,8,28210,14058,14152
New Jersey,Burlington County,9,26998,13495,13503
New Jersey,Burlington County,10,30331,15022,15309
New Jersey,Burlington County,11,33343,16111,17232
New Jersey,Burlington County,12,35289,17089,18200
New Jersey,Burlington County,13,30163,14555,15608
New Jersey,Burlington County,14,23660,11081,12579
New Jersey,Burlington County,15,18820,8486,10334
New Jersey,Burlington County,16,13489,5788,7701
New Jersey,Burlington County,17,9239,3778,5461
New Jersey,Burlington County,18,10193,3576,6617
New Jersey,Camden County,0,507078,244608,262470
New Jersey,Camden County,1,30911,15620,15291
New Jersey,Camden County,2,31994,16425,15569
New Jersey,Camden County,3,32606,16654,15952
New Jersey,Camden County,4,31001,16010,14991
New Jersey,Camden County,5,30382,15228,15154
New Jersey,Camden County,6,35855,17953,17902
New Jersey,Camden County,7,34657,17223,17434
New Jersey,Camden County,8,33570,16272,17298
New Jersey,Camden County,9,30659,14868,15791
New Jersey,Camden County,10,33194,15879,17315
New Jersey,Camden County,11,34294,16308,17986
New Jersey,Camden County,12,36091,17154,18937
New Jersey,Camden County,13,32456,15398,17058
New Jersey,Camden County,14,25523,11592,13931
New Jersey,Camden County,15,19978,8914,11064
New Jersey,Camden County,16,13742,5899,7843
New Jersey,Camden County,17,9207,3673,5534
New Jersey,Camden County,18,10958,3538,7420
New Jersey,Cape May County,0,92560,45218,47342
New Jersey,Cape May County,1,4294,2179,2115
New Jersey,Cape May County,2,4528,2255,2273
New Jersey,Cape May County,3,4517,2277,2240
New Jersey,Cape May County,4,4683,2501,2182
New Jersey,Cape May County,5,5094,2752,2342
New Jersey,Cape May County,6,5102,2784,2318
New Jersey,Cape May County,7,4555,2374,2181
New Jersey,Cape May County,8,4496,2235,2261
New Jersey,Cape May County,9,4037,1948,2089
New Jersey,Cape May County,10,4955,2498,2457
New Jersey,Cape May County,11,6140,2999,3141
New Jersey,Cape May County,12,7580,3560,4020
New Jersey,Cape May County,13,7993,3732,4261
New Jersey,Cape May County,14,7688,3643,4045
New Jersey,Cape May County,15,6408,3005,3403
New Jersey,Cape May County,16,4557,2065,2492
New Jersey,Cape May County,17,2990,1358,1632
New Jersey,Cape May County,18,2943,1053,1890
New Jersey,Cumberland County,0,150972,77018,73954
New Jersey,Cumberland County,1,9497,4833,4664
New Jersey,Cumberland County,2,10427,5197,5230
New Jersey,Cumberland County,3,10288,5211,5077
New Jersey,Cumberland County,4,9257,4771,4486
New Jersey,Cumberland County,5,8858,4643,4215
New Jersey,Cumberland County,6,11081,6243,4838
New Jersey,Cumberland County,7,10526,6137,4389
New Jersey,Cumberland County,8,10230,5647,4583
New Jersey,Cumberland County,9,9382,5107,4275
New Jersey,Cumberland County,10,9953,5202,4751
New Jersey,Cumberland County,11,9786,4831,4955
New Jersey,Cumberland County,12,9679,4762,4917
New Jersey,Cumberland County,13,8955,4370,4585
New Jersey,Cumberland County,14,7251,3369,3882
New Jersey,Cumberland County,15,5922,2716,3206
New Jersey,Cumberland County,16,4079,1777,2302
New Jersey,Cumberland County,17,2780,1110,1670
New Jersey,Cumberland County,18,3021,1092,1929
New Jersey,Essex County,0,799767,384964,414803
New Jersey,Essex County,1,52554,26877,25677
New Jersey,Essex County,2,53013,27123,25890
New Jersey,Essex County,3,52518,26764,25754
New Jersey,Essex County,4,50159,25562,24597
New Jersey,Essex County,5,51207,25491,25716
New Jersey,Essex County,6,56141,27849,28292
New Jersey,Essex County,7,54112,26505,27607
New Jersey,Essex County,8,56732,27217,29515
New Jersey,Essex County,9,55181,26690,28491
New Jersey,Essex County,10,56525,27478,29047
New Jersey,Essex County,11,55056,26775,28281
New Jersey,Essex County,12,52554,25356,27198
New Jersey,Essex County,13,45483,20921,24562
New Jersey,Essex County,14,35139,15567,19572
New Jersey,Essex County,15,26625,11590,15035
New Jersey,Essex County,16,18507,7507,11000
New Jersey,Essex County,17,12540,4768,7772
New Jersey,Essex County,18,15721,4924,10797
New Jersey,Gloucester County,0,291408,141789,149619
New Jersey,Gloucester County,1,15126,7668,7458
New Jersey,Gloucester County,2,17261,8854,8407
New Jersey,Gloucester County,3,19208,9785,9423
New Jersey,Gloucester County,4,18952,9785,9167
New Jersey,Gloucester County,5,18608,9533,9075
New Jersey,Gloucester County,6,18536,9500,9036
New Jersey,Gloucester County,7,17586,8783,8803
New Jersey,Gloucester County,8,18343,8814,9529
New Jersey,Gloucester County,9,17974,8595,9379
New Jersey,Gloucester County,10,20467,9709,10758
New Jersey,Gloucester County,11,21418,10451,10967
New Jersey,Gloucester County,12,22157,10832,11325
New Jersey,Gloucester County,13,19646,9336,10310
New Jersey,Gloucester County,14,15509,7198,8311
New Jersey,Gloucester County,15,11957,5497,6460
New Jersey,Gloucester County,16,8049,3540,4509
New Jersey,Gloucester County,17,5024,2044,2980
New Jersey,Gloucester County,18,5587,1865,3722
New Jersey,Hudson County,0,676061,336666,339395
New Jersey,Hudson County,1,46924,24051,22873
New Jersey,Hudson County,2,38055,19395,18660
New Jersey,Hudson County,3,33681,16969,16712
New Jersey,Hudson County,4,32387,16855,15532
New Jersey,Hudson County,5,40976,21302,19674
New Jersey,Hudson County,6,70608,36070,34538
New Jersey,Hudson County,7,72234,37526,34708
New Jersey,Hudson County,8,60177,31503,28674
New Jersey,Hudson County,9,46731,24222,22509
New Jersey,Hudson County,10,41961,21009,20952
New Jersey,Hudson County,11,40388,19887,20501
New Jersey,Hudson County,12,38590,18872,19718
New Jersey,Hudson County,13,33429,15643,17786
New Jersey,Hudson County,14,26012,11905,14107
New Jersey,Hudson County,15,19595,8394,11201
New Jersey,Hudson County,16,14123,5753,8370
New Jersey,Hudson County,17,9798,3882,5916
New Jersey,Hudson County,18,10392,3428,6964
New Jersey,Hunterdon County,0,124714,61767,62947
New Jersey,Hunterdon County,1,5173,2582,2591
New Jersey,Hunterdon County,2,6012,3140,2872
New Jersey,Hunterdon County,3,7559,3867,3692
New Jersey,Hunterdon County,4,8378,4347,4031
New Jersey,Hunterdon County,5,7921,4411,3510
New Jersey,Hunterdon County,6,5697,3020,2677
New Jersey,Hunterdon County,7,5652,2814,2838
New Jersey,Hunterdon County,8,6469,3147,3322
New Jersey,Hunterdon County,9,6839,3306,3533
New Jersey,Hunterdon County,10,9033,4289,4744
New Jersey,Hunterdon County,11,10995,5222,5773
New Jersey,Hunterdon County,12,11595,5751,5844
New Jersey,Hunterdon County,13,10286,5153,5133
New Jersey,Hunterdon County,14,7738,3931,3807
New Jersey,Hunterdon County,15,5849,2798,3051
New Jersey,Hunterdon County,16,4088,1942,2146
New Jersey,Hunterdon County,17,2409,1062,1347
New Jersey,Hunterdon County,18,3021,985,2036
New Jersey,Mercer County,0,369811,180955,188856
New Jersey,Mercer County,1,20928,10723,10205
New Jersey,Mercer County,2,21512,10869,10643
New Jersey,Mercer County,3,22221,11545,10676
New Jersey,Mercer County,4,27276,13527,13749
New Jersey,Mercer County,5,28778,14367,14411
New Jersey,Mercer County,6,24016,12500,11516
New Jersey,Mercer County,7,22333,11313,11020
New Jersey,Mercer County,8,23299,11802,11497
New Jersey,Mercer County,9,23520,11657,11863
New Jersey,Mercer County,10,25598,12699,12899
New Jersey,Mercer County,11,25774,12617,13157
New Jersey,Mercer County,12,25920,12695,13225
New Jersey,Mercer County,13,22636,10779,11857
New Jersey,Mercer County,14,17956,8307,9649
New Jersey,Mercer County,15,13623,6120,7503
New Jersey,Mercer County,16,9499,4084,5415
New Jersey,Mercer County,17,6727,2686,4041
New Jersey,Mercer County,18,8195,2665,5530
New Jersey,Middlesex County,0,829685,408929,420756
New Jersey,Middlesex County,1,47754,24430,23324
New Jersey,Middlesex County,2,49704,25573,24131
New Jersey,Middlesex County,3,51374,25978,25396
New Jersey,Middlesex County,4,54908,28284,26624
New Jersey,Middlesex County,5,53559,26994,26565
New Jersey,Middlesex County,6,55529,27920,27609
New Jersey,Middlesex County,7,56692,28748,27944
New Jersey,Middlesex County,8,58130,29340,28790
New Jersey,Middlesex County,9,55981,28416,27565
New Jersey,Middlesex County,10,56384,28366,28018
New Jersey,Middlesex County,11,56875,28140,28735
New Jersey,Middlesex County,12,57081,27730,29351
New Jersey,Middlesex County,13,51516,24898,26618
New Jersey,Middlesex County,14,40283,18971,21312
New Jersey,Middlesex County,15,30704,13952,16752
New Jersey,Middlesex County,16,21551,9434,12117
New Jersey,Middlesex County,17,14848,5882,8966
New Jersey,Middlesex County,18,16812,5873,10939
New Jersey,Monmouth County,0,621354,302288,319066
New Jersey,Monmouth County,1,30897,15686,15211
New Jersey,Monmouth County,2,34892,17817,17075
New Jersey,Monmouth County,3,40181,20398,19783
New Jersey,Monmouth County,4,40757,20869,19888
New Jersey,Monmouth County,5,37294,19054,18240
New Jersey,Monmouth County,6,34411,17679,16732
New Jersey,Monmouth County,7,32491,16342,16149
New Jersey,Monmouth County,8,34633,16804,17829
New Jersey,Monmouth County,9,36499,17801,18698
New Jersey,Monmouth County,10,43274,20971,22303
New Jersey,Monmouth County,11,49013,23562,25451
New Jersey,Monmouth County,12,52259,25627,26632
New Jersey,Monmouth County,13,45552,21996,23556
New Jersey,Monmouth County,14,35236,16687,18549
New Jersey,Monmouth County,15,27489,12751,14738
New Jersey,Monmouth County,16,18402,8082,10320
New Jersey,Monmouth County,17,12503,5035,7468
New Jersey,Monmouth County,18,15571,5127,10444
New Jersey,Morris County,0,494228,242781,251447
New Jersey,Morris County,1,24782,12804,11978
New Jersey,Morris County,2,27366,14171,13195
New Jersey,Morris County,3,31455,16115,15340
New Jersey,Morris County,4,33308,17059,16249
New Jersey,Morris County,5,29918,15080,14838
New Jersey,Morris County,6,26636,13814,12822
New Jersey,Morris County,7,27679,14066,13613
New Jersey,Morris County,8,30015,15001,15014
New Jersey,Morris County,9,30256,14843,15413
New Jersey,Morris County,10,35775,17364,18411
New Jersey,Morris County,11,39861,19563,20298
New Jersey,Morris County,12,39589,19518,20071
New Jersey,Morris County,13,33252,16174,17078
New Jersey,Morris County,14,25533,12238,13295
New Jersey,Morris County,15,20968,9592,11376
New Jersey,Morris County,16,15225,6672,8553
New Jersey,Morris County,17,10195,4190,6005
New Jersey,Morris County,18,12415,4517,7898
New Jersey,Ocean County,0,601651,290366,311285
New Jersey,Ocean County,1,42498,21843,20655
New Jersey,Ocean County,2,39741,20379,19362
New Jersey,Ocean County,3,39387,20107,19280
New Jersey,Ocean County,4,34427,17735,16692
New Jersey,Ocean County,5,32505,16343,16162
New Jersey,Ocean County,6,34395,17537,16858
New Jersey,Ocean County,7,31569,16097,15472
New Jersey,Ocean County,8,31061,15645,15416
New Jersey,Ocean County,9,29255,14574,14681
New Jersey,Ocean County,10,33255,16294,16961
New Jersey,Ocean County,11,36733,17803,18930
New Jersey,Ocean County,12,40947,19548,21399
New Jersey,Ocean County,13,40226,18730,21496
New Jersey,Ocean County,14,37123,16675,20448
New Jersey,Ocean County,15,34604,15423,19181
New Jersey,Ocean County,16,26098,11155,14943
New Jersey,Ocean County,17,17954,7511,10443
New Jersey,Ocean County,18,19873,6967,12906
New Jersey,Passaic County,0,503310,245542,257768
New Jersey,Passaic County,1,33867,17266,16601
New Jersey,Passaic County,2,33231,16949,16282
New Jersey,Passaic County,3,32861,16826,16035
New Jersey,Passaic County,4,33863,17075,16788
New Jersey,Passaic County,5,34694,17196,17498
New Jersey,Passaic County,6,35381,17860,17521
New Jersey,Passaic County,7,32673,16456,16217
New Jersey,Passaic County,8,32421,16145,16276
New Jersey,Passaic County,9,31089,15291,15798
New Jersey,Passaic County,10,32355,15812,16543
New Jersey,Passaic County,11,33664,16363,17301
New Jersey,Passaic County,12,33977,16521,17456
New Jersey,Passaic County,13,30021,14466,15555
New Jersey,Passaic County,14,23439,10902,12537
New Jersey,Passaic County,15,18234,8058,10176
New Jersey,Passaic County,16,13066,5576,7490
New Jersey,Passaic County,17,8696,3559,5137
New Jersey,Passaic County,18,9778,3221,6557
New Jersey,Salem County,0,62607,30717,31890
New Jersey,Salem County,1,3360,1715,1645
New Jersey,Salem County,2,3695,1862,1833
New Jersey,Salem County,3,3924,2023,1901
New Jersey,Salem County,4,3762,1988,1774
New Jersey,Salem County,5,3699,1893,1806
New Jersey,Salem County,6,3874,1971,1903
New Jersey,Salem County,7,3514,1739,1775
New Jersey,Salem County,8,3810,1942,1868
New Jersey,Salem County,9,3502,1803,1699
New Jersey,Salem County,10,4048,1952,2096
New Jersey,Salem County,11,4451,2156,2295
New Jersey,Salem County,12,4883,2360,2523
New Jersey,Salem County,13,4448,2111,2337
New Jersey,Salem County,14,3718,1850,1868
New Jersey,Salem County,15,2908,1362,1546
New Jersey,Salem County,16,1966,899,1067
New Jersey,Salem County,17,1339,562,777
New Jersey,Salem County,18,1706,529,1177
New Jersey,Somerset County,0,331164,161879,169285
New Jersey,Somerset County,1,16889,8642,8247
New Jersey,Somerset County,2,19092,9712,9380
New Jersey,Somerset County,3,22235,11594,10641
New Jersey,Somerset County,4,22108,11320,10788
New Jersey,Somerset County,5,19481,9883,9598
New Jersey,Somerset County,6,18419,9522,8897
New Jersey,Somerset County,7,18600,9357,9243
New Jersey,Somerset County,8,20548,9938,10610
New Jersey,Somerset County,9,21812,10664,11148
New Jersey,Somerset County,10,24661,12036,12625
New Jersey,Somerset County,11,26750,12928,13822
New Jersey,Somerset County,12,26630,13097,13533
New Jersey,Somerset County,13,22321,10976,11345
New Jersey,Somerset County,14,16203,7729,8474
New Jersey,Somerset County,15,12340,5574,6766
New Jersey,Somerset County,16,9045,3927,5118
New Jersey,Somerset County,17,6139,2498,3641
New Jersey,Somerset County,18,7891,2482,5409
New Jersey,Sussex County,0,140799,69985,70814
New Jersey,Sussex County,1,6369,3282,3087
New Jersey,Sussex County,2,7216,3667,3549
New Jersey,Sussex County,3,8499,4292,4207
New Jersey,Sussex County,4,8950,4622,4328
New Jersey,Sussex County,5,8309,4254,4055
New Jersey,Sussex County,6,8086,4315,3771
New Jersey,Sussex County,7,7320,3768,3552
New Jersey,Sussex County,8,7851,3945,3906
New Jersey,Sussex County,9,7835,3880,3955
New Jersey,Sussex County,10,10193,4986,5207
New Jersey,Sussex County,11,11916,5857,6059
New Jersey,Sussex County,12,12700,6287,6413
New Jersey,Sussex County,13,11193,5551,5642
New Jersey,Sussex County,14,8612,4268,4344
New Jersey,Sussex County,15,6563,3123,3440
New Jersey,Sussex County,16,4192,1975,2217
New Jersey,Sussex County,17,2384,1036,1348
New Jersey,Sussex County,18,2611,877,1734
New Jersey,Union County,0,558067,272270,285797
New Jersey,Union County,1,35127,17908,17219
New Jersey,Union County,2,36346,18382,17964
New Jersey,Union County,3,36889,18642,18247
New Jersey,Union County,4,35473,18132,17341
New Jersey,Union County,5,33772,16861,16911
New Jersey,Union County,6,35526,18132,17394
New Jersey,Union County,7,36184,18196,17988
New Jersey,Union County,8,38781,19127,19654
New Jersey,Union County,9,37929,18876,19053
New Jersey,Union County,10,39018,19320,19698
New Jersey,Union County,11,40051,19483,20568
New Jersey,Union County,12,39275,19223,20052
New Jersey,Union County,13,33444,15917,17527
New Jersey,Union County,14,25625,11935,13690
New Jersey,Union County,15,19550,8791,10759
New Jersey,Union County,16,13615,5774,7841
New Jersey,Union County,17,9462,3623,5839
New Jersey,Union County,18,12000,3948,8052
New Jersey,Warren County,0,105779,51787,53992
New Jersey,Warren County,1,4850,2467,2383
New Jersey,Warren County,2,5309,2685,2624
New Jersey,Warren County,3,6439,3250,3189
New Jersey,Warren County,4,6819,3478,3341
New Jersey,Warren County,5,6401,3264,3137
New Jersey,Warren County,6,6179,3223,2956
New Jersey,Warren County,7,5707,2908,2799
New Jersey,Warren County,8,5801,2860,2941
New Jersey,Warren County,9,5958,2990,2968
New Jersey,Warren County,10,7404,3562,3842
New Jersey,Warren County,11,8654,4291,4363
New Jersey,Warren County,12,9217,4517,4700
New Jersey,Warren County,13,7811,3837,3974
New Jersey,Warren County,14,6058,2887,3171
New Jersey,Warren County,15,4728,2169,2559
New Jersey,Warren County,16,3402,1554,1848
New Jersey,Warren County,17,2292,956,1336
New Jersey,Warren County,18,2750,889,1861
New Mexico,Bernalillo County,0,678701,332972,345729
New Mexico,Bernalillo County,1,37745,19357,18388
New Mexico,Bernalillo County,2,41002,20993,20009
New Mexico,Bernalillo County,3,42732,21868,20864
New Mexico,Bernalillo County,4,42856,21748,21108
New Mexico,Bernalillo County,5,44474,22783,21691
New Mexico,Bernalillo County,6,51033,26097,24936
New Mexico,Bernalillo County,7,50021,25494,24527
New Mexico,Bernalillo County,8,47292,23762,23530
New Mexico,Bernalillo County,9,40416,20197,20219
New Mexico,Bernalillo County,10,40777,20116,20661
New Mexico,Bernalillo County,11,40872,19846,21026
New Mexico,Bernalillo County,12,45276,21790,23486
New Mexico,Bernalillo County,13,42989,19855,23134
New Mexico,Bernalillo County,14,37614,17251,20363
New Mexico,Bernalillo County,15,28918,13253,15665
New Mexico,Bernalillo County,16,19120,8500,10620
New Mexico,Bernalillo County,17,12363,5186,7177
New Mexico,Bernalillo County,18,13201,4876,8325
New Mexico,Catron County,0,3578,1889,1689
New Mexico,Catron County,1,110,56,54
New Mexico,Catron County,2,105,56,49
New Mexico,Catron County,3,127,62,65
New Mexico,Catron County,4,151,82,69
New Mexico,Catron County,5,133,61,72
New Mexico,Catron County,6,123,70,53
New Mexico,Catron County,7,107,56,51
New Mexico,Catron County,8,111,66,45
New Mexico,Catron County,9,107,49,58
New Mexico,Catron County,10,138,75,63
New Mexico,Catron County,11,144,85,59
New Mexico,Catron County,12,333,142,191
New Mexico,Catron County,13,403,204,199
New Mexico,Catron County,14,474,255,219
New Mexico,Catron County,15,429,240,189
New Mexico,Catron County,16,287,169,118
New Mexico,Catron County,17,177,103,74
New Mexico,Catron County,18,119,58,61
New Mexico,Chaves County,0,64689,32098,32591
New Mexico,Chaves County,1,4276,2226,2050
New Mexico,Chaves County,2,4644,2365,2279
New Mexico,Chaves County,3,5030,2604,2426
New Mexico,Chaves County,4,5183,2811,2372
New Mexico,Chaves County,5,4122,2161,1961
New Mexico,Chaves County,6,4242,2125,2117
New Mexico,Chaves County,7,4062,2022,2040
New Mexico,Chaves County,8,4160,2071,2089
New Mexico,Chaves County,9,3551,1692,1859
New Mexico,Chaves County,10,3478,1744,1734
New Mexico,Chaves County,11,3736,1787,1949
New Mexico,Chaves County,12,4055,1984,2071
New Mexico,Chaves County,13,3824,1836,1988
New Mexico,Chaves County,14,3228,1540,1688
New Mexico,Chaves County,15,2592,1211,1381
New Mexico,Chaves County,16,1783,820,963
New Mexico,Chaves County,17,1316,572,744
New Mexico,Chaves County,18,1407,527,880
New Mexico,Cibola County,0,26746,13666,13080
New Mexico,Cibola County,1,1690,849,841
New Mexico,Cibola County,2,1838,928,910
New Mexico,Cibola County,3,1789,886,903
New Mexico,Cibola County,4,1659,843,816
New Mexico,Cibola County,5,1701,917,784
New Mexico,Cibola County,6,2003,1088,915
New Mexico,Cibola County,7,1790,978,812
New Mexico,Cibola County,8,1779,991,788
New Mexico,Cibola County,9,1621,895,726
New Mexico,Cibola County,10,1527,854,673
New Mexico,Cibola County,11,1504,761,743
New Mexico,Cibola County,12,1757,868,889
New Mexico,Cibola County,13,1782,864,918
New Mexico,Cibola County,14,1429,691,738
New Mexico,Cibola County,15,1081,499,582
New Mexico,Cibola County,16,750,318,432
New Mexico,Cibola County,17,555,240,315
New Mexico,Cibola County,18,491,196,295
New Mexico,Colfax County,0,12110,6142,5968
New Mexico,Colfax County,1,582,299,283
New Mexico,Colfax County,2,606,308,298
New Mexico,Colfax County,3,653,330,323
New Mexico,Colfax County,4,574,312,262
New Mexico,Colfax County,5,615,330,285
New Mexico,Colfax County,6,699,394,305
New Mexico,Colfax County,7,612,309,303
New Mexico,Colfax County,8,599,316,283
New Mexico,Colfax County,9,533,288,245
New Mexico,Colfax County,10,623,314,309
New Mexico,Colfax County,11,762,398,364
New Mexico,Colfax County,12,959,465,494
New Mexico,Colfax County,13,1044,506,538
New Mexico,Colfax County,14,1020,522,498
New Mexico,Colfax County,15,875,418,457
New Mexico,Colfax County,16,592,308,284
New Mexico,Colfax County,17,394,190,204
New Mexico,Colfax County,18,368,135,233
New Mexico,Curry County,0,49437,25643,23794
New Mexico,Curry County,1,3986,2003,1983
New Mexico,Curry County,2,3645,1864,1781
New Mexico,Curry County,3,3457,1757,1700
New Mexico,Curry County,4,3294,1851,1443
New Mexico,Curry County,5,4642,2883,1759
New Mexico,Curry County,6,4661,2624,2037
New Mexico,Curry County,7,3839,2023,1816
New Mexico,Curry County,8,3288,1715,1573
New Mexico,Curry County,9,2509,1284,1225
New Mexico,Curry County,10,2373,1170,1203
New Mexico,Curry County,11,2413,1178,1235
New Mexico,Curry County,12,2661,1308,1353
New Mexico,Curry County,13,2467,1231,1236
New Mexico,Curry County,14,1891,913,978
New Mexico,Curry County,15,1552,704,848
New Mexico,Curry County,16,1125,507,618
New Mexico,Curry County,17,824,332,492
New Mexico,Curry County,18,810,296,514
New Mexico,De Baca County,0,1781,882,899
New Mexico,De Baca County,1,86,31,55
New Mexico,De Baca County,2,130,63,67
New Mexico,De Baca County,3,109,61,48
New Mexico,De Baca County,4,115,60,55
New Mexico,De Baca County,5,75,43,32
New Mexico,De Baca County,6,68,35,33
New Mexico,De Baca County,7,86,45,41
New Mexico,De Baca County,8,107,57,50
New Mexico,De Baca County,9,68,34,34
New Mexico,De Baca County,10,82,42,40
New Mexico,De Baca County,11,90,48,42
New Mexico,De Baca County,12,144,75,69
New Mexico,De Baca County,13,124,45,79
New Mexico,De Baca County,14,156,95,61
New Mexico,De Baca County,15,131,58,73
New Mexico,De Baca County,16,80,37,43
New Mexico,De Baca County,17,57,26,31
New Mexico,De Baca County,18,73,27,46
New Mexico,Do�a Ana County,0,217522,106762,110760
New Mexico,Do�a Ana County,1,13944,7043,6901
New Mexico,Do�a Ana County,2,15068,7685,7383
New Mexico,Do�a Ana County,3,15202,7687,7515
New Mexico,Do�a Ana County,4,17287,8595,8692
New Mexico,Do�a Ana County,5,23124,11659,11465
New Mexico,Do�a Ana County,6,15482,8033,7449
New Mexico,Do�a Ana County,7,12866,6621,6245
New Mexico,Do�a Ana County,8,12790,6498,6292
New Mexico,Do�a Ana County,9,11190,5281,5909
New Mexico,Do�a Ana County,10,11134,5294,5840
New Mexico,Do�a Ana County,11,11051,5177,5874
New Mexico,Do�a Ana County,12,12331,5705,6626
New Mexico,Do�a Ana County,13,11715,5497,6218
New Mexico,Do�a Ana County,14,10633,5000,5633
New Mexico,Do�a Ana County,15,9072,4375,4697
New Mexico,Do�a Ana County,16,6294,2891,3403
New Mexico,Do�a Ana County,17,4307,2037,2270
New Mexico,Do�a Ana County,18,4032,1684,2348
New Mexico,Eddy County,0,57900,29150,28750
New Mexico,Eddy County,1,4265,2212,2053
New Mexico,Eddy County,2,4357,2167,2190
New Mexico,Eddy County,3,4199,2076,2123
New Mexico,Eddy County,4,3994,1991,2003
New Mexico,Eddy County,5,3626,1878,1748
New Mexico,Eddy County,6,4156,2195,1961
New Mexico,Eddy County,7,4131,2148,1983
New Mexico,Eddy County,8,3893,2080,1813
New Mexico,Eddy County,9,3223,1615,1608
New Mexico,Eddy County,10,3189,1601,1588
New Mexico,Eddy County,11,3252,1682,1570
New Mexico,Eddy County,12,3641,1829,1812
New Mexico,Eddy County,13,3568,1782,1786
New Mexico,Eddy County,14,2766,1373,1393
New Mexico,Eddy County,15,2031,978,1053
New Mexico,Eddy County,16,1443,663,780
New Mexico,Eddy County,17,1060,474,586
New Mexico,Eddy County,18,1106,406,700
New Mexico,Grant County,0,27346,13428,13918
New Mexico,Grant County,1,1435,727,708
New Mexico,Grant County,2,1515,766,749
New Mexico,Grant County,3,1536,794,742
New Mexico,Grant County,4,1685,883,802
New Mexico,Grant County,5,1450,779,671
New Mexico,Grant County,6,1311,683,628
New Mexico,Grant County,7,1324,649,675
New Mexico,Grant County,8,1420,682,738
New Mexico,Grant County,9,1340,651,689
New Mexico,Grant County,10,1322,635,687
New Mexico,Grant County,11,1401,660,741
New Mexico,Grant County,12,1877,890,987
New Mexico,Grant County,13,2146,999,1147
New Mexico,Grant County,14,2429,1168,1261
New Mexico,Grant County,15,1961,972,989
New Mexico,Grant County,16,1421,715,706
New Mexico,Grant County,17,870,411,459
New Mexico,Grant County,18,903,364,539
New Mexico,Guadalupe County,0,4341,2473,1868
New Mexico,Guadalupe County,1,212,122,90
New Mexico,Guadalupe County,2,242,127,115
New Mexico,Guadalupe County,3,268,146,122
New Mexico,Guadalupe County,4,275,141,134
New Mexico,Guadalupe County,5,263,174,89
New Mexico,Guadalupe County,6,304,213,91
New Mexico,Guadalupe County,7,344,230,114
New Mexico,Guadalupe County,8,308,177,131
New Mexico,Guadalupe County,9,248,151,97
New Mexico,Guadalupe County,10,209,125,84
New Mexico,Guadalupe County,11,235,127,108
New Mexico,Guadalupe County,12,298,164,134
New Mexico,Guadalupe County,13,285,143,142
New Mexico,Guadalupe County,14,242,139,103
New Mexico,Guadalupe County,15,184,99,85
New Mexico,Guadalupe County,16,164,70,94
New Mexico,Guadalupe County,17,133,66,67
New Mexico,Guadalupe County,18,127,59,68
New Mexico,Harding County,0,655,335,320
New Mexico,Harding County,1,25,7,18
New Mexico,Harding County,2,27,15,12
New Mexico,Harding County,3,20,11,9
New Mexico,Harding County,4,22,15,7
New Mexico,Harding County,5,20,8,12
New Mexico,Harding County,6,24,11,13
New Mexico,Harding County,7,30,17,13
New Mexico,Harding County,8,33,20,13
New Mexico,Harding County,9,23,14,9
New Mexico,Harding County,10,20,10,10
New Mexico,Harding County,11,38,20,18
New Mexico,Harding County,12,53,25,28
New Mexico,Harding County,13,73,42,31
New Mexico,Harding County,14,68,25,43
New Mexico,Harding County,15,63,30,33
New Mexico,Harding County,16,29,13,16
New Mexico,Harding County,17,32,18,14
New Mexico,Harding County,18,55,34,21
New Mexico,Hidalgo County,0,4240,2101,2139
New Mexico,Hidalgo County,1,267,137,130
New Mexico,Hidalgo County,2,272,122,150
New Mexico,Hidalgo County,3,273,144,129
New Mexico,Hidalgo County,4,254,126,128
New Mexico,Hidalgo County,5,246,125,121
New Mexico,Hidalgo County,6,246,137,109
New Mexico,Hidalgo County,7,228,126,102
New Mexico,Hidalgo County,8,198,113,85
New Mexico,Hidalgo County,9,172,83,89
New Mexico,Hidalgo County,10,225,98,127
New Mexico,Hidalgo County,11,292,148,144
New Mexico,Hidalgo County,12,336,159,177
New Mexico,Hidalgo County,13,283,136,147
New Mexico,Hidalgo County,14,300,143,157
New Mexico,Hidalgo County,15,232,123,109
New Mexico,Hidalgo County,16,168,83,85
New Mexico,Hidalgo County,17,125,53,72
New Mexico,Hidalgo County,18,123,45,78
New Mexico,Lea County,0,69611,35768,33843
New Mexico,Lea County,1,5434,2813,2621
New Mexico,Lea County,2,5980,3049,2931
New Mexico,Lea County,3,6041,3101,2940
New Mexico,Lea County,4,5305,2749,2556
New Mexico,Lea County,5,4712,2489,2223
New Mexico,Lea County,6,5017,2706,2311
New Mexico,Lea County,7,5117,2723,2394
New Mexico,Lea County,8,4851,2597,2254
New Mexico,Lea County,9,4059,2137,1922
New Mexico,Lea County,10,3884,1966,1918
New Mexico,Lea County,11,3716,1932,1784
New Mexico,Lea County,12,4052,2115,1937
New Mexico,Lea County,13,3495,1777,1718
New Mexico,Lea County,14,2674,1298,1376
New Mexico,Lea County,15,1960,899,1061
New Mexico,Lea County,16,1329,578,751
New Mexico,Lea County,17,1010,478,532
New Mexico,Lea County,18,975,361,614
New Mexico,Lincoln County,0,19556,9546,10010
New Mexico,Lincoln County,1,915,451,464
New Mexico,Lincoln County,2,993,524,469
New Mexico,Lincoln County,3,1062,558,504
New Mexico,Lincoln County,4,978,491,487
New Mexico,Lincoln County,5,829,447,382
New Mexico,Lincoln County,6,881,466,415
New Mexico,Lincoln County,7,955,452,503
New Mexico,Lincoln County,8,996,475,521
New Mexico,Lincoln County,9,853,405,448
New Mexico,Lincoln County,10,980,492,488
New Mexico,Lincoln County,11,1178,566,612
New Mexico,Lincoln County,12,1589,719,870
New Mexico,Lincoln County,13,1730,816,914
New Mexico,Lincoln County,14,1749,807,942
New Mexico,Lincoln County,15,1599,810,789
New Mexico,Lincoln County,16,1062,504,558
New Mexico,Lincoln County,17,688,321,367
New Mexico,Lincoln County,18,519,242,277
New Mexico,Los Alamos County,0,19101,9705,9396
New Mexico,Los Alamos County,1,1008,516,492
New Mexico,Los Alamos County,2,1160,594,566
New Mexico,Los Alamos County,3,1283,646,637
New Mexico,Los Alamos County,4,1214,624,590
New Mexico,Los Alamos County,5,926,481,445
New Mexico,Los Alamos County,6,1063,537,526
New Mexico,Los Alamos County,7,1306,753,553
New Mexico,Los Alamos County,8,1255,661,594
New Mexico,Los Alamos County,9,1103,550,553
New Mexico,Los Alamos County,10,1191,580,611
New Mexico,Los Alamos County,11,1345,671,674
New Mexico,Los Alamos County,12,1536,789,747
New Mexico,Los Alamos County,13,1301,681,620
New Mexico,Los Alamos County,14,1108,548,560
New Mexico,Los Alamos County,15,827,402,425
New Mexico,Los Alamos County,16,610,291,319
New Mexico,Los Alamos County,17,412,193,219
New Mexico,Los Alamos County,18,453,188,265
New Mexico,Luna County,0,23963,12045,11918
New Mexico,Luna County,1,1814,912,902
New Mexico,Luna County,2,1753,895,858
New Mexico,Luna County,3,1687,852,835
New Mexico,Luna County,4,1587,806,781
New Mexico,Luna County,5,1543,824,719
New Mexico,Luna County,6,1566,855,711
New Mexico,Luna County,7,1379,755,624
New Mexico,Luna County,8,1202,596,606
New Mexico,Luna County,9,1133,549,584
New Mexico,Luna County,10,1196,591,605
New Mexico,Luna County,11,1239,626,613
New Mexico,Luna County,12,1434,719,715
New Mexico,Luna County,13,1378,640,738
New Mexico,Luna County,14,1337,631,706
New Mexico,Luna County,15,1418,678,740
New Mexico,Luna County,16,1022,516,506
New Mexico,Luna County,17,683,341,342
New Mexico,Luna County,18,592,259,333
New Mexico,McKinley County,0,72290,34976,37314
New Mexico,McKinley County,1,5169,2704,2465
New Mexico,McKinley County,2,6152,3213,2939
New Mexico,McKinley County,3,6056,3091,2965
New Mexico,McKinley County,4,5470,2734,2736
New Mexico,McKinley County,5,4897,2450,2447
New Mexico,McKinley County,6,5869,2880,2989
New Mexico,McKinley County,7,5005,2547,2458
New Mexico,McKinley County,8,4282,2119,2163
New Mexico,McKinley County,9,3974,1886,2088
New Mexico,McKinley County,10,3991,1937,2054
New Mexico,McKinley County,11,4115,1913,2202
New Mexico,McKinley County,12,4334,1991,2343
New Mexico,McKinley County,13,4007,1842,2165
New Mexico,McKinley County,14,3087,1316,1771
New Mexico,McKinley County,15,2188,929,1259
New Mexico,McKinley County,16,1611,679,932
New Mexico,McKinley County,17,1041,375,666
New Mexico,McKinley County,18,1042,370,672
New Mexico,Mora County,0,4506,2304,2202
New Mexico,Mora County,1,207,91,116
New Mexico,Mora County,2,213,101,112
New Mexico,Mora County,3,218,112,106
New Mexico,Mora County,4,259,139,120
New Mexico,Mora County,5,205,119,86
New Mexico,Mora County,6,213,107,106
New Mexico,Mora County,7,200,117,83
New Mexico,Mora County,8,256,121,135
New Mexico,Mora County,9,178,88,90
New Mexico,Mora County,10,241,123,118
New Mexico,Mora County,11,296,136,160
New Mexico,Mora County,12,352,184,168
New Mexico,Mora County,13,372,189,183
New Mexico,Mora County,14,434,226,208
New Mexico,Mora County,15,344,192,152
New Mexico,Mora County,16,219,121,98
New Mexico,Mora County,17,145,67,78
New Mexico,Mora County,18,154,71,83
New Mexico,Otero County,0,66781,34530,32251
New Mexico,Otero County,1,4582,2414,2168
New Mexico,Otero County,2,4367,2198,2169
New Mexico,Otero County,3,4210,2173,2037
New Mexico,Otero County,4,4024,2103,1921
New Mexico,Otero County,5,5248,3237,2011
New Mexico,Otero County,6,5480,3175,2305
New Mexico,Otero County,7,4728,2538,2190
New Mexico,Otero County,8,4074,2119,1955
New Mexico,Otero County,9,3492,1805,1687
New Mexico,Otero County,10,3289,1559,1730
New Mexico,Otero County,11,3451,1679,1772
New Mexico,Otero County,12,4281,2078,2203
New Mexico,Otero County,13,4081,1951,2130
New Mexico,Otero County,14,3478,1713,1765
New Mexico,Otero County,15,2907,1456,1451
New Mexico,Otero County,16,2128,1030,1098
New Mexico,Otero County,17,1613,777,836
New Mexico,Otero County,18,1348,525,823
New Mexico,Quay County,0,8253,4029,4224
New Mexico,Quay County,1,419,199,220
New Mexico,Quay County,2,493,224,269
New Mexico,Quay County,3,526,280,246
New Mexico,Quay County,4,486,235,251
New Mexico,Quay County,5,352,201,151
New Mexico,Quay County,6,449,248,201
New Mexico,Quay County,7,376,186,190
New Mexico,Quay County,8,466,232,234
New Mexico,Quay County,9,382,190,192
New Mexico,Quay County,10,432,189,243
New Mexico,Quay County,11,514,252,262
New Mexico,Quay County,12,607,301,306
New Mexico,Quay County,13,650,289,361
New Mexico,Quay County,14,643,313,330
New Mexico,Quay County,15,568,271,297
New Mexico,Quay County,16,430,224,206
New Mexico,Quay County,17,242,110,132
New Mexico,Quay County,18,218,85,133
New Mexico,Rio Arriba County,0,39006,19075,19931
New Mexico,Rio Arriba County,1,2418,1214,1204
New Mexico,Rio Arriba County,2,2585,1253,1332
New Mexico,Rio Arriba County,3,2553,1267,1286
New Mexico,Rio Arriba County,4,2514,1285,1229
New Mexico,Rio Arriba County,5,2176,1085,1091
New Mexico,Rio Arriba County,6,2295,1162,1133
New Mexico,Rio Arriba County,7,2253,1113,1140
New Mexico,Rio Arriba County,8,2194,1084,1110
New Mexico,Rio Arriba County,9,2072,1053,1019
New Mexico,Rio Arriba County,10,2341,1138,1203
New Mexico,Rio Arriba County,11,2384,1165,1219
New Mexico,Rio Arriba County,12,2792,1413,1379
New Mexico,Rio Arriba County,13,2871,1365,1506
New Mexico,Rio Arriba County,14,2456,1196,1260
New Mexico,Rio Arriba County,15,1959,919,1040
New Mexico,Rio Arriba County,16,1367,673,694
New Mexico,Rio Arriba County,17,946,388,558
New Mexico,Rio Arriba County,18,830,302,528
New Mexico,Roosevelt County,0,18743,9375,9368
New Mexico,Roosevelt County,1,1325,659,666
New Mexico,Roosevelt County,2,1267,663,604
New Mexico,Roosevelt County,3,1238,649,589
New Mexico,Roosevelt County,4,1644,818,826
New Mexico,Roosevelt County,5,2407,1228,1179
New Mexico,Roosevelt County,6,1336,723,613
New Mexico,Roosevelt County,7,1112,595,517
New Mexico,Roosevelt County,8,983,501,482
New Mexico,Roosevelt County,9,915,456,459
New Mexico,Roosevelt County,10,961,458,503
New Mexico,Roosevelt County,11,913,476,437
New Mexico,Roosevelt County,12,983,473,510
New Mexico,Roosevelt County,13,987,450,537
New Mexico,Roosevelt County,14,854,416,438
New Mexico,Roosevelt County,15,621,296,325
New Mexico,Roosevelt County,16,488,218,270
New Mexico,Roosevelt County,17,388,178,210
New Mexico,Roosevelt County,18,321,118,203
New Mexico,Sandoval County,0,145179,71144,74035
New Mexico,Sandoval County,1,7991,4222,3769
New Mexico,Sandoval County,2,9366,4754,4612
New Mexico,Sandoval County,3,10251,5206,5045
New Mexico,Sandoval County,4,9609,4943,4666
New Mexico,Sandoval County,5,7806,3939,3867
New Mexico,Sandoval County,6,8703,4377,4326
New Mexico,Sandoval County,7,9227,4618,4609
New Mexico,Sandoval County,8,9567,4733,4834
New Mexico,Sandoval County,9,8765,4252,4513
New Mexico,Sandoval County,10,9238,4544,4694
New Mexico,Sandoval County,11,8834,4324,4510
New Mexico,Sandoval County,12,10202,4856,5346
New Mexico,Sandoval County,13,9864,4618,5246
New Mexico,Sandoval County,14,9158,4195,4963
New Mexico,Sandoval County,15,7142,3403,3739
New Mexico,Sandoval County,16,4530,2161,2369
New Mexico,Sandoval County,17,2507,1102,1405
New Mexico,Sandoval County,18,2419,897,1522
New Mexico,San Juan County,0,125043,61898,63145
New Mexico,San Juan County,1,8328,4232,4096
New Mexico,San Juan County,2,9221,4702,4519
New Mexico,San Juan County,3,9783,4971,4812
New Mexico,San Juan County,4,8831,4429,4402
New Mexico,San Juan County,5,7307,3699,3608
New Mexico,San Juan County,6,8833,4473,4360
New Mexico,San Juan County,7,8384,4278,4106
New Mexico,San Juan County,8,8472,4301,4171
New Mexico,San Juan County,9,7216,3587,3629
New Mexico,San Juan County,10,6830,3342,3488
New Mexico,San Juan County,11,6932,3351,3581
New Mexico,San Juan County,12,8321,4183,4138
New Mexico,San Juan County,13,7900,3943,3957
New Mexico,San Juan County,14,6318,3047,3271
New Mexico,San Juan County,15,4613,2096,2517
New Mexico,San Juan County,16,3241,1451,1790
New Mexico,San Juan County,17,2268,949,1319
New Mexico,San Juan County,18,2245,864,1381
New Mexico,San Miguel County,0,27591,13671,13920
New Mexico,San Miguel County,1,1292,646,646
New Mexico,San Miguel County,2,1363,698,665
New Mexico,San Miguel County,3,1376,694,682
New Mexico,San Miguel County,4,2025,1041,984
New Mexico,San Miguel County,5,1825,935,890
New Mexico,San Miguel County,6,1750,942,808
New Mexico,San Miguel County,7,1499,766,733
New Mexico,San Miguel County,8,1451,726,725
New Mexico,San Miguel County,9,1373,652,721
New Mexico,San Miguel County,10,1655,806,849
New Mexico,San Miguel County,11,1668,849,819
New Mexico,San Miguel County,12,2194,1120,1074
New Mexico,San Miguel County,13,2128,1024,1104
New Mexico,San Miguel County,14,1988,945,1043
New Mexico,San Miguel County,15,1573,752,821
New Mexico,San Miguel County,16,1151,526,625
New Mexico,San Miguel County,17,716,351,365
New Mexico,San Miguel County,18,564,198,366
New Mexico,Santa Fe County,0,150056,72711,77345
New Mexico,Santa Fe County,1,6449,3294,3155
New Mexico,Santa Fe County,2,7296,3663,3633
New Mexico,Santa Fe County,3,8354,4140,4214
New Mexico,Santa Fe County,4,8029,4004,4025
New Mexico,Santa Fe County,5,7791,3968,3823
New Mexico,Santa Fe County,6,8372,4230,4142
New Mexico,Santa Fe County,7,8470,4313,4157
New Mexico,Santa Fe County,8,8624,4353,4271
New Mexico,Santa Fe County,9,8224,4149,4075
New Mexico,Santa Fe County,10,9010,4447,4563
New Mexico,Santa Fe County,11,9573,4653,4920
New Mexico,Santa Fe County,12,11377,5288,6089
New Mexico,Santa Fe County,13,12002,5554,6448
New Mexico,Santa Fe County,14,12957,5910,7047
New Mexico,Santa Fe County,15,10389,4957,5432
New Mexico,Santa Fe County,16,6340,2938,3402
New Mexico,Santa Fe County,17,3535,1620,1915
New Mexico,Santa Fe County,18,3264,1230,2034
New Mexico,Sierra County,0,10968,5489,5479
New Mexico,Sierra County,1,552,284,268
New Mexico,Sierra County,2,456,229,227
New Mexico,Sierra County,3,440,221,219
New Mexico,Sierra County,4,427,236,191
New Mexico,Sierra County,5,433,230,203
New Mexico,Sierra County,6,500,252,248
New Mexico,Sierra County,7,435,239,196
New Mexico,Sierra County,8,439,222,217
New Mexico,Sierra County,9,422,206,216
New Mexico,Sierra County,10,495,241,254
New Mexico,Sierra County,11,627,293,334
New Mexico,Sierra County,12,787,381,406
New Mexico,Sierra County,13,949,430,519
New Mexico,Sierra County,14,1136,574,562
New Mexico,Sierra County,15,1030,513,517
New Mexico,Sierra County,16,801,406,395
New Mexico,Sierra County,17,551,305,246
New Mexico,Sierra County,18,488,227,261
New Mexico,Socorro County,0,16735,8396,8339
New Mexico,Socorro County,1,962,455,507
New Mexico,Socorro County,2,1062,524,538
New Mexico,Socorro County,3,1114,542,572
New Mexico,Socorro County,4,1255,703,552
New Mexico,Socorro County,5,1216,710,506
New Mexico,Socorro County,6,1040,542,498
New Mexico,Socorro County,7,940,471,469
New Mexico,Socorro County,8,880,455,425
New Mexico,Socorro County,9,854,427,427
New Mexico,Socorro County,10,845,433,412
New Mexico,Socorro County,11,950,460,490
New Mexico,Socorro County,12,1191,582,609
New Mexico,Socorro County,13,1196,558,638
New Mexico,Socorro County,14,1049,531,518
New Mexico,Socorro County,15,869,407,462
New Mexico,Socorro County,16,621,296,325
New Mexico,Socorro County,17,351,171,180
New Mexico,Socorro County,18,340,129,211
New Mexico,Taos County,0,32835,16164,16671
New Mexico,Taos County,1,1448,719,729
New Mexico,Taos County,2,1517,794,723
New Mexico,Taos County,3,1753,902,851
New Mexico,Taos County,4,1718,925,793
New Mexico,Taos County,5,1524,808,716
New Mexico,Taos County,6,1638,842,796
New Mexico,Taos County,7,1662,848,814
New Mexico,Taos County,8,1852,957,895
New Mexico,Taos County,9,1787,950,837
New Mexico,Taos County,10,1912,954,958
New Mexico,Taos County,11,2119,1015,1104
New Mexico,Taos County,12,2485,1155,1330
New Mexico,Taos County,13,2732,1304,1428
New Mexico,Taos County,14,3004,1434,1570
New Mexico,Taos County,15,2344,1074,1270
New Mexico,Taos County,16,1528,715,813
New Mexico,Taos County,17,942,441,501
New Mexico,Taos County,18,870,327,543
New Mexico,Torrance County,0,15591,8264,7327
New Mexico,Torrance County,1,778,399,379
New Mexico,Torrance County,2,851,464,387
New Mexico,Torrance County,3,998,471,527
New Mexico,Torrance County,4,997,530,467
New Mexico,Torrance County,5,884,527,357
New Mexico,Torrance County,6,958,591,367
New Mexico,Torrance County,7,861,519,342
New Mexico,Torrance County,8,920,505,415
New Mexico,Torrance County,9,864,482,382
New Mexico,Torrance County,10,908,492,416
New Mexico,Torrance County,11,941,449,492
New Mexico,Torrance County,12,1172,579,593
New Mexico,Torrance County,13,1228,624,604
New Mexico,Torrance County,14,1152,590,562
New Mexico,Torrance County,15,867,450,417
New Mexico,Torrance County,16,568,281,287
New Mexico,Torrance County,17,353,182,171
New Mexico,Torrance County,18,291,129,162
New Mexico,Union County,0,4118,2304,1814
New Mexico,Union County,1,193,98,95
New Mexico,Union County,2,223,112,111
New Mexico,Union County,3,226,111,115
New Mexico,Union County,4,198,101,97
New Mexico,Union County,5,230,158,72
New Mexico,Union County,6,324,229,95
New Mexico,Union County,7,289,195,94
New Mexico,Union County,8,298,192,106
New Mexico,Union County,9,248,159,89
New Mexico,Union County,10,260,155,105
New Mexico,Union County,11,206,127,79
New Mexico,Union County,12,272,137,135
New Mexico,Union County,13,289,162,127
New Mexico,Union County,14,238,110,128
New Mexico,Union County,15,223,98,125
New Mexico,Union County,16,149,69,80
New Mexico,Union County,17,128,53,75
New Mexico,Union County,18,124,38,86
New Mexico,Valencia County,0,76456,38350,38106
New Mexico,Valencia County,1,4339,2168,2171
New Mexico,Valencia County,2,5053,2618,2435
New Mexico,Valencia County,3,5377,2840,2537
New Mexico,Valencia County,4,5133,2573,2560
New Mexico,Valencia County,5,4745,2465,2280
New Mexico,Valencia County,6,5048,2702,2346
New Mexico,Valencia County,7,4510,2270,2240
New Mexico,Valencia County,8,4554,2385,2169
New Mexico,Valencia County,9,4275,2154,2121
New Mexico,Valencia County,10,4527,2294,2233
New Mexico,Valencia County,11,4791,2376,2415
New Mexico,Valencia County,12,5582,2734,2848
New Mexico,Valencia County,13,5020,2414,2606
New Mexico,Valencia County,14,4603,2220,2383
New Mexico,Valencia County,15,3649,1755,1894
New Mexico,Valencia County,16,2445,1140,1305
New Mexico,Valencia County,17,1506,683,823
New Mexico,Valencia County,18,1299,559,740
New York,Albany County,0,307117,148733,158384
New York,Albany County,1,15326,7935,7391
New York,Albany County,2,15450,7878,7572
New York,Albany County,3,15482,7925,7557
New York,Albany County,4,22663,11084,11579
New York,Albany County,5,32432,15993,16439
New York,Albany County,6,21150,10548,10602
New York,Albany County,7,19583,9936,9647
New York,Albany County,8,18904,9313,9591
New York,Albany County,9,16359,8036,8323
New York,Albany County,10,17789,8764,9025
New York,Albany County,11,19468,9433,10035
New York,Albany County,12,20806,10082,10724
New York,Albany County,13,19632,9471,10161
New York,Albany County,14,17005,7974,9031
New York,Albany County,15,12764,5849,6915
New York,Albany County,16,8637,3722,4915
New York,Albany County,17,5900,2306,3594
New York,Albany County,18,7767,2484,5283
New York,Allegany County,0,46430,23569,22861
New York,Allegany County,1,2432,1302,1130
New York,Allegany County,2,2569,1307,1262
New York,Allegany County,3,2645,1371,1274
New York,Allegany County,4,4418,2376,2042
New York,Allegany County,5,4147,2242,1905
New York,Allegany County,6,2284,1141,1143
New York,Allegany County,7,2445,1236,1209
New York,Allegany County,8,2385,1178,1207
New York,Allegany County,9,2293,1152,1141
New York,Allegany County,10,2524,1274,1250
New York,Allegany County,11,2778,1354,1424
New York,Allegany County,12,3328,1694,1634
New York,Allegany County,13,3367,1711,1656
New York,Allegany County,14,2922,1454,1468
New York,Allegany County,15,2243,1157,1086
New York,Allegany County,16,1523,712,811
New York,Allegany County,17,1071,504,567
New York,Allegany County,18,1056,404,652
New York,Bronx County,0,1432132,674900,757232
New York,Bronx County,1,102439,51774,50665
New York,Bronx County,2,100964,51560,49404
New York,Bronx County,3,94039,47951,46088
New York,Bronx County,4,95438,48839,46599
New York,Bronx County,5,104295,52109,52186
New York,Bronx County,6,123314,60442,62872
New York,Bronx County,7,106667,51090,55577
New York,Bronx County,8,95542,44726,50816
New York,Bronx County,9,85837,39366,46471
New York,Bronx County,10,87335,40225,47110
New York,Bronx County,11,91999,42378,49621
New York,Bronx County,12,86730,39149,47581
New York,Bronx County,13,74158,33222,40936
New York,Bronx County,14,57334,25151,32183
New York,Bronx County,15,44680,18301,26379
New York,Bronx County,16,32911,12590,20321
New York,Bronx County,17,22623,8316,14307
New York,Bronx County,18,25827,7711,18116
New York,Broome County,0,191659,94240,97419
New York,Broome County,1,10042,5207,4835
New York,Broome County,2,10070,5173,4897
New York,Broome County,3,10326,5305,5021
New York,Broome County,4,14623,7642,6981
New York,Broome County,5,19105,9718,9387
New York,Broome County,6,11326,5836,5490
New York,Broome County,7,10389,5214,5175
New York,Broome County,8,10435,5219,5216
New York,Broome County,9,9252,4568,4684
New York,Broome County,10,10215,5075,5140
New York,Broome County,11,11862,5777,6085
New York,Broome County,12,14182,7009,7173
New York,Broome County,13,13290,6557,6733
New York,Broome County,14,10869,5261,5608
New York,Broome County,15,8529,3925,4604
New York,Broome County,16,6353,2792,3561
New York,Broome County,17,4883,1981,2902
New York,Broome County,18,5908,1981,3927
New York,Cattaraugus County,0,76840,38148,38692
New York,Cattaraugus County,1,4272,2208,2064
New York,Cattaraugus County,2,4613,2288,2325
New York,Cattaraugus County,3,5009,2529,2480
New York,Cattaraugus County,4,5231,2712,2519
New York,Cattaraugus County,5,4771,2449,2322
New York,Cattaraugus County,6,4263,2203,2060
New York,Cattaraugus County,7,4215,2104,2111
New York,Cattaraugus County,8,4229,2143,2086
New York,Cattaraugus County,9,4110,2045,2065
New York,Cattaraugus County,10,4561,2236,2325
New York,Cattaraugus County,11,5157,2595,2562
New York,Cattaraugus County,12,5915,2938,2977
New York,Cattaraugus County,13,5765,2838,2927
New York,Cattaraugus County,14,4942,2432,2510
New York,Cattaraugus County,15,3645,1817,1828
New York,Cattaraugus County,16,2544,1181,1363
New York,Cattaraugus County,17,1752,786,966
New York,Cattaraugus County,18,1846,644,1202
New York,Cayuga County,0,77145,39522,37623
New York,Cayuga County,1,3846,1999,1847
New York,Cayuga County,2,4163,2153,2010
New York,Cayuga County,3,4320,2239,2081
New York,Cayuga County,4,4561,2284,2277
New York,Cayuga County,5,4653,2523,2130
New York,Cayuga County,6,4958,2746,2212
New York,Cayuga County,7,4729,2623,2106
New York,Cayuga County,8,4690,2461,2229
New York,Cayuga County,9,4181,2288,1893
New York,Cayuga County,10,4822,2535,2287
New York,Cayuga County,11,5522,2858,2664
New York,Cayuga County,12,6111,3064,3047
New York,Cayuga County,13,5839,2893,2946
New York,Cayuga County,14,4742,2409,2333
New York,Cayuga County,15,3745,1810,1935
New York,Cayuga County,16,2549,1181,1368
New York,Cayuga County,17,1694,764,930
New York,Cayuga County,18,2020,692,1328
New York,Chautauqua County,0,127939,63165,64774
New York,Chautauqua County,1,6915,3437,3478
New York,Chautauqua County,2,6935,3501,3434
New York,Chautauqua County,3,7438,3849,3589
New York,Chautauqua County,4,9042,4519,4523
New York,Chautauqua County,5,8232,4377,3855
New York,Chautauqua County,6,7691,4051,3640
New York,Chautauqua County,7,7198,3676,3522
New York,Chautauqua County,8,6883,3431,3452
New York,Chautauqua County,9,6626,3246,3380
New York,Chautauqua County,10,7497,3742,3755
New York,Chautauqua County,11,8339,4162,4177
New York,Chautauqua County,12,9692,4787,4905
New York,Chautauqua County,13,9747,4834,4913
New York,Chautauqua County,14,8119,4064,4055
New York,Chautauqua County,15,6134,2848,3286
New York,Chautauqua County,16,4594,2094,2500
New York,Chautauqua County,17,3085,1256,1829
New York,Chautauqua County,18,3772,1291,2481
New York,Chemung County,0,84254,41850,42404
New York,Chemung County,1,4713,2427,2286
New York,Chemung County,2,5048,2585,2463
New York,Chemung County,3,5070,2584,2486
New York,Chemung County,4,5165,2578,2587
New York,Chemung County,5,4934,2554,2380
New York,Chemung County,6,5279,2817,2462
New York,Chemung County,7,5197,2717,2480
New York,Chemung County,8,5100,2619,2481
New York,Chemung County,9,4725,2479,2246
New York,Chemung County,10,5106,2636,2470
New York,Chemung County,11,5581,2756,2825
New York,Chemung County,12,6247,3026,3221
New York,Chemung County,13,6114,2981,3133
New York,Chemung County,14,5097,2439,2658
New York,Chemung County,15,3870,1803,2067
New York,Chemung County,16,2718,1203,1515
New York,Chemung County,17,2015,863,1152
New York,Chemung County,18,2275,783,1492
New York,Chenango County,0,47536,23814,23722
New York,Chenango County,1,2569,1278,1291
New York,Chenango County,2,2638,1312,1326
New York,Chenango County,3,2785,1485,1300
New York,Chenango County,4,2793,1424,1369
New York,Chenango County,5,2599,1343,1256
New York,Chenango County,6,2881,1514,1367
New York,Chenango County,7,2495,1308,1187
New York,Chenango County,8,2571,1294,1277
New York,Chenango County,9,2509,1274,1235
New York,Chenango County,10,3011,1466,1545
New York,Chenango County,11,3348,1676,1672
New York,Chenango County,12,3850,1944,1906
New York,Chenango County,13,3804,1886,1918
New York,Chenango County,14,3020,1514,1506
New York,Chenango County,15,2564,1247,1317
New York,Chenango County,16,1804,894,910
New York,Chenango County,17,1138,505,633
New York,Chenango County,18,1157,450,707
New York,Clinton County,0,80695,41527,39168
New York,Clinton County,1,3914,2008,1906
New York,Clinton County,2,4053,2059,1994
New York,Clinton County,3,4054,2059,1995
New York,Clinton County,4,5454,2748,2706
New York,Clinton County,5,7481,3767,3714
New York,Clinton County,6,5151,2897,2254
New York,Clinton County,7,5054,2919,2135
New York,Clinton County,8,4960,2715,2245
New York,Clinton County,9,4546,2557,1989
New York,Clinton County,10,5039,2720,2319
New York,Clinton County,11,5585,2849,2736
New York,Clinton County,12,6086,3075,3011
New York,Clinton County,13,5554,2806,2748
New York,Clinton County,14,4545,2240,2305
New York,Clinton County,15,3431,1644,1787
New York,Clinton County,16,2388,1097,1291
New York,Clinton County,17,1734,749,985
New York,Clinton County,18,1666,618,1048
New York,Columbia County,0,59916,30001,29915
New York,Columbia County,1,2500,1282,1218
New York,Columbia County,2,2710,1417,1293
New York,Columbia County,3,3000,1614,1386
New York,Columbia County,4,3256,1800,1456
New York,Columbia County,5,3018,1600,1418
New York,Columbia County,6,3378,1741,1637
New York,Columbia County,7,3113,1533,1580
New York,Columbia County,8,3170,1557,1613
New York,Columbia County,9,3120,1574,1546
New York,Columbia County,10,3825,1933,1892
New York,Columbia County,11,4560,2271,2289
New York,Columbia County,12,5034,2551,2483
New York,Columbia County,13,4977,2476,2501
New York,Columbia County,14,4498,2187,2311
New York,Columbia County,15,3692,1820,1872
New York,Columbia County,16,2593,1223,1370
New York,Columbia County,17,1594,690,904
New York,Columbia County,18,1878,732,1146
New York,Cortland County,0,47823,23370,24453
New York,Cortland County,1,2527,1327,1200
New York,Cortland County,2,2404,1227,1177
New York,Cortland County,3,2643,1360,1283
New York,Cortland County,4,4528,2129,2399
New York,Cortland County,5,5801,2709,3092
New York,Cortland County,6,2811,1438,1373
New York,Cortland County,7,2496,1244,1252
New York,Cortland County,8,2535,1295,1240
New York,Cortland County,9,2367,1220,1147
New York,Cortland County,10,2690,1334,1356
New York,Cortland County,11,2933,1463,1470
New York,Cortland County,12,3235,1599,1636
New York,Cortland County,13,2963,1461,1502
New York,Cortland County,14,2568,1245,1323
New York,Cortland County,15,1981,952,1029
New York,Cortland County,16,1390,625,765
New York,Cortland County,17,948,403,545
New York,Cortland County,18,1003,339,664
New York,Delaware County,0,44527,22496,22031
New York,Delaware County,1,1709,862,847
New York,Delaware County,2,2017,1027,990
New York,Delaware County,3,2187,1082,1105
New York,Delaware County,4,3189,1755,1434
New York,Delaware County,5,2689,1434,1255
New York,Delaware County,6,2353,1266,1087
New York,Delaware County,7,2178,1124,1054
New York,Delaware County,8,2157,1047,1110
New York,Delaware County,9,2127,1076,1051
New York,Delaware County,10,2597,1323,1274
New York,Delaware County,11,3000,1488,1512
New York,Delaware County,12,3630,1785,1845
New York,Delaware County,13,3792,1940,1852
New York,Delaware County,14,3360,1716,1644
New York,Delaware County,15,2842,1450,1392
New York,Delaware County,16,2030,980,1050
New York,Delaware County,17,1338,616,722
New York,Delaware County,18,1332,525,807
New York,Dutchess County,0,293718,146277,147441
New York,Dutchess County,1,13331,6798,6533
New York,Dutchess County,2,14594,7525,7069
New York,Dutchess County,3,16135,8343,7792
New York,Dutchess County,4,21009,10508,10501
New York,Dutchess County,5,21428,10799,10629
New York,Dutchess County,6,18299,9879,8420
New York,Dutchess County,7,16713,8759,7954
New York,Dutchess County,8,17127,8750,8377
New York,Dutchess County,9,16749,8574,8175
New York,Dutchess County,10,19624,9876,9748
New York,Dutchess County,11,22407,11051,11356
New York,Dutchess County,12,23843,11911,11932
New York,Dutchess County,13,20826,10355,10471
New York,Dutchess County,14,16192,7835,8357
New York,Dutchess County,15,12954,5963,6991
New York,Dutchess County,16,9005,4058,4947
New York,Dutchess County,17,6335,2739,3596
New York,Dutchess County,18,7147,2554,4593
New York,Erie County,0,919719,444942,474777
New York,Erie County,1,50045,25650,24395
New York,Erie County,2,50695,25656,25039
New York,Erie County,3,51832,26375,25457
New York,Erie County,4,57837,29401,28436
New York,Erie County,5,60345,30154,30191
New York,Erie County,6,68252,34643,33609
New York,Erie County,7,63545,31764,31781
New York,Erie County,8,54877,27044,27833
New York,Erie County,9,47907,23633,24274
New York,Erie County,10,55260,26855,28405
New York,Erie County,11,61408,29796,31612
New York,Erie County,12,67705,32380,35325
New York,Erie County,13,64959,30872,34087
New York,Erie County,14,52390,24542,27848
New York,Erie County,15,39689,18078,21611
New York,Erie County,16,28701,12261,16440
New York,Erie County,17,20122,7953,12169
New York,Erie County,18,24150,7885,16265
New York,Essex County,0,37300,19255,18045
New York,Essex County,1,1455,766,689
New York,Essex County,2,1653,812,841
New York,Essex County,3,1755,916,839
New York,Essex County,4,1901,1029,872
New York,Essex County,5,1887,1063,824
New York,Essex County,6,2201,1293,908
New York,Essex County,7,2238,1271,967
New York,Essex County,8,2132,1184,948
New York,Essex County,9,2045,1060,985
New York,Essex County,10,2337,1236,1101
New York,Essex County,11,2690,1338,1352
New York,Essex County,12,3121,1550,1571
New York,Essex County,13,3142,1567,1575
New York,Essex County,14,2843,1424,1419
New York,Essex County,15,2186,1092,1094
New York,Essex County,16,1603,791,812
New York,Essex County,17,1007,450,557
New York,Essex County,18,1104,413,691
New York,Franklin County,0,50293,27683,22610
New York,Franklin County,1,2405,1215,1190
New York,Franklin County,2,2749,1445,1304
New York,Franklin County,3,2883,1487,1396
New York,Franklin County,4,3040,1682,1358
New York,Franklin County,5,3527,2268,1259
New York,Franklin County,6,3670,2364,1306
New York,Franklin County,7,3477,2153,1324
New York,Franklin County,8,3267,1906,1361
New York,Franklin County,9,2972,1785,1187
New York,Franklin County,10,3204,1816,1388
New York,Franklin County,11,3542,1927,1615
New York,Franklin County,12,3680,1886,1794
New York,Franklin County,13,3425,1731,1694
New York,Franklin County,14,2779,1438,1341
New York,Franklin County,15,2203,1090,1113
New York,Franklin County,16,1469,680,789
New York,Franklin County,17,986,415,571
New York,Franklin County,18,1015,395,620
New York,Fulton County,0,53591,26670,26921
New York,Fulton County,1,2676,1341,1335
New York,Fulton County,2,2963,1559,1404
New York,Fulton County,3,3130,1582,1548
New York,Fulton County,4,3042,1579,1463
New York,Fulton County,5,2950,1534,1416
New York,Fulton County,6,3356,1781,1575
New York,Fulton County,7,3158,1605,1553
New York,Fulton County,8,3287,1692,1595
New York,Fulton County,9,2907,1479,1428
New York,Fulton County,10,3595,1809,1786
New York,Fulton County,11,3941,1968,1973
New York,Fulton County,12,4209,2127,2082
New York,Fulton County,13,3878,1909,1969
New York,Fulton County,14,3381,1625,1756
New York,Fulton County,15,2688,1304,1384
New York,Fulton County,16,1785,783,1002
New York,Fulton County,17,1239,558,681
New York,Fulton County,18,1406,435,971
New York,Genesee County,0,57511,28611,28900
New York,Genesee County,1,2992,1503,1489
New York,Genesee County,2,3235,1591,1644
New York,Genesee County,3,3409,1737,1672
New York,Genesee County,4,3425,1725,1700
New York,Genesee County,5,3396,1776,1620
New York,Genesee County,6,3682,1998,1684
New York,Genesee County,7,3432,1814,1618
New York,Genesee County,8,3369,1722,1647
New York,Genesee County,9,2996,1523,1473
New York,Genesee County,10,3703,1853,1850
New York,Genesee County,11,4218,2090,2128
New York,Genesee County,12,4557,2288,2269
New York,Genesee County,13,4347,2163,2184
New York,Genesee County,14,3315,1609,1706
New York,Genesee County,15,2601,1247,1354
New York,Genesee County,16,1935,886,1049
New York,Genesee County,17,1367,581,786
New York,Genesee County,18,1532,505,1027
New York,Greene County,0,47491,24854,22637
New York,Greene County,1,1967,1009,958
New York,Greene County,2,2157,1106,1051
New York,Greene County,3,2178,1155,1023
New York,Greene County,4,2747,1670,1077
New York,Greene County,5,3080,1987,1093
New York,Greene County,6,2859,1584,1275
New York,Greene County,7,2726,1450,1276
New York,Greene County,8,2547,1384,1163
New York,Greene County,9,2619,1334,1285
New York,Greene County,10,3019,1559,1460
New York,Greene County,11,3470,1783,1687
New York,Greene County,12,3961,1991,1970
New York,Greene County,13,3653,1849,1804
New York,Greene County,14,3299,1602,1697
New York,Greene County,15,2864,1394,1470
New York,Greene County,16,1917,968,949
New York,Greene County,17,1196,557,639
New York,Greene County,18,1232,472,760
New York,Hamilton County,0,4434,2222,2212
New York,Hamilton County,1,116,53,63
New York,Hamilton County,2,151,76,75
New York,Hamilton County,3,182,103,79
New York,Hamilton County,4,190,93,97
New York,Hamilton County,5,192,103,89
New York,Hamilton County,6,182,83,99
New York,Hamilton County,7,155,82,73
New York,Hamilton County,8,204,101,103
New York,Hamilton County,9,181,94,87
New York,Hamilton County,10,248,121,127
New York,Hamilton County,11,325,168,157
New York,Hamilton County,12,420,208,212
New York,Hamilton County,13,502,249,253
New York,Hamilton County,14,497,253,244
New York,Hamilton County,15,363,189,174
New York,Hamilton County,16,244,129,115
New York,Hamilton County,17,127,59,68
New York,Hamilton County,18,155,58,97
New York,Herkimer County,0,61833,30591,31242
New York,Herkimer County,1,3158,1651,1507
New York,Herkimer County,2,3534,1805,1729
New York,Herkimer County,3,3754,1848,1906
New York,Herkimer County,4,3940,2040,1900
New York,Herkimer County,5,3484,1741,1743
New York,Herkimer County,6,3671,1890,1781
New York,Herkimer County,7,3357,1673,1684
New York,Herkimer County,8,3491,1811,1680
New York,Herkimer County,9,3166,1577,1589
New York,Herkimer County,10,3775,1848,1927
New York,Herkimer County,11,4246,2136,2110
New York,Herkimer County,12,4846,2393,2453
New York,Herkimer County,13,4596,2278,2318
New York,Herkimer County,14,4136,2037,2099
New York,Herkimer County,15,3159,1588,1571
New York,Herkimer County,16,2269,1020,1249
New York,Herkimer County,17,1537,675,862
New York,Herkimer County,18,1714,580,1134
New York,Jefferson County,0,111755,58764,52991
New York,Jefferson County,1,8720,4462,4258
New York,Jefferson County,2,7593,3920,3673
New York,Jefferson County,3,6741,3418,3323
New York,Jefferson County,4,6412,3438,2974
New York,Jefferson County,5,11062,7031,4031
New York,Jefferson County,6,10580,6165,4415
New York,Jefferson County,7,8510,4688,3822
New York,Jefferson County,8,7413,4034,3379
New York,Jefferson County,9,5589,2966,2623
New York,Jefferson County,10,5620,2820,2800
New York,Jefferson County,11,6014,2991,3023
New York,Jefferson County,12,6413,3136,3277
New York,Jefferson County,13,5812,2778,3034
New York,Jefferson County,14,4906,2385,2521
New York,Jefferson County,15,4003,1926,2077
New York,Jefferson County,16,2637,1232,1405
New York,Jefferson County,17,1790,769,1021
New York,Jefferson County,18,1940,605,1335
New York,Kings County,0,2582830,1223764,1359066
New York,Kings County,1,187240,96346,90894
New York,Kings County,2,164579,84434,80145
New York,Kings County,3,150122,76378,73744
New York,Kings County,4,136789,69117,67672
New York,Kings County,5,159267,76330,82937
New York,Kings County,6,243474,117584,125890
New York,Kings County,7,231343,113008,118335
New York,Kings County,8,195823,94865,100958
New York,Kings County,9,164002,77871,86131
New York,Kings County,10,155030,72464,82566
New York,Kings County,11,148169,68383,79786
New York,Kings County,12,149208,68095,81113
New York,Kings County,13,138538,62155,76383
New York,Kings County,14,116624,51265,65359
New York,Kings County,15,87765,37502,50263
New York,Kings County,16,60437,24271,36166
New York,Kings County,17,44006,16943,27063
New York,Kings County,18,50414,16753,33661
New York,Lewis County,0,26447,13398,13049
New York,Lewis County,1,1631,828,803
New York,Lewis County,2,1689,876,813
New York,Lewis County,3,1676,890,786
New York,Lewis County,4,1608,809,799
New York,Lewis County,5,1438,730,708
New York,Lewis County,6,1535,812,723
New York,Lewis County,7,1523,791,732
New York,Lewis County,8,1552,775,777
New York,Lewis County,9,1396,710,686
New York,Lewis County,10,1621,842,779
New York,Lewis County,11,1773,900,873
New York,Lewis County,12,2117,1081,1036
New York,Lewis County,13,2043,1048,995
New York,Lewis County,14,1625,817,808
New York,Lewis County,15,1125,553,572
New York,Lewis County,16,850,414,436
New York,Lewis County,17,628,286,342
New York,Lewis County,18,617,236,381
New York,Livingston County,0,63227,31760,31467
New York,Livingston County,1,2708,1408,1300
New York,Livingston County,2,3055,1565,1490
New York,Livingston County,3,3321,1664,1657
New York,Livingston County,4,5212,2538,2674
New York,Livingston County,5,6397,3085,3312
New York,Livingston County,6,3481,2033,1448
New York,Livingston County,7,3342,1822,1520
New York,Livingston County,8,3459,1815,1644
New York,Livingston County,9,3130,1709,1421
New York,Livingston County,10,3865,2011,1854
New York,Livingston County,11,4397,2207,2190
New York,Livingston County,12,4972,2459,2513
New York,Livingston County,13,4581,2279,2302
New York,Livingston County,14,3705,1812,1893
New York,Livingston County,15,2861,1357,1504
New York,Livingston County,16,1923,867,1056
New York,Livingston County,17,1315,595,720
New York,Livingston County,18,1503,534,969
New York,Madison County,0,70795,34933,35862
New York,Madison County,1,3287,1767,1520
New York,Madison County,2,3611,1868,1743
New York,Madison County,3,4016,2013,2003
New York,Madison County,4,5979,2836,3143
New York,Madison County,5,5626,2787,2839
New York,Madison County,6,3755,1924,1831
New York,Madison County,7,3743,1896,1847
New York,Madison County,8,3870,1962,1908
New York,Madison County,9,3588,1771,1817
New York,Madison County,10,4226,2058,2168
New York,Madison County,11,5128,2565,2563
New York,Madison County,12,5679,2822,2857
New York,Madison County,13,5332,2629,2703
New York,Madison County,14,4291,2148,2143
New York,Madison County,15,3227,1589,1638
New York,Madison County,16,2358,1065,1293
New York,Madison County,17,1520,665,855
New York,Madison County,18,1559,568,991
New York,Monroe County,0,742474,358365,384109
New York,Monroe County,1,40620,20799,19821
New York,Monroe County,2,42537,21615,20922
New York,Monroe County,3,43775,22379,21396
New York,Monroe County,4,50128,25723,24405
New York,Monroe County,5,50791,25339,25452
New York,Monroe County,6,54505,27302,27203
New York,Monroe County,7,50934,24951,25983
New York,Monroe County,8,44955,21766,23189
New York,Monroe County,9,39234,18710,20524
New York,Monroe County,10,44910,21498,23412
New York,Monroe County,11,49224,23642,25582
New York,Monroe County,12,53537,25489,28048
New York,Monroe County,13,49275,23669,25606
New York,Monroe County,14,40796,18996,21800
New York,Monroe County,15,31963,14453,17510
New York,Monroe County,16,22066,9640,12426
New York,Monroe County,17,14904,6187,8717
New York,Monroe County,18,18320,6207,12113
New York,Montgomery County,0,49455,24350,25105
New York,Montgomery County,1,3068,1559,1509
New York,Montgomery County,2,3028,1566,1462
New York,Montgomery County,3,3209,1651,1558
New York,Montgomery County,4,3005,1566,1439
New York,Montgomery County,5,2873,1451,1422
New York,Montgomery County,6,3022,1576,1446
New York,Montgomery County,7,3167,1543,1624
New York,Montgomery County,8,3004,1458,1546
New York,Montgomery County,9,2643,1345,1298
New York,Montgomery County,10,2941,1442,1499
New York,Montgomery County,11,3238,1589,1649
New York,Montgomery County,12,3541,1672,1869
New York,Montgomery County,13,3513,1750,1763
New York,Montgomery County,14,2912,1464,1448
New York,Montgomery County,15,2310,1139,1171
New York,Montgomery County,16,1488,665,823
New York,Montgomery County,17,1029,418,611
New York,Montgomery County,18,1464,496,968
New York,Nassau County,0,1358343,661427,696916
New York,Nassau County,1,74286,38135,36151
New York,Nassau County,2,79685,40823,38862
New York,Nassau County,3,84427,43123,41304
New York,Nassau County,4,86141,44343,41798
New York,Nassau County,5,86139,43660,42479
New York,Nassau County,6,81542,41700,39842
New York,Nassau County,7,77599,38755,38844
New York,Nassau County,8,81406,40191,41215
New York,Nassau County,9,81743,40412,41331
New York,Nassau County,10,89940,43758,46182
New York,Nassau County,11,99241,47737,51504
New York,Nassau County,12,102717,49664,53053
New York,Nassau County,13,92194,44278,47916
New York,Nassau County,14,74826,35317,39509
New York,Nassau County,15,58036,26933,31103
New York,Nassau County,16,40312,17395,22917
New York,Nassau County,17,29599,11854,17745
New York,Nassau County,18,38510,13349,25161
New York,New York County,0,1628701,771151,857550
New York,New York County,1,76939,39106,37833
New York,New York County,2,64902,32719,32183
New York,New York County,3,57993,29101,28892
New York,New York County,4,67977,31560,36417
New York,New York County,5,111265,50390,60875
New York,New York County,6,188858,89468,99390
New York,New York County,7,174670,86098,88572
New York,New York County,8,129336,64345,64991
New York,New York County,9,104009,51424,52585
New York,New York County,10,101387,50339,51048
New York,New York County,11,98015,48893,49122
New York,New York County,12,94588,46239,48349
New York,New York County,13,89860,41662,48198
New York,New York County,14,79862,34939,44923
New York,New York County,15,66479,27508,38971
New York,New York County,16,49528,20154,29374
New York,New York County,17,33825,13446,20379
New York,New York County,18,39208,13760,25448
New York,Niagara County,0,210433,102493,107940
New York,Niagara County,1,11064,5624,5440
New York,Niagara County,2,11486,5821,5665
New York,Niagara County,3,11847,5993,5854
New York,Niagara County,4,12678,6426,6252
New York,Niagara County,5,12289,6220,6069
New York,Niagara County,6,13699,6936,6763
New York,Niagara County,7,12789,6444,6345
New York,Niagara County,8,12139,5953,6186
New York,Niagara County,9,11120,5432,5688
New York,Niagara County,10,12941,6432,6509
New York,Niagara County,11,14877,7153,7724
New York,Niagara County,12,16956,8247,8709
New York,Niagara County,13,16439,8064,8375
New York,Niagara County,14,12959,6271,6688
New York,Niagara County,15,9949,4691,5258
New York,Niagara County,16,6771,2951,3820
New York,Niagara County,17,4834,1968,2866
New York,Niagara County,18,5596,1867,3729
New York,Oneida County,0,229577,114334,115243
New York,Oneida County,1,12799,6504,6295
New York,Oneida County,2,13801,6992,6809
New York,Oneida County,3,13751,6984,6767
New York,Oneida County,4,14755,7655,7100
New York,Oneida County,5,15170,8112,7058
New York,Oneida County,6,14563,7591,6972
New York,Oneida County,7,14137,7386,6751
New York,Oneida County,8,13403,6934,6469
New York,Oneida County,9,12050,6199,5851
New York,Oneida County,10,14300,7291,7009
New York,Oneida County,11,15397,7719,7678
New York,Oneida County,12,16745,8400,8345
New York,Oneida County,13,15647,7616,8031
New York,Oneida County,14,13123,6393,6730
New York,Oneida County,15,10421,4853,5568
New York,Oneida County,16,7389,3224,4165
New York,Oneida County,17,5272,2144,3128
New York,Oneida County,18,6854,2337,4517
New York,Onondaga County,0,461809,222674,239135
New York,Onondaga County,1,26136,13238,12898
New York,Onondaga County,2,27152,13907,13245
New York,Onondaga County,3,27293,13987,13306
New York,Onondaga County,4,32698,16091,16607
New York,Onondaga County,5,32453,15857,16596
New York,Onondaga County,6,31133,15512,15621
New York,Onondaga County,7,30409,14884,15525
New York,Onondaga County,8,27520,13464,14056
New York,Onondaga County,9,24398,11778,12620
New York,Onondaga County,10,27594,13244,14350
New York,Onondaga County,11,31195,15027,16168
New York,Onondaga County,12,34025,16427,17598
New York,Onondaga County,13,31168,14950,16218
New York,Onondaga County,14,25540,12183,13357
New York,Onondaga County,15,18817,8513,10304
New York,Onondaga County,16,13259,5809,7450
New York,Onondaga County,17,9388,3868,5520
New York,Onondaga County,18,11631,3935,7696
New York,Ontario County,0,109864,53826,56038
New York,Ontario County,1,5448,2731,2717
New York,Ontario County,2,6026,3082,2944
New York,Ontario County,3,6489,3334,3155
New York,Ontario County,4,7146,3665,3481
New York,Ontario County,5,6926,3561,3365
New York,Ontario County,6,6179,3238,2941
New York,Ontario County,7,6158,3114,3044
New York,Ontario County,8,6326,3087,3239
New York,Ontario County,9,5734,2809,2925
New York,Ontario County,10,6943,3415,3528
New York,Ontario County,11,7884,3845,4039
New York,Ontario County,12,8623,4202,4421
New York,Ontario County,13,8089,3945,4144
New York,Ontario County,14,7176,3403,3773
New York,Ontario County,15,5735,2704,3031
New York,Ontario County,16,3728,1726,2002
New York,Ontario County,17,2517,1066,1451
New York,Ontario County,18,2737,899,1838
New York,Orange County,0,381951,191531,190420
New York,Orange County,1,25255,12987,12268
New York,Orange County,2,26505,13585,12920
New York,Orange County,3,28051,14480,13571
New York,Orange County,4,28875,15387,13488
New York,Orange County,5,28646,16269,12377
New York,Orange County,6,23082,11965,11117
New York,Orange County,7,21905,11124,10781
New York,Orange County,8,22773,11284,11489
New York,Orange County,9,22280,11033,11247
New York,Orange County,10,25307,12414,12893
New York,Orange County,11,27099,13297,13802
New York,Orange County,12,26491,13010,13481
New York,Orange County,13,22141,11060,11081
New York,Orange County,14,17789,8325,9464
New York,Orange County,15,13739,6391,7348
New York,Orange County,16,9228,4127,5101
New York,Orange County,17,6133,2516,3617
New York,Orange County,18,6652,2277,4375
New York,Orleans County,0,40612,20278,20334
New York,Orleans County,1,2070,1082,988
New York,Orleans County,2,2056,1059,997
New York,Orleans County,3,2252,1122,1130
New York,Orleans County,4,2472,1269,1203
New York,Orleans County,5,2525,1348,1177
New York,Orleans County,6,2786,1490,1296
New York,Orleans County,7,2432,1248,1184
New York,Orleans County,8,2398,1196,1202
New York,Orleans County,9,2256,1102,1154
New York,Orleans County,10,2658,1301,1357
New York,Orleans County,11,3033,1522,1511
New York,Orleans County,12,3332,1670,1662
New York,Orleans County,13,3065,1539,1526
New York,Orleans County,14,2431,1207,1224
New York,Orleans County,15,1837,875,962
New York,Orleans County,16,1291,603,688
New York,Orleans County,17,858,368,490
New York,Orleans County,18,860,277,583
New York,Oswego County,0,117898,59114,58784
New York,Oswego County,1,6410,3308,3102
New York,Oswego County,2,6774,3549,3225
New York,Oswego County,3,7147,3625,3522
New York,Oswego County,4,8707,4408,4299
New York,Oswego County,5,8333,4274,4059
New York,Oswego County,6,7673,4007,3666
New York,Oswego County,7,6898,3559,3339
New York,Oswego County,8,6691,3347,3344
New York,Oswego County,9,6101,3009,3092
New York,Oswego County,10,7434,3673,3761
New York,Oswego County,11,8781,4429,4352
New York,Oswego County,12,9446,4760,4686
New York,Oswego County,13,8238,4210,4028
New York,Oswego County,14,6644,3273,3371
New York,Oswego County,15,4904,2407,2497
New York,Oswego County,16,3464,1584,1880
New York,Oswego County,17,2085,911,1174
New York,Oswego County,18,2168,781,1387
New York,Otsego County,0,59749,28984,30765
New York,Otsego County,1,2530,1333,1197
New York,Otsego County,2,2577,1373,1204
New York,Otsego County,3,2637,1300,1337
New York,Otsego County,4,5144,2346,2798
New York,Otsego County,5,6662,3130,3532
New York,Otsego County,6,3118,1580,1538
New York,Otsego County,7,2856,1460,1396
New York,Otsego County,8,2965,1530,1435
New York,Otsego County,9,2680,1350,1330
New York,Otsego County,10,3311,1634,1677
New York,Otsego County,11,3738,1846,1892
New York,Otsego County,12,4515,2219,2296
New York,Otsego County,13,4359,2071,2288
New York,Otsego County,14,4021,1964,2057
New York,Otsego County,15,3200,1524,1676
New York,Otsego County,16,2308,1095,1213
New York,Otsego County,17,1416,621,795
New York,Otsego County,18,1712,608,1104
New York,Putnam County,0,98892,49406,49486
New York,Putnam County,1,4444,2270,2174
New York,Putnam County,2,5064,2596,2468
New York,Putnam County,3,5998,3092,2906
New York,Putnam County,4,6288,3224,3064
New York,Putnam County,5,6160,3278,2882
New York,Putnam County,6,5471,2948,2523
New York,Putnam County,7,5403,2779,2624
New York,Putnam County,8,5639,2931,2708
New York,Putnam County,9,5904,2940,2964
New York,Putnam County,10,7277,3616,3661
New York,Putnam County,11,8378,4199,4179
New York,Putnam County,12,8509,4179,4330
New York,Putnam County,13,7188,3558,3630
New York,Putnam County,14,5675,2725,2950
New York,Putnam County,15,4472,2149,2323
New York,Putnam County,16,3142,1466,1676
New York,Putnam County,17,1900,783,1117
New York,Putnam County,18,1980,673,1307
New York,Queens County,0,2278906,1105389,1173517
New York,Queens County,1,141209,72395,68814
New York,Queens County,2,126951,65172,61779
New York,Queens County,3,118937,60929,58008
New York,Queens County,4,114778,58711,56067
New York,Queens County,5,130841,64391,66450
New York,Queens County,6,186616,92619,93997
New York,Queens County,7,179467,90453,89014
New York,Queens County,8,163548,81456,82092
New York,Queens County,9,149404,73676,75728
New York,Queens County,10,153212,75383,77829
New York,Queens County,11,155338,75568,79770
New York,Queens County,12,157714,76085,81629
New York,Queens County,13,143374,67595,75779
New York,Queens County,14,115074,52633,62441
New York,Queens County,15,85915,37897,48018
New York,Queens County,16,62063,25723,36340
New York,Queens County,17,44020,17545,26475
New York,Queens County,18,50445,17158,33287
New York,Rensselaer County,0,159442,78763,80679
New York,Rensselaer County,1,8391,4299,4092
New York,Rensselaer County,2,8651,4508,4143
New York,Rensselaer County,3,8668,4427,4241
New York,Rensselaer County,4,10524,5714,4810
New York,Rensselaer County,5,10868,5883,4985
New York,Rensselaer County,6,11601,5976,5625
New York,Rensselaer County,7,11096,5492,5604
New York,Rensselaer County,8,9845,4829,5016
New York,Rensselaer County,9,8959,4444,4515
New York,Rensselaer County,10,9988,4891,5097
New York,Rensselaer County,11,10865,5168,5697
New York,Rensselaer County,12,11887,5735,6152
New York,Rensselaer County,13,11068,5354,5714
New York,Rensselaer County,14,9228,4452,4776
New York,Rensselaer County,15,6836,3212,3624
New York,Rensselaer County,16,4488,1984,2504
New York,Rensselaer County,17,2998,1227,1771
New York,Rensselaer County,18,3481,1168,2313
New York,Richmond County,0,476179,230765,245414
New York,Richmond County,1,27413,13935,13478
New York,Richmond County,2,28324,14593,13731
New York,Richmond County,3,29902,15338,14564
New York,Richmond County,4,29185,14992,14193
New York,Richmond County,5,28704,14454,14250
New York,Richmond County,6,33845,17004,16841
New York,Richmond County,7,31046,15620,15426
New York,Richmond County,8,29726,14522,15204
New York,Richmond County,9,29588,14338,15250
New York,Richmond County,10,32043,15366,16677
New York,Richmond County,11,33525,16102,17423
New York,Richmond County,12,34435,16479,17956
New York,Richmond County,13,31390,14789,16601
New York,Richmond County,14,25521,11759,13762
New York,Richmond County,15,19864,8926,10938
New York,Richmond County,16,13289,5859,7430
New York,Richmond County,17,8660,3468,5192
New York,Richmond County,18,9719,3221,6498
New York,Rockland County,0,325695,159777,165918
New York,Rockland County,1,26349,13312,13037
New York,Rockland County,2,24665,12547,12118
New York,Rockland County,3,25527,13094,12433
New York,Rockland County,4,23717,12235,11482
New York,Rockland County,5,21479,10954,10525
New York,Rockland County,6,19909,10252,9657
New York,Rockland County,7,18004,9272,8732
New York,Rockland County,8,18437,9157,9280
New York,Rockland County,9,17352,8656,8696
New York,Rockland County,10,18867,9167,9700
New York,Rockland County,11,20786,10021,10765
New York,Rockland County,12,21038,10185,10853
New York,Rockland County,13,18458,8953,9505
New York,Rockland County,14,15161,7109,8052
New York,Rockland County,15,12552,5539,7013
New York,Rockland County,16,9024,3905,5119
New York,Rockland County,17,6638,2745,3893
New York,Rockland County,18,7732,2674,5058
New York,St. Lawrence County,0,108047,55194,52853
New York,St. Lawrence County,1,5535,2822,2713
New York,St. Lawrence County,2,6017,3122,2895
New York,St. Lawrence County,3,6439,3315,3124
New York,St. Lawrence County,4,9103,4686,4417
New York,St. Lawrence County,5,9065,4981,4084
New York,St. Lawrence County,6,6474,3608,2866
New York,St. Lawrence County,7,6318,3435,2883
New York,St. Lawrence County,8,6030,3110,2920
New York,St. Lawrence County,9,5750,3024,2726
New York,St. Lawrence County,10,6520,3367,3153
New York,St. Lawrence County,11,7002,3571,3431
New York,St. Lawrence County,12,7742,3811,3931
New York,St. Lawrence County,13,7226,3647,3579
New York,St. Lawrence County,14,6114,3027,3087
New York,St. Lawrence County,15,4772,2339,2433
New York,St. Lawrence County,16,3284,1515,1769
New York,St. Lawrence County,17,2374,1033,1341
New York,St. Lawrence County,18,2282,781,1501
New York,Saratoga County,0,230163,113980,116183
New York,Saratoga County,1,11788,6047,5741
New York,Saratoga County,2,12643,6433,6210
New York,Saratoga County,3,13167,6735,6432
New York,Saratoga County,4,14026,7143,6883
New York,Saratoga County,5,13429,7007,6422
New York,Saratoga County,6,13727,7252,6475
New York,Saratoga County,7,14261,7301,6960
New York,Saratoga County,8,14462,7259,7203
New York,Saratoga County,9,13828,6860,6968
New York,Saratoga County,10,16351,8159,8192
New York,Saratoga County,11,17376,8580,8796
New York,Saratoga County,12,17735,8639,9096
New York,Saratoga County,13,15642,7630,8012
New York,Saratoga County,14,13780,6626,7154
New York,Saratoga County,15,11177,5233,5944
New York,Saratoga County,16,7367,3397,3970
New York,Saratoga County,17,4463,1930,2533
New York,Saratoga County,18,4941,1749,3192
New York,Schenectady County,0,155350,75706,79644
New York,Schenectady County,1,8948,4619,4329
New York,Schenectady County,2,9283,4825,4458
New York,Schenectady County,3,9454,4887,4567
New York,Schenectady County,4,9562,4849,4713
New York,Schenectady County,5,10050,5111,4939
New York,Schenectady County,6,10210,5125,5085
New York,Schenectady County,7,10344,5190,5154
New York,Schenectady County,8,10042,4934,5108
New York,Schenectady County,9,9121,4509,4612
New York,Schenectady County,10,9726,4805,4921
New York,Schenectady County,11,10543,5078,5465
New York,Schenectady County,12,11150,5335,5815
New York,Schenectady County,13,10327,4979,5348
New York,Schenectady County,14,8376,3971,4405
New York,Schenectady County,15,6348,2944,3404
New York,Schenectady County,16,4372,1857,2515
New York,Schenectady County,17,3122,1221,1901
New York,Schenectady County,18,4372,1467,2905
New York,Schoharie County,0,31097,15596,15501
New York,Schoharie County,1,1265,701,564
New York,Schoharie County,2,1528,764,764
New York,Schoharie County,3,1585,824,761
New York,Schoharie County,4,2263,1130,1133
New York,Schoharie County,5,2030,1056,974
New York,Schoharie County,6,1684,860,824
New York,Schoharie County,7,1613,857,756
New York,Schoharie County,8,1654,841,813
New York,Schoharie County,9,1593,768,825
New York,Schoharie County,10,1877,966,911
New York,Schoharie County,11,2235,1121,1114
New York,Schoharie County,12,2511,1213,1298
New York,Schoharie County,13,2462,1228,1234
New York,Schoharie County,14,2207,1062,1145
New York,Schoharie County,15,1802,910,892
New York,Schoharie County,16,1254,609,645
New York,Schoharie County,17,790,388,402
New York,Schoharie County,18,744,298,446
New York,Schuyler County,0,17912,8930,8982
New York,Schuyler County,1,906,484,422
New York,Schuyler County,2,948,473,475
New York,Schuyler County,3,966,501,465
New York,Schuyler County,4,975,499,476
New York,Schuyler County,5,858,441,417
New York,Schuyler County,6,1064,572,492
New York,Schuyler County,7,962,481,481
New York,Schuyler County,8,989,449,540
New York,Schuyler County,9,984,469,515
New York,Schuyler County,10,1161,592,569
New York,Schuyler County,11,1304,677,627
New York,Schuyler County,12,1485,722,763
New York,Schuyler County,13,1488,745,743
New York,Schuyler County,14,1301,666,635
New York,Schuyler County,15,981,483,498
New York,Schuyler County,16,657,329,328
New York,Schuyler County,17,439,188,251
New York,Schuyler County,18,444,159,285
New York,Seneca County,0,34300,18005,16295
New York,Seneca County,1,1768,928,840
New York,Seneca County,2,1846,948,898
New York,Seneca County,3,1962,1019,943
New York,Seneca County,4,1937,1026,911
New York,Seneca County,5,2279,1347,932
New York,Seneca County,6,2434,1452,982
New York,Seneca County,7,2208,1266,942
New York,Seneca County,8,2012,1099,913
New York,Seneca County,9,1797,989,808
New York,Seneca County,10,2084,1110,974
New York,Seneca County,11,2187,1137,1050
New York,Seneca County,12,2637,1332,1305
New York,Seneca County,13,2558,1299,1259
New York,Seneca County,14,2149,1038,1111
New York,Seneca County,15,1737,828,909
New York,Seneca County,16,1124,533,591
New York,Seneca County,17,761,334,427
New York,Seneca County,18,820,320,500
New York,Steuben County,0,95796,47749,48047
New York,Steuben County,1,5193,2738,2455
New York,Steuben County,2,5674,2880,2794
New York,Steuben County,3,5923,3017,2906
New York,Steuben County,4,5813,3050,2763
New York,Steuben County,5,5247,2693,2554
New York,Steuben County,6,5726,2885,2841
New York,Steuben County,7,5438,2760,2678
New York,Steuben County,8,5655,2882,2773
New York,Steuben County,9,5186,2597,2589
New York,Steuben County,10,6125,3032,3093
New York,Steuben County,11,6667,3359,3308
New York,Steuben County,12,7335,3685,3650
New York,Steuben County,13,6964,3490,3474
New York,Steuben County,14,6138,3030,3108
New York,Steuben County,15,4701,2217,2484
New York,Steuben County,16,3281,1546,1735
New York,Steuben County,17,2275,1025,1250
New York,Steuben County,18,2455,863,1592
New York,Suffolk County,0,1481093,729117,751976
New York,Suffolk County,1,79299,40414,38885
New York,Suffolk County,2,82660,42187,40473
New York,Suffolk County,3,91648,47076,44572
New York,Suffolk County,4,96707,49652,47055
New York,Suffolk County,5,96541,49044,47497
New York,Suffolk County,6,92355,48062,44293
New York,Suffolk County,7,83549,42731,40818
New York,Suffolk County,8,85642,43313,42329
New York,Suffolk County,9,88238,44037,44201
New York,Suffolk County,10,102769,50380,52389
New York,Suffolk County,11,116372,57222,59150
New York,Suffolk County,12,117553,57918,59635
New York,Suffolk County,13,98004,47797,50207
New York,Suffolk County,14,76998,36401,40597
New York,Suffolk County,15,63170,28795,34375
New York,Suffolk County,16,44866,19545,25321
New York,Suffolk County,17,29973,12515,17458
New York,Suffolk County,18,34749,12028,22721
New York,Sullivan County,0,75498,38865,36633
New York,Sullivan County,1,4280,2217,2063
New York,Sullivan County,2,4381,2231,2150
New York,Sullivan County,3,4546,2337,2209
New York,Sullivan County,4,4505,2379,2126
New York,Sullivan County,5,4278,2274,2004
New York,Sullivan County,6,4644,2510,2134
New York,Sullivan County,7,4367,2324,2043
New York,Sullivan County,8,4465,2297,2168
New York,Sullivan County,9,4215,2267,1948
New York,Sullivan County,10,4752,2498,2254
New York,Sullivan County,11,5632,2955,2677
New York,Sullivan County,12,5879,3011,2868
New York,Sullivan County,13,5316,2698,2618
New York,Sullivan County,14,4801,2416,2385
New York,Sullivan County,15,3796,1849,1947
New York,Sullivan County,16,2681,1328,1353
New York,Sullivan County,17,1561,732,829
New York,Sullivan County,18,1399,542,857
New York,Tioga County,0,48560,24129,24431
New York,Tioga County,1,2501,1236,1265
New York,Tioga County,2,2717,1428,1289
New York,Tioga County,3,3054,1584,1470
New York,Tioga County,4,2972,1543,1429
New York,Tioga County,5,2533,1308,1225
New York,Tioga County,6,2593,1330,1263
New York,Tioga County,7,2629,1304,1325
New York,Tioga County,8,2839,1431,1408
New York,Tioga County,9,2639,1323,1316
New York,Tioga County,10,2904,1441,1463
New York,Tioga County,11,3387,1660,1727
New York,Tioga County,12,4157,2041,2116
New York,Tioga County,13,3781,1910,1871
New York,Tioga County,14,2918,1452,1466
New York,Tioga County,15,2549,1211,1338
New York,Tioga County,16,1777,856,921
New York,Tioga County,17,1329,597,732
New York,Tioga County,18,1281,474,807
New York,Tompkins County,0,102793,50524,52269
New York,Tompkins County,1,3920,1972,1948
New York,Tompkins County,2,4198,2114,2084
New York,Tompkins County,3,4119,2131,1988
New York,Tompkins County,4,11582,5750,5832
New York,Tompkins County,5,18426,9506,8920
New York,Tompkins County,6,7300,3724,3576
New York,Tompkins County,7,5818,2858,2960
New York,Tompkins County,8,5745,2783,2962
New York,Tompkins County,9,4952,2417,2535
New York,Tompkins County,10,4975,2439,2536
New York,Tompkins County,11,5385,2600,2785
New York,Tompkins County,12,5658,2668,2990
New York,Tompkins County,13,5815,2753,3062
New York,Tompkins County,14,5283,2561,2722
New York,Tompkins County,15,3848,1840,2008
New York,Tompkins County,16,2425,1108,1317
New York,Tompkins County,17,1506,648,858
New York,Tompkins County,18,1838,652,1186
New York,Ulster County,0,178599,88505,90094
New York,Ulster County,1,7834,4007,3827
New York,Ulster County,2,8438,4224,4214
New York,Ulster County,3,9415,4719,4696
New York,Ulster County,4,10797,5312,5485
New York,Ulster County,5,11318,5850,5468
New York,Ulster County,6,11645,6119,5526
New York,Ulster County,7,10818,5681,5137
New York,Ulster County,8,10423,5378,5045
New York,Ulster County,9,10246,5259,4987
New York,Ulster County,10,11691,5963,5728
New York,Ulster County,11,13007,6463,6544
New York,Ulster County,12,14478,7172,7306
New York,Ulster County,13,13161,6451,6710
New York,Ulster County,14,11547,5550,5997
New York,Ulster County,15,9212,4273,4939
New York,Ulster County,16,6128,2831,3297
New York,Ulster County,17,3820,1630,2190
New York,Ulster County,18,4621,1623,2998
New York,Warren County,0,64265,31572,32693
New York,Warren County,1,2887,1475,1412
New York,Warren County,2,3256,1682,1574
New York,Warren County,3,3408,1769,1639
New York,Warren County,4,3381,1797,1584
New York,Warren County,5,3376,1720,1656
New York,Warren County,6,3957,2029,1928
New York,Warren County,7,3691,1841,1850
New York,Warren County,8,3496,1775,1721
New York,Warren County,9,3325,1665,1660
New York,Warren County,10,4114,1944,2170
New York,Warren County,11,4717,2294,2423
New York,Warren County,12,5352,2571,2781
New York,Warren County,13,5014,2437,2577
New York,Warren County,14,4657,2262,2395
New York,Warren County,15,3646,1771,1875
New York,Warren County,16,2588,1224,1364
New York,Warren County,17,1607,695,912
New York,Warren County,18,1793,621,1172
New York,Washington County,0,61197,31674,29523
New York,Washington County,1,2862,1460,1402
New York,Washington County,2,3146,1675,1471
New York,Washington County,3,3349,1696,1653
New York,Washington County,4,3387,1896,1491
New York,Washington County,5,3570,2066,1504
New York,Washington County,6,3790,2081,1709
New York,Washington County,7,3760,2016,1744
New York,Washington County,8,3538,1918,1620
New York,Washington County,9,3657,2017,1640
New York,Washington County,10,4107,2204,1903
New York,Washington County,11,4670,2347,2323
New York,Washington County,12,4790,2396,2394
New York,Washington County,13,4652,2343,2309
New York,Washington County,14,3805,1895,1910
New York,Washington County,15,3102,1522,1580
New York,Washington County,16,2153,991,1162
New York,Washington County,17,1375,613,762
New York,Washington County,18,1484,538,946
New York,Wayne County,0,90064,44703,45361
New York,Wayne County,1,4836,2448,2388
New York,Wayne County,2,5389,2793,2596
New York,Wayne County,3,5619,2847,2772
New York,Wayne County,4,5182,2568,2614
New York,Wayne County,5,4976,2567,2409
New York,Wayne County,6,5287,2719,2568
New York,Wayne County,7,5070,2541,2529
New York,Wayne County,8,5175,2578,2597
New York,Wayne County,9,4639,2356,2283
New York,Wayne County,10,5890,2937,2953
New York,Wayne County,11,6764,3352,3412
New York,Wayne County,12,7427,3679,3748
New York,Wayne County,13,6808,3347,3461
New York,Wayne County,14,5602,2823,2779
New York,Wayne County,15,4490,2125,2365
New York,Wayne County,16,2997,1412,1585
New York,Wayne County,17,1891,868,1023
New York,Wayne County,18,2022,743,1279
New York,Westchester County,0,967612,468720,498892
New York,Westchester County,1,53786,27736,26050
New York,Westchester County,2,57474,29620,27854
New York,Westchester County,3,61624,31717,29907
New York,Westchester County,4,64485,32969,31516
New York,Westchester County,5,59911,29615,30296
New York,Westchester County,6,54967,27864,27103
New York,Westchester County,7,56320,28334,27986
New York,Westchester County,8,60984,30052,30932
New York,Westchester County,9,62418,30537,31881
New York,Westchester County,10,67692,32887,34805
New York,Westchester County,11,70955,34113,36842
New York,Westchester County,12,70213,33925,36288
New York,Westchester County,13,61775,29385,32390
New York,Westchester County,14,49412,22900,26512
New York,Westchester County,15,38669,17521,21148
New York,Westchester County,16,28454,11910,16544
New York,Westchester County,17,20834,8303,12531
New York,Westchester County,18,27639,9332,18307
New York,Wyoming County,0,40085,21705,18380
New York,Wyoming County,1,1978,1002,976
New York,Wyoming County,2,2088,1081,1007
New York,Wyoming County,3,2123,1055,1068
New York,Wyoming County,4,2142,1099,1043
New York,Wyoming County,5,2193,1226,967
New York,Wyoming County,6,2861,1736,1125
New York,Wyoming County,7,2798,1736,1062
New York,Wyoming County,8,2598,1549,1049
New York,Wyoming County,9,2354,1391,963
New York,Wyoming County,10,2779,1624,1155
New York,Wyoming County,11,3015,1625,1390
New York,Wyoming County,12,3065,1623,1442
New York,Wyoming County,13,2903,1497,1406
New York,Wyoming County,14,2511,1293,1218
New York,Wyoming County,15,1875,938,937
New York,Wyoming County,16,1255,598,657
New York,Wyoming County,17,781,353,428
New York,Wyoming County,18,766,279,487
New York,Yates County,0,24841,12070,12771
New York,Yates County,1,1490,773,717
New York,Yates County,2,1564,800,764
New York,Yates County,3,1434,704,730
New York,Yates County,4,1763,861,902
New York,Yates County,5,1898,843,1055
New York,Yates County,6,1421,717,704
New York,Yates County,7,1261,652,609
New York,Yates County,8,1224,586,638
New York,Yates County,9,1105,551,554
New York,Yates County,10,1306,640,666
New York,Yates County,11,1423,706,717
New York,Yates County,12,1850,859,991
New York,Yates County,13,1930,921,1009
New York,Yates County,14,1722,830,892
New York,Yates County,15,1345,711,634
New York,Yates County,16,903,442,461
New York,Yates County,17,597,255,342
New York,Yates County,18,605,219,386
North Carolina,Alamance County,0,166436,78937,87499
North Carolina,Alamance County,1,9632,4933,4699
North Carolina,Alamance County,2,10150,5224,4926
North Carolina,Alamance County,3,10645,5422,5223
North Carolina,Alamance County,4,12950,6282,6668
North Carolina,Alamance County,5,10920,5165,5755
North Carolina,Alamance County,6,10734,5099,5635
North Carolina,Alamance County,7,9991,4832,5159
North Carolina,Alamance County,8,9542,4502,5040
North Carolina,Alamance County,9,9564,4576,4988
North Carolina,Alamance County,10,11047,5317,5730
North Carolina,Alamance County,11,11344,5431,5913
North Carolina,Alamance County,12,11436,5444,5992
North Carolina,Alamance County,13,10354,4899,5455
North Carolina,Alamance County,14,8538,3844,4694
North Carolina,Alamance County,15,7273,3184,4089
North Carolina,Alamance County,16,5160,2182,2978
North Carolina,Alamance County,17,3476,1370,2106
North Carolina,Alamance County,18,3680,1231,2449
North Carolina,Alexander County,0,37353,19008,18345
North Carolina,Alexander County,1,1826,920,906
North Carolina,Alexander County,2,1996,1044,952
North Carolina,Alexander County,3,2329,1206,1123
North Carolina,Alexander County,4,2068,1026,1042
North Carolina,Alexander County,5,2067,1135,932
North Carolina,Alexander County,6,2412,1350,1062
North Carolina,Alexander County,7,1957,1055,902
North Carolina,Alexander County,8,2235,1181,1054
North Carolina,Alexander County,9,2258,1240,1018
North Carolina,Alexander County,10,2653,1409,1244
North Carolina,Alexander County,11,2751,1377,1374
North Carolina,Alexander County,12,2731,1418,1313
North Carolina,Alexander County,13,2581,1248,1333
North Carolina,Alexander County,14,2334,1134,1200
North Carolina,Alexander County,15,2036,968,1068
North Carolina,Alexander County,16,1474,665,809
North Carolina,Alexander County,17,910,381,529
North Carolina,Alexander County,18,735,251,484
North Carolina,Alleghany County,0,11161,5528,5633
North Carolina,Alleghany County,1,518,267,251
North Carolina,Alleghany County,2,493,245,248
North Carolina,Alleghany County,3,574,288,286
North Carolina,Alleghany County,4,534,278,256
North Carolina,Alleghany County,5,527,269,258
North Carolina,Alleghany County,6,564,313,251
North Carolina,Alleghany County,7,480,235,245
North Carolina,Alleghany County,8,542,290,252
North Carolina,Alleghany County,9,569,296,273
North Carolina,Alleghany County,10,699,362,337
North Carolina,Alleghany County,11,755,371,384
North Carolina,Alleghany County,12,910,450,460
North Carolina,Alleghany County,13,973,464,509
North Carolina,Alleghany County,14,925,444,481
North Carolina,Alleghany County,15,813,398,415
North Carolina,Alleghany County,16,548,250,298
North Carolina,Alleghany County,17,386,171,215
North Carolina,Alleghany County,18,351,137,214
North Carolina,Anson County,0,24877,12939,11938
North Carolina,Anson County,1,1276,629,647
North Carolina,Anson County,2,1313,687,626
North Carolina,Anson County,3,1388,686,702
North Carolina,Anson County,4,1425,723,702
North Carolina,Anson County,5,1585,900,685
North Carolina,Anson County,6,1938,1189,749
North Carolina,Anson County,7,1626,979,647
North Carolina,Anson County,8,1508,888,620
North Carolina,Anson County,9,1510,857,653
North Carolina,Anson County,10,1559,821,738
North Carolina,Anson County,11,1727,849,878
North Carolina,Anson County,12,1671,851,820
North Carolina,Anson County,13,1757,895,862
North Carolina,Anson County,14,1524,725,799
North Carolina,Anson County,15,1190,550,640
North Carolina,Anson County,16,839,351,488
North Carolina,Anson County,17,529,193,336
North Carolina,Anson County,18,512,166,346
North Carolina,Ashe County,0,27109,13300,13809
North Carolina,Ashe County,1,1106,552,554
North Carolina,Ashe County,2,1359,703,656
North Carolina,Ashe County,3,1442,686,756
North Carolina,Ashe County,4,1370,693,677
North Carolina,Ashe County,5,1211,639,572
North Carolina,Ashe County,6,1373,741,632
North Carolina,Ashe County,7,1298,678,620
North Carolina,Ashe County,8,1473,742,731
North Carolina,Ashe County,9,1532,776,756
North Carolina,Ashe County,10,1720,879,841
North Carolina,Ashe County,11,1860,901,959
North Carolina,Ashe County,12,2153,1077,1076
North Carolina,Ashe County,13,2245,1061,1184
North Carolina,Ashe County,14,2203,1040,1163
North Carolina,Ashe County,15,1868,945,923
North Carolina,Ashe County,16,1306,577,729
North Carolina,Ashe County,17,854,375,479
North Carolina,Ashe County,18,736,235,501
North Carolina,Avery County,0,17505,9527,7978
North Carolina,Avery County,1,653,340,313
North Carolina,Avery County,2,702,355,347
North Carolina,Avery County,3,772,396,376
North Carolina,Avery County,4,994,462,532
North Carolina,Avery County,5,1151,639,512
North Carolina,Avery County,6,1135,729,406
North Carolina,Avery County,7,1050,681,369
North Carolina,Avery County,8,1078,659,419
North Carolina,Avery County,9,1134,690,444
North Carolina,Avery County,10,1284,805,479
North Carolina,Avery County,11,1177,690,487
North Carolina,Avery County,12,1262,670,592
North Carolina,Avery County,13,1222,590,632
North Carolina,Avery County,14,1230,612,618
North Carolina,Avery County,15,1033,491,542
North Carolina,Avery County,16,741,358,383
North Carolina,Avery County,17,455,204,251
North Carolina,Avery County,18,432,156,276
North Carolina,Beaufort County,0,47079,22487,24592
North Carolina,Beaufort County,1,2277,1148,1129
North Carolina,Beaufort County,2,2574,1309,1265
North Carolina,Beaufort County,3,2811,1425,1386
North Carolina,Beaufort County,4,2809,1438,1371
North Carolina,Beaufort County,5,2344,1167,1177
North Carolina,Beaufort County,6,2509,1190,1319
North Carolina,Beaufort County,7,2226,1096,1130
North Carolina,Beaufort County,8,2454,1157,1297
North Carolina,Beaufort County,9,2647,1274,1373
North Carolina,Beaufort County,10,2901,1371,1530
North Carolina,Beaufort County,11,3012,1468,1544
North Carolina,Beaufort County,12,3526,1660,1866
North Carolina,Beaufort County,13,3708,1727,1981
North Carolina,Beaufort County,14,3639,1708,1931
North Carolina,Beaufort County,15,3132,1465,1667
North Carolina,Beaufort County,16,2120,963,1157
North Carolina,Beaufort County,17,1224,545,679
North Carolina,Beaufort County,18,1166,376,790
North Carolina,Bertie County,0,19026,9599,9427
North Carolina,Bertie County,1,818,434,384
North Carolina,Bertie County,2,927,489,438
North Carolina,Bertie County,3,995,516,479
North Carolina,Bertie County,4,951,517,434
North Carolina,Bertie County,5,1120,655,465
North Carolina,Bertie County,6,1268,780,488
North Carolina,Bertie County,7,1155,672,483
North Carolina,Bertie County,8,958,493,465
North Carolina,Bertie County,9,1047,585,462
North Carolina,Bertie County,10,1101,558,543
North Carolina,Bertie County,11,1247,583,664
North Carolina,Bertie County,12,1489,710,779
North Carolina,Bertie County,13,1571,753,818
North Carolina,Bertie County,14,1384,621,763
North Carolina,Bertie County,15,1072,485,587
North Carolina,Bertie County,16,764,333,431
North Carolina,Bertie County,17,562,208,354
North Carolina,Bertie County,18,597,207,390
North Carolina,Bladen County,0,33190,15833,17357
North Carolina,Bladen County,1,1684,887,797
North Carolina,Bladen County,2,1821,908,913
North Carolina,Bladen County,3,2031,1021,1010
North Carolina,Bladen County,4,1951,977,974
North Carolina,Bladen County,5,1793,898,895
North Carolina,Bladen County,6,1916,981,935
North Carolina,Bladen County,7,1661,781,880
North Carolina,Bladen County,8,1803,878,925
North Carolina,Bladen County,9,1968,958,1010
North Carolina,Bladen County,10,2100,993,1107
North Carolina,Bladen County,11,2151,986,1165
North Carolina,Bladen County,12,2441,1145,1296
North Carolina,Bladen County,13,2623,1227,1396
North Carolina,Bladen County,14,2431,1142,1289
North Carolina,Bladen County,15,1954,921,1033
North Carolina,Bladen County,16,1260,535,725
North Carolina,Bladen County,17,862,347,515
North Carolina,Bladen County,18,740,248,492
North Carolina,Brunswick County,0,136744,65301,71443
North Carolina,Brunswick County,1,5304,2693,2611
North Carolina,Brunswick County,2,5833,3028,2805
North Carolina,Brunswick County,3,6145,3150,2995
North Carolina,Brunswick County,4,5634,2881,2753
North Carolina,Brunswick County,5,5257,2609,2648
North Carolina,Brunswick County,6,6225,3134,3091
North Carolina,Brunswick County,7,6081,2887,3194
North Carolina,Brunswick County,8,6623,3139,3484
North Carolina,Brunswick County,9,6375,3076,3299
North Carolina,Brunswick County,10,7290,3558,3732
North Carolina,Brunswick County,11,8073,3704,4369
North Carolina,Brunswick County,12,10750,4748,6002
North Carolina,Brunswick County,13,14084,6180,7904
North Carolina,Brunswick County,14,16137,7476,8661
North Carolina,Brunswick County,15,12979,6404,6575
North Carolina,Brunswick County,16,7467,3800,3667
North Carolina,Brunswick County,17,3569,1715,1854
North Carolina,Brunswick County,18,2918,1119,1799
North Carolina,Buncombe County,0,259103,124207,134896
North Carolina,Buncombe County,1,12875,6612,6263
North Carolina,Buncombe County,2,13061,6628,6433
North Carolina,Buncombe County,3,13534,6885,6649
North Carolina,Buncombe County,4,13881,7118,6763
North Carolina,Buncombe County,5,14116,6920,7196
North Carolina,Buncombe County,6,18299,8933,9366
North Carolina,Buncombe County,7,18040,8777,9263
North Carolina,Buncombe County,8,17822,8831,8991
North Carolina,Buncombe County,9,16603,8217,8386
North Carolina,Buncombe County,10,16947,8435,8512
North Carolina,Buncombe County,11,16244,7833,8411
North Carolina,Buncombe County,12,17533,8137,9396
North Carolina,Buncombe County,13,18320,8324,9996
North Carolina,Buncombe County,14,17148,7792,9356
North Carolina,Buncombe County,15,13566,6222,7344
North Carolina,Buncombe County,16,8897,3931,4966
North Carolina,Buncombe County,17,5836,2414,3422
North Carolina,Buncombe County,18,6381,2198,4183
North Carolina,Burke County,0,90382,45182,45200
North Carolina,Burke County,1,4366,2258,2108
North Carolina,Burke County,2,4458,2278,2180
North Carolina,Burke County,3,4931,2489,2442
North Carolina,Burke County,4,5821,3528,2293
North Carolina,Burke County,5,5360,3020,2340
North Carolina,Burke County,6,5718,2952,2766
North Carolina,Burke County,7,4819,2475,2344
North Carolina,Burke County,8,4964,2462,2502
North Carolina,Burke County,9,5108,2568,2540
North Carolina,Burke County,10,6293,3103,3190
North Carolina,Burke County,11,6685,3372,3313
North Carolina,Burke County,12,7162,3510,3652
North Carolina,Burke County,13,6403,3080,3323
North Carolina,Burke County,14,5721,2696,3025
North Carolina,Burke County,15,4690,2161,2529
North Carolina,Burke County,16,3539,1572,1967
North Carolina,Burke County,17,2229,922,1307
North Carolina,Burke County,18,2115,736,1379
North Carolina,Cabarrus County,0,211342,102992,108350
North Carolina,Cabarrus County,1,13684,7017,6667
North Carolina,Cabarrus County,2,14724,7577,7147
North Carolina,Cabarrus County,3,16074,8312,7762
North Carolina,Cabarrus County,4,14720,7509,7211
North Carolina,Cabarrus County,5,11884,6013,5871
North Carolina,Cabarrus County,6,13073,6426,6647
North Carolina,Cabarrus County,7,13546,6507,7039
North Carolina,Cabarrus County,8,15063,7143,7920
North Carolina,Cabarrus County,9,15026,7287,7739
North Carolina,Cabarrus County,10,16197,7912,8285
North Carolina,Cabarrus County,11,14676,7278,7398
North Carolina,Cabarrus County,12,13475,6566,6909
North Carolina,Cabarrus County,13,11252,5323,5929
North Carolina,Cabarrus County,14,9408,4354,5054
North Carolina,Cabarrus County,15,7436,3423,4013
North Carolina,Cabarrus County,16,4985,2135,2850
North Carolina,Cabarrus County,17,3137,1207,1930
North Carolina,Cabarrus County,18,2982,1003,1979
North Carolina,Caldwell County,0,82029,40637,41392
North Carolina,Caldwell County,1,4195,2164,2031
North Carolina,Caldwell County,2,4258,2201,2057
North Carolina,Caldwell County,3,4973,2560,2413
North Carolina,Caldwell County,4,4815,2495,2320
North Carolina,Caldwell County,5,4458,2326,2132
North Carolina,Caldwell County,6,5010,2509,2501
North Carolina,Caldwell County,7,4327,2178,2149
North Carolina,Caldwell County,8,4435,2240,2195
North Carolina,Caldwell County,9,4842,2457,2385
North Carolina,Caldwell County,10,6047,3058,2989
North Carolina,Caldwell County,11,6195,3147,3048
North Carolina,Caldwell County,12,6269,3115,3154
North Carolina,Caldwell County,13,5903,2849,3054
North Carolina,Caldwell County,14,5288,2534,2754
North Carolina,Caldwell County,15,4404,2040,2364
North Carolina,Caldwell County,16,3134,1454,1680
North Carolina,Caldwell County,17,1966,801,1165
North Carolina,Caldwell County,18,1510,509,1001
North Carolina,Camden County,0,10710,5336,5374
North Carolina,Camden County,1,567,280,287
North Carolina,Camden County,2,634,315,319
North Carolina,Camden County,3,770,397,373
North Carolina,Camden County,4,694,348,346
North Carolina,Camden County,5,492,264,228
North Carolina,Camden County,6,583,302,281
North Carolina,Camden County,7,619,307,312
North Carolina,Camden County,8,729,348,381
North Carolina,Camden County,9,704,347,357
North Carolina,Camden County,10,785,372,413
North Carolina,Camden County,11,791,421,370
North Carolina,Camden County,12,826,418,408
North Carolina,Camden County,13,766,396,370
North Carolina,Camden County,14,532,263,269
North Carolina,Camden County,15,487,240,247
North Carolina,Camden County,16,357,165,192
North Carolina,Camden County,17,189,81,108
North Carolina,Camden County,18,185,72,113
North Carolina,Carteret County,0,69524,34054,35470
North Carolina,Carteret County,1,2869,1492,1377
North Carolina,Carteret County,2,3267,1704,1563
North Carolina,Carteret County,3,3807,2049,1758
North Carolina,Carteret County,4,3504,1788,1716
North Carolina,Carteret County,5,3139,1644,1495
North Carolina,Carteret County,6,3535,1899,1636
North Carolina,Carteret County,7,3564,1751,1813
North Carolina,Carteret County,8,3796,1905,1891
North Carolina,Carteret County,9,3760,1851,1909
North Carolina,Carteret County,10,4331,2117,2214
North Carolina,Carteret County,11,4900,2403,2497
North Carolina,Carteret County,12,5647,2599,3048
North Carolina,Carteret County,13,6042,2786,3256
North Carolina,Carteret County,14,5776,2714,3062
North Carolina,Carteret County,15,4764,2331,2433
North Carolina,Carteret County,16,3148,1519,1629
North Carolina,Carteret County,17,1879,804,1075
North Carolina,Carteret County,18,1796,698,1098
North Carolina,Caswell County,0,22698,11525,11173
North Carolina,Caswell County,1,1097,557,540
North Carolina,Caswell County,2,1122,538,584
North Carolina,Caswell County,3,1238,636,602
North Carolina,Caswell County,4,1229,662,567
North Carolina,Caswell County,5,1198,673,525
North Carolina,Caswell County,6,1400,820,580
North Carolina,Caswell County,7,1218,676,542
North Carolina,Caswell County,8,1210,674,536
North Carolina,Caswell County,9,1289,707,582
North Carolina,Caswell County,10,1571,852,719
North Carolina,Caswell County,11,1624,808,816
North Carolina,Caswell County,12,1792,903,889
North Carolina,Caswell County,13,1829,858,971
North Carolina,Caswell County,14,1635,753,882
North Carolina,Caswell County,15,1259,619,640
North Carolina,Caswell County,16,865,390,475
North Carolina,Caswell County,17,614,231,383
North Carolina,Caswell County,18,508,168,340
North Carolina,Catawba County,0,158652,77479,81173
North Carolina,Catawba County,1,8919,4443,4476
North Carolina,Catawba County,2,9460,4789,4671
North Carolina,Catawba County,3,10272,5213,5059
North Carolina,Catawba County,4,10281,5272,5009
North Carolina,Catawba County,5,9434,4750,4684
North Carolina,Catawba County,6,9994,4996,4998
North Carolina,Catawba County,7,8827,4375,4452
North Carolina,Catawba County,8,9060,4452,4608
North Carolina,Catawba County,9,9468,4733,4735
North Carolina,Catawba County,10,11148,5419,5729
North Carolina,Catawba County,11,11326,5676,5650
North Carolina,Catawba County,12,11604,5792,5812
North Carolina,Catawba County,13,10522,5053,5469
North Carolina,Catawba County,14,9184,4308,4876
North Carolina,Catawba County,15,7719,3594,4125
North Carolina,Catawba County,16,5264,2315,2949
North Carolina,Catawba County,17,3206,1328,1878
North Carolina,Catawba County,18,2964,971,1993
North Carolina,Chatham County,0,73139,34953,38186
North Carolina,Chatham County,1,3573,1755,1818
North Carolina,Chatham County,2,3968,1970,1998
North Carolina,Chatham County,3,4579,2276,2303
North Carolina,Chatham County,4,4012,2015,1997
North Carolina,Chatham County,5,3234,1649,1585
North Carolina,Chatham County,6,3172,1573,1599
North Carolina,Chatham County,7,3397,1611,1786
North Carolina,Chatham County,8,4027,1933,2094
North Carolina,Chatham County,9,4300,2127,2173
North Carolina,Chatham County,10,5089,2522,2567
North Carolina,Chatham County,11,4996,2443,2553
North Carolina,Chatham County,12,5570,2657,2913
North Carolina,Chatham County,13,5365,2535,2830
North Carolina,Chatham County,14,5442,2501,2941
North Carolina,Chatham County,15,4786,2151,2635
North Carolina,Chatham County,16,3306,1486,1820
North Carolina,Chatham County,17,2122,882,1240
North Carolina,Chatham County,18,2201,867,1334
North Carolina,Cherokee County,0,28383,13832,14551
North Carolina,Cherokee County,1,1194,628,566
North Carolina,Cherokee County,2,1254,633,621
North Carolina,Cherokee County,3,1418,743,675
North Carolina,Cherokee County,4,1379,729,650
North Carolina,Cherokee County,5,1226,631,595
North Carolina,Cherokee County,6,1355,662,693
North Carolina,Cherokee County,7,1185,597,588
North Carolina,Cherokee County,8,1359,643,716
North Carolina,Cherokee County,9,1417,685,732
North Carolina,Cherokee County,10,1699,850,849
North Carolina,Cherokee County,11,1834,912,922
North Carolina,Cherokee County,12,2186,1034,1152
North Carolina,Cherokee County,13,2480,1146,1334
North Carolina,Cherokee County,14,2663,1278,1385
North Carolina,Cherokee County,15,2321,1071,1250
North Carolina,Cherokee County,16,1659,820,839
North Carolina,Cherokee County,17,968,466,502
North Carolina,Cherokee County,18,786,304,482
North Carolina,Chowan County,0,14029,6677,7352
North Carolina,Chowan County,1,663,344,319
North Carolina,Chowan County,2,751,381,370
North Carolina,Chowan County,3,873,431,442
North Carolina,Chowan County,4,830,425,405
North Carolina,Chowan County,5,699,378,321
North Carolina,Chowan County,6,730,395,335
North Carolina,Chowan County,7,733,345,388
North Carolina,Chowan County,8,720,345,375
North Carolina,Chowan County,9,749,355,394
North Carolina,Chowan County,10,754,373,381
North Carolina,Chowan County,11,837,370,467
North Carolina,Chowan County,12,1086,507,579
North Carolina,Chowan County,13,1148,542,606
North Carolina,Chowan County,14,1084,479,605
North Carolina,Chowan County,15,895,397,498
North Carolina,Chowan County,16,605,290,315
North Carolina,Chowan County,17,447,182,265
North Carolina,Chowan County,18,425,138,287
North Carolina,Clay County,0,11139,5435,5704
North Carolina,Clay County,1,481,246,235
North Carolina,Clay County,2,492,266,226
North Carolina,Clay County,3,573,294,279
North Carolina,Clay County,4,569,309,260
North Carolina,Clay County,5,440,250,190
North Carolina,Clay County,6,493,258,235
North Carolina,Clay County,7,435,218,217
North Carolina,Clay County,8,520,260,260
North Carolina,Clay County,9,535,255,280
North Carolina,Clay County,10,650,321,329
North Carolina,Clay County,11,665,312,353
North Carolina,Clay County,12,821,401,420
North Carolina,Clay County,13,1001,451,550
North Carolina,Clay County,14,1100,494,606
North Carolina,Clay County,15,997,461,536
North Carolina,Clay County,16,683,330,353
North Carolina,Clay County,17,369,199,170
North Carolina,Clay County,18,315,110,205
North Carolina,Cleveland County,0,97645,46924,50721
North Carolina,Cleveland County,1,5460,2782,2678
North Carolina,Cleveland County,2,5880,2965,2915
North Carolina,Cleveland County,3,6325,3186,3139
North Carolina,Cleveland County,4,6409,3281,3128
North Carolina,Cleveland County,5,6155,3075,3080
North Carolina,Cleveland County,6,6343,3125,3218
North Carolina,Cleveland County,7,5138,2466,2672
North Carolina,Cleveland County,8,5184,2388,2796
North Carolina,Cleveland County,9,5363,2638,2725
North Carolina,Cleveland County,10,6550,3107,3443
North Carolina,Cleveland County,11,6991,3414,3577
North Carolina,Cleveland County,12,6965,3388,3577
North Carolina,Cleveland County,13,6698,3202,3496
North Carolina,Cleveland County,14,5897,2737,3160
North Carolina,Cleveland County,15,4968,2229,2739
North Carolina,Cleveland County,16,3447,1475,1972
North Carolina,Cleveland County,17,2140,854,1286
North Carolina,Cleveland County,18,1732,612,1120
North Carolina,Columbus County,0,55655,27545,28110
North Carolina,Columbus County,1,2901,1497,1404
North Carolina,Columbus County,2,3094,1483,1611
North Carolina,Columbus County,3,3434,1768,1666
North Carolina,Columbus County,4,3433,1715,1718
North Carolina,Columbus County,5,3435,1856,1579
North Carolina,Columbus County,6,3654,2068,1586
North Carolina,Columbus County,7,3202,1677,1525
North Carolina,Columbus County,8,3273,1759,1514
North Carolina,Columbus County,9,3216,1672,1544
North Carolina,Columbus County,10,3525,1771,1754
North Carolina,Columbus County,11,3640,1789,1851
North Carolina,Columbus County,12,3861,1819,2042
North Carolina,Columbus County,13,3796,1855,1941
North Carolina,Columbus County,14,3462,1620,1842
North Carolina,Columbus County,15,3112,1400,1712
North Carolina,Columbus County,16,2091,902,1189
North Carolina,Columbus County,17,1385,537,848
North Carolina,Columbus County,18,1141,357,784
North Carolina,Craven County,0,102912,52028,50884
North Carolina,Craven County,1,6440,3274,3166
North Carolina,Craven County,2,6131,3125,3006
North Carolina,Craven County,3,6082,2984,3098
North Carolina,Craven County,4,6132,3235,2897
North Carolina,Craven County,5,9865,6388,3477
North Carolina,Craven County,6,7732,4291,3441
North Carolina,Craven County,7,6178,3109,3069
North Carolina,Craven County,8,5961,3112,2849
North Carolina,Craven County,9,5145,2595,2550
North Carolina,Craven County,10,5221,2553,2668
North Carolina,Craven County,11,5377,2567,2810
North Carolina,Craven County,12,6464,2981,3483
North Carolina,Craven County,13,6584,3058,3526
North Carolina,Craven County,14,6034,2748,3286
North Carolina,Craven County,15,5302,2487,2815
North Carolina,Craven County,16,3598,1658,1940
North Carolina,Craven County,17,2340,1035,1305
North Carolina,Craven County,18,2326,828,1498
North Carolina,Cumberland County,0,332330,164493,167837
North Carolina,Cumberland County,1,25155,12721,12434
North Carolina,Cumberland County,2,22957,11731,11226
North Carolina,Cumberland County,3,21434,10847,10587
North Carolina,Cumberland County,4,22660,11983,10677
North Carolina,Cumberland County,5,32901,19592,13309
North Carolina,Cumberland County,6,32283,17462,14821
North Carolina,Cumberland County,7,24708,12272,12436
North Carolina,Cumberland County,8,21571,10400,11171
North Carolina,Cumberland County,9,17849,8403,9446
North Carolina,Cumberland County,10,17797,8144,9653
North Carolina,Cumberland County,11,17944,8262,9682
North Carolina,Cumberland County,12,18641,8363,10278
North Carolina,Cumberland County,13,16813,7642,9171
North Carolina,Cumberland County,14,13279,6016,7263
North Carolina,Cumberland County,15,10166,4527,5639
North Carolina,Cumberland County,16,7187,2898,4289
North Carolina,Cumberland County,17,4784,1857,2927
North Carolina,Cumberland County,18,4201,1373,2828
North Carolina,Currituck County,0,27072,13404,13668
North Carolina,Currituck County,1,1545,798,747
North Carolina,Currituck County,2,1679,838,841
North Carolina,Currituck County,3,1766,891,875
North Carolina,Currituck County,4,1582,792,790
North Carolina,Currituck County,5,1296,660,636
North Carolina,Currituck County,6,1586,806,780
North Carolina,Currituck County,7,1733,846,887
North Carolina,Currituck County,8,1644,812,832
North Carolina,Currituck County,9,1563,754,809
North Carolina,Currituck County,10,1891,972,919
North Carolina,Currituck County,11,2049,986,1063
North Carolina,Currituck County,12,2314,1156,1158
North Carolina,Currituck County,13,2026,1008,1018
North Carolina,Currituck County,14,1622,770,852
North Carolina,Currituck County,15,1199,596,603
North Carolina,Currituck County,16,795,396,399
North Carolina,Currituck County,17,421,189,232
North Carolina,Currituck County,18,361,134,227
North Carolina,Dare County,0,36501,17998,18503
North Carolina,Dare County,1,1647,856,791
North Carolina,Dare County,2,1845,918,927
North Carolina,Dare County,3,2184,1127,1057
North Carolina,Dare County,4,1857,962,895
North Carolina,Dare County,5,1606,852,754
North Carolina,Dare County,6,1773,927,846
North Carolina,Dare County,7,1929,975,954
North Carolina,Dare County,8,2212,1066,1146
North Carolina,Dare County,9,2142,1075,1067
North Carolina,Dare County,10,2422,1196,1226
North Carolina,Dare County,11,2574,1266,1308
North Carolina,Dare County,12,3076,1441,1635
North Carolina,Dare County,13,3415,1647,1768
North Carolina,Dare County,14,2917,1388,1529
North Carolina,Dare County,15,2196,1078,1118
North Carolina,Dare County,16,1257,599,658
North Carolina,Dare County,17,768,358,410
North Carolina,Dare County,18,681,267,414
North Carolina,Davidson County,0,166614,81509,85105
North Carolina,Davidson County,1,9297,4692,4605
North Carolina,Davidson County,2,9578,4947,4631
North Carolina,Davidson County,3,10969,5732,5237
North Carolina,Davidson County,4,10344,5274,5070
North Carolina,Davidson County,5,9078,4537,4541
North Carolina,Davidson County,6,10217,5104,5113
North Carolina,Davidson County,7,8992,4434,4558
North Carolina,Davidson County,8,9594,4646,4948
North Carolina,Davidson County,9,9737,4672,5065
North Carolina,Davidson County,10,12217,6024,6193
North Carolina,Davidson County,11,12321,6141,6180
North Carolina,Davidson County,12,12507,6176,6331
North Carolina,Davidson County,13,11386,5558,5828
North Carolina,Davidson County,14,9566,4536,5030
North Carolina,Davidson County,15,8259,3818,4441
North Carolina,Davidson County,16,5670,2575,3095
North Carolina,Davidson County,17,3683,1525,2158
North Carolina,Davidson County,18,3199,1118,2081
North Carolina,Davie County,0,42733,20849,21884
North Carolina,Davie County,1,2086,1078,1008
North Carolina,Davie County,2,2448,1265,1183
North Carolina,Davie County,3,2725,1405,1320
North Carolina,Davie County,4,2664,1348,1316
North Carolina,Davie County,5,2252,1172,1080
North Carolina,Davie County,6,2139,1068,1071
North Carolina,Davie County,7,2006,990,1016
North Carolina,Davie County,8,2278,1069,1209
North Carolina,Davie County,9,2460,1203,1257
North Carolina,Davie County,10,3101,1521,1580
North Carolina,Davie County,11,3209,1569,1640
North Carolina,Davie County,12,3218,1581,1637
North Carolina,Davie County,13,3103,1501,1602
North Carolina,Davie County,14,2805,1336,1469
North Carolina,Davie County,15,2283,1104,1179
North Carolina,Davie County,16,1612,727,885
North Carolina,Davie County,17,1156,492,664
North Carolina,Davie County,18,1188,420,768
North Carolina,Duplin County,0,58856,28664,30192
North Carolina,Duplin County,1,3604,1865,1739
North Carolina,Duplin County,2,3873,1936,1937
North Carolina,Duplin County,3,4109,2113,1996
North Carolina,Duplin County,4,3721,1978,1743
North Carolina,Duplin County,5,3341,1710,1631
North Carolina,Duplin County,6,3496,1755,1741
North Carolina,Duplin County,7,3173,1526,1647
North Carolina,Duplin County,8,3373,1692,1681
North Carolina,Duplin County,9,3517,1734,1783
North Carolina,Duplin County,10,3743,1797,1946
North Carolina,Duplin County,11,3683,1813,1870
North Carolina,Duplin County,12,4219,2020,2199
North Carolina,Duplin County,13,3998,1854,2144
North Carolina,Duplin County,14,3485,1667,1818
North Carolina,Duplin County,15,2883,1349,1534
North Carolina,Duplin County,16,1954,866,1088
North Carolina,Duplin County,17,1299,523,776
North Carolina,Duplin County,18,1385,466,919
North Carolina,Durham County,0,316739,151221,165518
North Carolina,Durham County,1,20417,10478,9939
North Carolina,Durham County,2,18116,9275,8841
North Carolina,Durham County,3,17262,8790,8472
North Carolina,Durham County,4,20326,9908,10418
North Carolina,Durham County,5,21487,10598,10889
North Carolina,Durham County,6,29560,14166,15394
North Carolina,Durham County,7,28155,13717,14438
North Carolina,Durham County,8,24157,11749,12408
North Carolina,Durham County,9,20254,9845,10409
North Carolina,Durham County,10,20176,9823,10353
North Carolina,Durham County,11,18458,8784,9674
North Carolina,Durham County,12,18926,8589,10337
North Carolina,Durham County,13,17975,8129,9846
North Carolina,Durham County,14,14976,6540,8436
North Carolina,Durham County,15,10734,4682,6052
North Carolina,Durham County,16,6637,2832,3805
North Carolina,Durham County,17,4240,1750,2490
North Carolina,Durham County,18,4883,1566,3317
North Carolina,Edgecombe County,0,52005,24036,27969
North Carolina,Edgecombe County,1,2922,1472,1450
North Carolina,Edgecombe County,2,3322,1678,1644
North Carolina,Edgecombe County,3,3386,1777,1609
North Carolina,Edgecombe County,4,3206,1620,1586
North Carolina,Edgecombe County,5,3024,1461,1563
North Carolina,Edgecombe County,6,3386,1570,1816
North Carolina,Edgecombe County,7,2751,1247,1504
North Carolina,Edgecombe County,8,2917,1311,1606
North Carolina,Edgecombe County,9,2702,1257,1445
North Carolina,Edgecombe County,10,3005,1362,1643
North Carolina,Edgecombe County,11,3264,1485,1779
North Carolina,Edgecombe County,12,3879,1774,2105
North Carolina,Edgecombe County,13,3988,1788,2200
North Carolina,Edgecombe County,14,3435,1521,1914
North Carolina,Edgecombe County,15,2687,1181,1506
North Carolina,Edgecombe County,16,1709,705,1004
North Carolina,Edgecombe County,17,1219,459,760
North Carolina,Edgecombe County,18,1203,368,835
North Carolina,Forsyth County,0,379099,179783,199316
North Carolina,Forsyth County,1,22538,11581,10957
North Carolina,Forsyth County,2,24127,12338,11789
North Carolina,Forsyth County,3,25172,12815,12357
North Carolina,Forsyth County,4,26836,13071,13765
North Carolina,Forsyth County,5,24866,11994,12872
North Carolina,Forsyth County,6,26059,12497,13562
North Carolina,Forsyth County,7,24210,11516,12694
North Carolina,Forsyth County,8,23163,11016,12147
North Carolina,Forsyth County,9,22299,10582,11717
North Carolina,Forsyth County,10,24763,11732,13031
North Carolina,Forsyth County,11,24974,12043,12931
North Carolina,Forsyth County,12,26019,12194,13825
North Carolina,Forsyth County,13,23456,10667,12789
North Carolina,Forsyth County,14,20070,9031,11039
North Carolina,Forsyth County,15,15458,6871,8587
North Carolina,Forsyth County,16,10417,4440,5977
North Carolina,Forsyth County,17,7128,2905,4223
North Carolina,Forsyth County,18,7544,2490,5054
North Carolina,Franklin County,0,67560,33391,34169
North Carolina,Franklin County,1,3768,1879,1889
North Carolina,Franklin County,2,3942,2011,1931
North Carolina,Franklin County,3,4396,2247,2149
North Carolina,Franklin County,4,4378,2286,2092
North Carolina,Franklin County,5,3837,2126,1711
North Carolina,Franklin County,6,4126,2130,1996
North Carolina,Franklin County,7,3790,1876,1914
North Carolina,Franklin County,8,4039,2046,1993
North Carolina,Franklin County,9,4148,2104,2044
North Carolina,Franklin County,10,4900,2403,2497
North Carolina,Franklin County,11,4879,2404,2475
North Carolina,Franklin County,12,5221,2545,2676
North Carolina,Franklin County,13,4784,2304,2480
North Carolina,Franklin County,14,3928,1844,2084
North Carolina,Franklin County,15,3011,1423,1588
North Carolina,Franklin County,16,1939,829,1110
North Carolina,Franklin County,17,1308,554,754
North Carolina,Franklin County,18,1166,380,786
North Carolina,Gaston County,0,222846,107389,115457
North Carolina,Gaston County,1,13216,6757,6459
North Carolina,Gaston County,2,13827,7011,6816
North Carolina,Gaston County,3,14422,7342,7080
North Carolina,Gaston County,4,13936,7207,6729
North Carolina,Gaston County,5,12765,6532,6233
North Carolina,Gaston County,6,15528,7593,7935
North Carolina,Gaston County,7,14248,6820,7428
North Carolina,Gaston County,8,13667,6520,7147
North Carolina,Gaston County,9,13813,6559,7254
North Carolina,Gaston County,10,16417,7915,8502
North Carolina,Gaston County,11,15909,7862,8047
North Carolina,Gaston County,12,15329,7432,7897
North Carolina,Gaston County,13,13982,6592,7390
North Carolina,Gaston County,14,11907,5540,6367
North Carolina,Gaston County,15,9492,4197,5295
North Carolina,Gaston County,16,6279,2629,3650
North Carolina,Gaston County,17,4195,1648,2547
North Carolina,Gaston County,18,3914,1233,2681
North Carolina,Gates County,0,11573,5731,5842
North Carolina,Gates County,1,535,294,241
North Carolina,Gates County,2,602,305,297
North Carolina,Gates County,3,741,388,353
North Carolina,Gates County,4,705,371,334
North Carolina,Gates County,5,580,324,256
North Carolina,Gates County,6,647,331,316
North Carolina,Gates County,7,592,285,307
North Carolina,Gates County,8,604,282,322
North Carolina,Gates County,9,554,266,288
North Carolina,Gates County,10,784,369,415
North Carolina,Gates County,11,916,472,444
North Carolina,Gates County,12,1078,529,549
North Carolina,Gates County,13,895,445,450
North Carolina,Gates County,14,709,326,383
North Carolina,Gates County,15,661,316,345
North Carolina,Gates County,16,433,215,218
North Carolina,Gates County,17,261,115,146
North Carolina,Gates County,18,276,98,178
North Carolina,Graham County,0,8484,4239,4245
North Carolina,Graham County,1,408,208,200
North Carolina,Graham County,2,442,237,205
North Carolina,Graham County,3,528,298,230
North Carolina,Graham County,4,503,264,239
North Carolina,Graham County,5,411,217,194
North Carolina,Graham County,6,468,223,245
North Carolina,Graham County,7,420,209,211
North Carolina,Graham County,8,467,232,235
North Carolina,Graham County,9,454,241,213
North Carolina,Graham County,10,521,268,253
North Carolina,Graham County,11,587,296,291
North Carolina,Graham County,12,601,284,317
North Carolina,Graham County,13,655,325,330
North Carolina,Graham County,14,581,282,299
North Carolina,Graham County,15,513,238,275
North Carolina,Graham County,16,419,209,210
North Carolina,Graham County,17,260,118,142
North Carolina,Graham County,18,246,90,156
North Carolina,Granville County,0,60115,30635,29480
North Carolina,Granville County,1,3031,1545,1486
North Carolina,Granville County,2,3227,1631,1596
North Carolina,Granville County,3,3759,1977,1782
North Carolina,Granville County,4,3725,2067,1658
North Carolina,Granville County,5,3597,2126,1471
North Carolina,Granville County,6,3680,1871,1809
North Carolina,Granville County,7,3455,1827,1628
North Carolina,Granville County,8,3533,1863,1670
North Carolina,Granville County,9,3733,1891,1842
North Carolina,Granville County,10,4476,2323,2153
North Carolina,Granville County,11,4778,2441,2337
North Carolina,Granville County,12,4684,2388,2296
North Carolina,Granville County,13,4144,2069,2075
North Carolina,Granville County,14,3525,1684,1841
North Carolina,Granville County,15,2725,1277,1448
North Carolina,Granville County,16,1773,817,956
North Carolina,Granville County,17,1178,494,684
North Carolina,Granville County,18,1092,344,748
North Carolina,Greene County,0,21012,11481,9531
North Carolina,Greene County,1,1014,515,499
North Carolina,Greene County,2,1170,609,561
North Carolina,Greene County,3,1300,659,641
North Carolina,Greene County,4,1180,624,556
North Carolina,Greene County,5,1337,809,528
North Carolina,Greene County,6,1502,980,522
North Carolina,Greene County,7,1456,937,519
North Carolina,Greene County,8,1433,932,501
North Carolina,Greene County,9,1431,853,578
North Carolina,Greene County,10,1359,807,552
North Carolina,Greene County,11,1350,751,599
North Carolina,Greene County,12,1537,792,745
North Carolina,Greene County,13,1462,688,774
North Carolina,Greene County,14,1229,608,621
North Carolina,Greene County,15,902,445,457
North Carolina,Greene County,16,566,229,337
North Carolina,Greene County,17,389,134,255
North Carolina,Greene County,18,395,109,286
North Carolina,Guilford County,0,533670,252687,280983
North Carolina,Guilford County,1,31411,16142,15269
North Carolina,Guilford County,2,32503,16490,16013
North Carolina,Guilford County,3,34248,17329,16919
North Carolina,Guilford County,4,40311,19307,21004
North Carolina,Guilford County,5,38057,18223,19834
North Carolina,Guilford County,6,39484,18944,20540
North Carolina,Guilford County,7,34339,16058,18281
North Carolina,Guilford County,8,33453,15726,17727
North Carolina,Guilford County,9,31871,15051,16820
North Carolina,Guilford County,10,35898,17134,18764
North Carolina,Guilford County,11,34757,16518,18239
North Carolina,Guilford County,12,34972,16647,18325
North Carolina,Guilford County,13,31417,14654,16763
North Carolina,Guilford County,14,26654,12019,14635
North Carolina,Guilford County,15,20943,9361,11582
North Carolina,Guilford County,16,14171,5990,8181
North Carolina,Guilford County,17,9293,3747,5546
North Carolina,Guilford County,18,9888,3347,6541
North Carolina,Halifax County,0,50574,24282,26292
North Carolina,Halifax County,1,2772,1403,1369
North Carolina,Halifax County,2,2880,1482,1398
North Carolina,Halifax County,3,3164,1627,1537
North Carolina,Halifax County,4,3035,1523,1512
North Carolina,Halifax County,5,2715,1399,1316
North Carolina,Halifax County,6,3247,1667,1580
North Carolina,Halifax County,7,2715,1354,1361
North Carolina,Halifax County,8,2795,1385,1410
North Carolina,Halifax County,9,2572,1305,1267
North Carolina,Halifax County,10,3002,1432,1570
North Carolina,Halifax County,11,3550,1714,1836
North Carolina,Halifax County,12,3921,1871,2050
North Carolina,Halifax County,13,3727,1692,2035
North Carolina,Halifax County,14,3414,1579,1835
North Carolina,Halifax County,15,2627,1159,1468
North Carolina,Halifax County,16,1891,804,1087
North Carolina,Halifax County,17,1312,506,806
North Carolina,Halifax County,18,1235,380,855
North Carolina,Harnett County,0,134214,66478,67736
North Carolina,Harnett County,1,9938,5191,4747
North Carolina,Harnett County,2,10012,5118,4894
North Carolina,Harnett County,3,9645,4860,4785
North Carolina,Harnett County,4,9084,4538,4546
North Carolina,Harnett County,5,8248,4152,4096
North Carolina,Harnett County,6,10325,5229,5096
North Carolina,Harnett County,7,10797,5516,5281
North Carolina,Harnett County,8,9865,5014,4851
North Carolina,Harnett County,9,8364,4196,4168
North Carolina,Harnett County,10,8452,4274,4178
North Carolina,Harnett County,11,8063,4045,4018
North Carolina,Harnett County,12,7778,3829,3949
North Carolina,Harnett County,13,6920,3299,3621
North Carolina,Harnett County,14,5754,2678,3076
North Carolina,Harnett County,15,4456,1967,2489
North Carolina,Harnett County,16,3052,1326,1726
North Carolina,Harnett County,17,1932,756,1176
North Carolina,Harnett County,18,1529,490,1039
North Carolina,Haywood County,0,61971,29956,32015
North Carolina,Haywood County,1,2998,1574,1424
North Carolina,Haywood County,2,3062,1593,1469
North Carolina,Haywood County,3,3216,1690,1526
North Carolina,Haywood County,4,3104,1635,1469
North Carolina,Haywood County,5,2831,1422,1409
North Carolina,Haywood County,6,3664,1880,1784
North Carolina,Haywood County,7,3422,1635,1787
North Carolina,Haywood County,8,3356,1639,1717
North Carolina,Haywood County,9,3402,1687,1715
North Carolina,Haywood County,10,3961,1921,2040
North Carolina,Haywood County,11,4238,2045,2193
North Carolina,Haywood County,12,4704,2188,2516
North Carolina,Haywood County,13,4765,2233,2532
North Carolina,Haywood County,14,4614,2168,2446
North Carolina,Haywood County,15,4112,1891,2221
North Carolina,Haywood County,16,2886,1322,1564
North Carolina,Haywood County,17,1920,843,1077
North Carolina,Haywood County,18,1716,590,1126
North Carolina,Henderson County,0,116748,56031,60717
North Carolina,Henderson County,1,5623,2865,2758
North Carolina,Henderson County,2,6000,3076,2924
North Carolina,Henderson County,3,6510,3314,3196
North Carolina,Henderson County,4,6109,3093,3016
North Carolina,Henderson County,5,5471,2733,2738
North Carolina,Henderson County,6,6015,3015,3000
North Carolina,Henderson County,7,6078,2960,3118
North Carolina,Henderson County,8,6388,3157,3231
North Carolina,Henderson County,9,6492,3150,3342
North Carolina,Henderson County,10,7361,3687,3674
North Carolina,Henderson County,11,7505,3675,3830
North Carolina,Henderson County,12,8292,3839,4453
North Carolina,Henderson County,13,8830,4084,4746
North Carolina,Henderson County,14,8919,4021,4898
North Carolina,Henderson County,15,7973,3615,4358
North Carolina,Henderson County,16,5903,2699,3204
North Carolina,Henderson County,17,3591,1606,1985
North Carolina,Henderson County,18,3688,1442,2246
North Carolina,Hertford County,0,23659,11623,12036
North Carolina,Hertford County,1,1084,558,526
North Carolina,Hertford County,2,1220,591,629
North Carolina,Hertford County,3,1340,691,649
North Carolina,Hertford County,4,1894,1021,873
North Carolina,Hertford County,5,1561,795,766
North Carolina,Hertford County,6,1554,854,700
North Carolina,Hertford County,7,1309,739,570
North Carolina,Hertford County,8,1310,674,636
North Carolina,Hertford County,9,1269,662,607
North Carolina,Hertford County,10,1295,676,619
North Carolina,Hertford County,11,1514,733,781
North Carolina,Hertford County,12,1786,854,932
North Carolina,Hertford County,13,1844,836,1008
North Carolina,Hertford County,14,1504,715,789
North Carolina,Hertford County,15,1162,502,660
North Carolina,Hertford County,16,827,329,498
North Carolina,Hertford County,17,603,219,384
North Carolina,Hertford County,18,583,174,409
North Carolina,Hoke County,0,54764,27067,27697
North Carolina,Hoke County,1,4600,2382,2218
North Carolina,Hoke County,2,4408,2232,2176
North Carolina,Hoke County,3,3849,1983,1866
North Carolina,Hoke County,4,3303,1717,1586
North Carolina,Hoke County,5,3173,1600,1573
North Carolina,Hoke County,6,4892,2458,2434
North Carolina,Hoke County,7,4796,2441,2355
North Carolina,Hoke County,8,4411,2201,2210
North Carolina,Hoke County,9,3388,1657,1731
North Carolina,Hoke County,10,3347,1672,1675
North Carolina,Hoke County,11,3094,1478,1616
North Carolina,Hoke County,12,3198,1521,1677
North Carolina,Hoke County,13,2797,1272,1525
North Carolina,Hoke County,14,2184,1013,1171
North Carolina,Hoke County,15,1422,656,766
North Carolina,Hoke County,16,898,409,489
North Carolina,Hoke County,17,559,227,332
North Carolina,Hoke County,18,445,148,297
North Carolina,Hyde County,0,5230,2862,2368
North Carolina,Hyde County,1,206,105,101
North Carolina,Hyde County,2,242,128,114
North Carolina,Hyde County,3,256,126,130
North Carolina,Hyde County,4,251,120,131
North Carolina,Hyde County,5,282,186,96
North Carolina,Hyde County,6,329,217,112
North Carolina,Hyde County,7,364,257,107
North Carolina,Hyde County,8,349,230,119
North Carolina,Hyde County,9,352,226,126
North Carolina,Hyde County,10,361,200,161
North Carolina,Hyde County,11,317,157,160
North Carolina,Hyde County,12,378,191,187
North Carolina,Hyde County,13,462,223,239
North Carolina,Hyde County,14,377,193,184
North Carolina,Hyde County,15,261,132,129
North Carolina,Hyde County,16,189,90,99
North Carolina,Hyde County,17,142,49,93
North Carolina,Hyde County,18,112,32,80
North Carolina,Iredell County,0,178435,87826,90609
North Carolina,Iredell County,1,9937,5111,4826
North Carolina,Iredell County,2,10922,5581,5341
North Carolina,Iredell County,3,12448,6327,6121
North Carolina,Iredell County,4,11799,6104,5695
North Carolina,Iredell County,5,10235,5241,4994
North Carolina,Iredell County,6,10878,5574,5304
North Carolina,Iredell County,7,10217,5084,5133
North Carolina,Iredell County,8,10995,5381,5614
North Carolina,Iredell County,9,11518,5667,5851
North Carolina,Iredell County,10,13436,6601,6835
North Carolina,Iredell County,11,13359,6584,6775
North Carolina,Iredell County,12,13198,6425,6773
North Carolina,Iredell County,13,11190,5481,5709
North Carolina,Iredell County,14,9374,4461,4913
North Carolina,Iredell County,15,7816,3622,4194
North Carolina,Iredell County,16,5190,2326,2864
North Carolina,Iredell County,17,3296,1381,1915
North Carolina,Iredell County,18,2627,875,1752
North Carolina,Jackson County,0,43327,21253,22074
North Carolina,Jackson County,1,1927,964,963
North Carolina,Jackson County,2,1994,997,997
North Carolina,Jackson County,3,2018,1041,977
North Carolina,Jackson County,4,4094,2011,2083
North Carolina,Jackson County,5,5078,2520,2558
North Carolina,Jackson County,6,2663,1367,1296
North Carolina,Jackson County,7,2326,1228,1098
North Carolina,Jackson County,8,2266,1178,1088
North Carolina,Jackson County,9,2074,972,1102
North Carolina,Jackson County,10,2404,1235,1169
North Carolina,Jackson County,11,2329,1157,1172
North Carolina,Jackson County,12,2783,1309,1474
North Carolina,Jackson County,13,2844,1354,1490
North Carolina,Jackson County,14,2825,1309,1516
North Carolina,Jackson County,15,2394,1154,1240
North Carolina,Jackson County,16,1597,786,811
North Carolina,Jackson County,17,911,376,535
North Carolina,Jackson County,18,800,295,505
North Carolina,Johnston County,0,202675,99289,103386
North Carolina,Johnston County,1,12907,6627,6280
North Carolina,Johnston County,2,14164,7135,7029
North Carolina,Johnston County,3,15569,8030,7539
North Carolina,Johnston County,4,13743,7066,6677
North Carolina,Johnston County,5,11051,5642,5409
North Carolina,Johnston County,6,12317,6134,6183
North Carolina,Johnston County,7,12654,6178,6476
North Carolina,Johnston County,8,13784,6741,7043
North Carolina,Johnston County,9,14352,6957,7395
North Carolina,Johnston County,10,16025,7868,8157
North Carolina,Johnston County,11,14558,7242,7316
North Carolina,Johnston County,12,13208,6519,6689
North Carolina,Johnston County,13,11354,5382,5972
North Carolina,Johnston County,14,9586,4367,5219
North Carolina,Johnston County,15,7614,3473,4141
North Carolina,Johnston County,16,4679,2063,2616
North Carolina,Johnston County,17,2808,1131,1677
North Carolina,Johnston County,18,2302,734,1568
North Carolina,Jones County,0,9637,4721,4916
North Carolina,Jones County,1,469,276,193
North Carolina,Jones County,2,470,233,237
North Carolina,Jones County,3,528,269,259
North Carolina,Jones County,4,509,251,258
North Carolina,Jones County,5,469,249,220
North Carolina,Jones County,6,559,299,260
North Carolina,Jones County,7,513,267,246
North Carolina,Jones County,8,535,276,259
North Carolina,Jones County,9,471,223,248
North Carolina,Jones County,10,584,289,295
North Carolina,Jones County,11,672,320,352
North Carolina,Jones County,12,806,380,426
North Carolina,Jones County,13,874,421,453
North Carolina,Jones County,14,702,324,378
North Carolina,Jones County,15,590,282,308
North Carolina,Jones County,16,374,168,206
North Carolina,Jones County,17,263,117,146
North Carolina,Jones County,18,249,77,172
North Carolina,Lee County,0,61452,30064,31388
North Carolina,Lee County,1,3940,2059,1881
North Carolina,Lee County,2,4079,2069,2010
North Carolina,Lee County,3,4302,2199,2103
North Carolina,Lee County,4,3871,2024,1847
North Carolina,Lee County,5,3651,1832,1819
North Carolina,Lee County,6,4099,2075,2024
North Carolina,Lee County,7,3697,1773,1924
North Carolina,Lee County,8,3784,1932,1852
North Carolina,Lee County,9,3580,1803,1777
North Carolina,Lee County,10,4097,1972,2125
North Carolina,Lee County,11,4124,2035,2089
North Carolina,Lee County,12,4197,2014,2183
North Carolina,Lee County,13,3913,1872,2041
North Carolina,Lee County,14,3306,1577,1729
North Carolina,Lee County,15,2612,1198,1414
North Carolina,Lee County,16,1754,760,994
North Carolina,Lee County,17,1150,435,715
North Carolina,Lee County,18,1296,435,861
North Carolina,Lenoir County,0,55976,26660,29316
North Carolina,Lenoir County,1,3209,1639,1570
North Carolina,Lenoir County,2,3408,1697,1711
North Carolina,Lenoir County,3,3758,1928,1830
North Carolina,Lenoir County,4,3452,1830,1622
North Carolina,Lenoir County,5,3257,1647,1610
North Carolina,Lenoir County,6,3301,1633,1668
North Carolina,Lenoir County,7,2970,1437,1533
North Carolina,Lenoir County,8,3030,1413,1617
North Carolina,Lenoir County,9,3049,1460,1589
North Carolina,Lenoir County,10,3364,1634,1730
North Carolina,Lenoir County,11,3627,1691,1936
North Carolina,Lenoir County,12,4252,2019,2233
North Carolina,Lenoir County,13,4211,1957,2254
North Carolina,Lenoir County,14,3439,1558,1881
North Carolina,Lenoir County,15,2948,1279,1669
North Carolina,Lenoir County,16,1979,841,1138
North Carolina,Lenoir County,17,1430,550,880
North Carolina,Lenoir County,18,1292,447,845
North Carolina,Lincoln County,0,83770,41594,42176
North Carolina,Lincoln County,1,4326,2242,2084
North Carolina,Lincoln County,2,4722,2380,2342
North Carolina,Lincoln County,3,5318,2758,2560
North Carolina,Lincoln County,4,4998,2625,2373
North Carolina,Lincoln County,5,4329,2254,2075
North Carolina,Lincoln County,6,4866,2494,2372
North Carolina,Lincoln County,7,4552,2274,2278
North Carolina,Lincoln County,8,4703,2340,2363
North Carolina,Lincoln County,9,5412,2651,2761
North Carolina,Lincoln County,10,6522,3241,3281
North Carolina,Lincoln County,11,6513,3358,3155
North Carolina,Lincoln County,12,6646,3246,3400
North Carolina,Lincoln County,13,6061,2972,3089
North Carolina,Lincoln County,14,4935,2368,2567
North Carolina,Lincoln County,15,4211,1998,2213
North Carolina,Lincoln County,16,2750,1297,1453
North Carolina,Lincoln County,17,1601,656,945
North Carolina,Lincoln County,18,1305,440,865
North Carolina,McDowell County,0,45507,22711,22796
North Carolina,McDowell County,1,2328,1168,1160
North Carolina,McDowell County,2,2487,1381,1106
North Carolina,McDowell County,3,2720,1473,1247
North Carolina,McDowell County,4,2545,1306,1239
North Carolina,McDowell County,5,2440,1251,1189
North Carolina,McDowell County,6,2891,1521,1370
North Carolina,McDowell County,7,2433,1239,1194
North Carolina,McDowell County,8,2553,1353,1200
North Carolina,McDowell County,9,2727,1391,1336
North Carolina,McDowell County,10,3148,1602,1546
North Carolina,McDowell County,11,3183,1609,1574
North Carolina,McDowell County,12,3405,1661,1744
North Carolina,McDowell County,13,3330,1565,1765
North Carolina,McDowell County,14,3005,1447,1558
North Carolina,McDowell County,15,2466,1170,1296
North Carolina,McDowell County,16,1699,780,919
North Carolina,McDowell County,17,1127,471,656
North Carolina,McDowell County,18,1020,323,697
North Carolina,Macon County,0,35285,17116,18169
North Carolina,Macon County,1,1759,940,819
North Carolina,Macon County,2,1751,905,846
North Carolina,Macon County,3,1948,975,973
North Carolina,Macon County,4,1827,948,879
North Carolina,Macon County,5,1584,833,751
North Carolina,Macon County,6,1753,859,894
North Carolina,Macon County,7,1732,861,871
North Carolina,Macon County,8,1751,836,915
North Carolina,Macon County,9,1644,851,793
North Carolina,Macon County,10,1908,985,923
North Carolina,Macon County,11,2166,1036,1130
North Carolina,Macon County,12,2656,1241,1415
North Carolina,Macon County,13,2750,1319,1431
North Carolina,Macon County,14,3010,1368,1642
North Carolina,Macon County,15,2695,1259,1436
North Carolina,Macon County,16,1991,915,1076
North Carolina,Macon County,17,1268,570,698
North Carolina,Macon County,18,1092,415,677
North Carolina,Madison County,0,21763,10726,11037
North Carolina,Madison County,1,1030,511,519
North Carolina,Madison County,2,1017,542,475
North Carolina,Madison County,3,1098,568,530
North Carolina,Madison County,4,1503,796,707
North Carolina,Madison County,5,1415,760,655
North Carolina,Madison County,6,1230,608,622
North Carolina,Madison County,7,1173,586,587
North Carolina,Madison County,8,1208,571,637
North Carolina,Madison County,9,1261,653,608
North Carolina,Madison County,10,1348,679,669
North Carolina,Madison County,11,1443,730,713
North Carolina,Madison County,12,1528,735,793
North Carolina,Madison County,13,1649,776,873
North Carolina,Madison County,14,1630,797,833
North Carolina,Madison County,15,1295,613,682
North Carolina,Madison County,16,837,378,459
North Carolina,Madison County,17,559,250,309
North Carolina,Madison County,18,539,173,366
North Carolina,Martin County,0,22671,10657,12014
North Carolina,Martin County,1,1215,600,615
North Carolina,Martin County,2,1236,615,621
North Carolina,Martin County,3,1316,667,649
North Carolina,Martin County,4,1290,626,664
North Carolina,Martin County,5,1146,573,573
North Carolina,Martin County,6,1308,639,669
North Carolina,Martin County,7,1133,543,590
North Carolina,Martin County,8,1064,495,569
North Carolina,Martin County,9,1124,513,611
North Carolina,Martin County,10,1432,666,766
North Carolina,Martin County,11,1540,743,797
North Carolina,Martin County,12,1666,805,861
North Carolina,Martin County,13,1955,914,1041
North Carolina,Martin County,14,1669,766,903
North Carolina,Martin County,15,1408,637,771
North Carolina,Martin County,16,943,403,540
North Carolina,Martin County,17,680,269,411
North Carolina,Martin County,18,546,183,363
North Carolina,Mecklenburg County,0,1093901,526014,567887
North Carolina,Mecklenburg County,1,72712,37292,35420
North Carolina,Mecklenburg County,2,70568,35696,34872
North Carolina,Mecklenburg County,3,72324,36455,35869
North Carolina,Mecklenburg County,4,69725,34559,35166
North Carolina,Mecklenburg County,5,71289,34882,36407
North Carolina,Mecklenburg County,6,96626,47427,49199
North Carolina,Mecklenburg County,7,89871,44242,45629
North Carolina,Mecklenburg County,8,84116,40756,43360
North Carolina,Mecklenburg County,9,75889,35940,39949
North Carolina,Mecklenburg County,10,77794,37332,40462
North Carolina,Mecklenburg County,11,69764,33411,36353
North Carolina,Mecklenburg County,12,65420,31059,34361
North Carolina,Mecklenburg County,13,55254,25645,29609
North Carolina,Mecklenburg County,14,43324,19123,24201
North Carolina,Mecklenburg County,15,32093,14132,17961
North Carolina,Mecklenburg County,16,20065,8535,11530
North Carolina,Mecklenburg County,17,12933,4915,8018
North Carolina,Mecklenburg County,18,14134,4613,9521
North Carolina,Mitchell County,0,15000,7393,7607
North Carolina,Mitchell County,1,712,359,353
North Carolina,Mitchell County,2,737,374,363
North Carolina,Mitchell County,3,793,405,388
North Carolina,Mitchell County,4,774,410,364
North Carolina,Mitchell County,5,706,393,313
North Carolina,Mitchell County,6,854,421,433
North Carolina,Mitchell County,7,778,395,383
North Carolina,Mitchell County,8,746,372,374
North Carolina,Mitchell County,9,834,423,411
North Carolina,Mitchell County,10,959,504,455
North Carolina,Mitchell County,11,1040,510,530
North Carolina,Mitchell County,12,1128,542,586
North Carolina,Mitchell County,13,1198,561,637
North Carolina,Mitchell County,14,1130,545,585
North Carolina,Mitchell County,15,986,490,496
North Carolina,Mitchell County,16,730,358,372
North Carolina,Mitchell County,17,488,216,272
North Carolina,Mitchell County,18,407,115,292
North Carolina,Montgomery County,0,27271,13316,13955
North Carolina,Montgomery County,1,1448,715,733
North Carolina,Montgomery County,2,1594,789,805
North Carolina,Montgomery County,3,1773,898,875
North Carolina,Montgomery County,4,1812,945,867
North Carolina,Montgomery County,5,1574,809,765
North Carolina,Montgomery County,6,1615,839,776
North Carolina,Montgomery County,7,1358,628,730
North Carolina,Montgomery County,8,1424,681,743
North Carolina,Montgomery County,9,1585,789,796
North Carolina,Montgomery County,10,1722,811,911
North Carolina,Montgomery County,11,1798,897,901
North Carolina,Montgomery County,12,1957,962,995
North Carolina,Montgomery County,13,2014,981,1033
North Carolina,Montgomery County,14,1838,899,939
North Carolina,Montgomery County,15,1522,739,783
North Carolina,Montgomery County,16,1017,457,560
North Carolina,Montgomery County,17,626,283,343
North Carolina,Montgomery County,18,594,194,400
North Carolina,Moore County,0,98682,47539,51143
North Carolina,Moore County,1,5763,2986,2777
North Carolina,Moore County,2,5820,2912,2908
North Carolina,Moore County,3,5974,3029,2945
North Carolina,Moore County,4,5325,2721,2604
North Carolina,Moore County,5,4325,2154,2171
North Carolina,Moore County,6,5464,2747,2717
North Carolina,Moore County,7,6022,2971,3051
North Carolina,Moore County,8,6100,3055,3045
North Carolina,Moore County,9,5475,2664,2811
North Carolina,Moore County,10,5644,2766,2878
North Carolina,Moore County,11,5866,2838,3028
North Carolina,Moore County,12,6555,3078,3477
North Carolina,Moore County,13,6721,3092,3629
North Carolina,Moore County,14,6417,2861,3556
North Carolina,Moore County,15,6083,2799,3284
North Carolina,Moore County,16,4552,2117,2435
North Carolina,Moore County,17,3163,1428,1735
North Carolina,Moore County,18,3413,1321,2092
North Carolina,Nash County,0,94016,45066,48950
North Carolina,Nash County,1,5188,2629,2559
North Carolina,Nash County,2,5594,2823,2771
North Carolina,Nash County,3,6028,3052,2976
North Carolina,Nash County,4,6193,3267,2926
North Carolina,Nash County,5,5796,2885,2911
North Carolina,Nash County,6,5983,2981,3002
North Carolina,Nash County,7,5140,2508,2632
North Carolina,Nash County,8,5236,2529,2707
North Carolina,Nash County,9,5450,2532,2918
North Carolina,Nash County,10,6123,2960,3163
North Carolina,Nash County,11,6453,3106,3347
North Carolina,Nash County,12,6908,3311,3597
North Carolina,Nash County,13,6498,3023,3475
North Carolina,Nash County,14,5898,2672,3226
North Carolina,Nash County,15,4686,2174,2512
North Carolina,Nash County,16,3066,1314,1752
North Carolina,Nash County,17,1945,727,1218
North Carolina,Nash County,18,1831,573,1258
North Carolina,New Hanover County,0,232274,110744,121530
North Carolina,New Hanover County,1,11442,5909,5533
North Carolina,New Hanover County,2,11730,5963,5767
North Carolina,New Hanover County,3,12380,6316,6064
North Carolina,New Hanover County,4,15380,7251,8129
North Carolina,New Hanover County,5,21660,10384,11276
North Carolina,New Hanover County,6,16459,8207,8252
North Carolina,New Hanover County,7,14557,7107,7450
North Carolina,New Hanover County,8,14747,7234,7513
North Carolina,New Hanover County,9,13855,6801,7054
North Carolina,New Hanover County,10,14930,7381,7549
North Carolina,New Hanover County,11,13964,6721,7243
North Carolina,New Hanover County,12,15073,6891,8182
North Carolina,New Hanover County,13,14886,6648,8238
North Carolina,New Hanover County,14,13764,6089,7675
North Carolina,New Hanover County,15,11234,5128,6106
North Carolina,New Hanover County,16,7079,3185,3894
North Carolina,New Hanover County,17,4475,1928,2547
North Carolina,New Hanover County,18,4659,1601,3058
North Carolina,Northampton County,0,19676,9597,10079
North Carolina,Northampton County,1,905,490,415
North Carolina,Northampton County,2,883,458,425
North Carolina,Northampton County,3,1059,573,486
North Carolina,Northampton County,4,921,470,451
North Carolina,Northampton County,5,1016,536,480
North Carolina,Northampton County,6,1188,642,546
North Carolina,Northampton County,7,883,497,386
North Carolina,Northampton County,8,951,458,493
North Carolina,Northampton County,9,937,496,441
North Carolina,Northampton County,10,1125,575,550
North Carolina,Northampton County,11,1283,615,668
North Carolina,Northampton County,12,1630,714,916
North Carolina,Northampton County,13,1805,891,914
North Carolina,Northampton County,14,1544,729,815
North Carolina,Northampton County,15,1355,595,760
North Carolina,Northampton County,16,934,435,499
North Carolina,Northampton County,17,597,227,370
North Carolina,Northampton County,18,660,196,464
North Carolina,Onslow County,0,197683,109144,88539
North Carolina,Onslow County,1,17315,8811,8504
North Carolina,Onslow County,2,13752,7006,6746
North Carolina,Onslow County,3,11369,5730,5639
North Carolina,Onslow County,4,14583,9545,5038
North Carolina,Onslow County,5,33687,24471,9216
North Carolina,Onslow County,6,20740,11952,8788
North Carolina,Onslow County,7,15906,8398,7508
North Carolina,Onslow County,8,11710,5881,5829
North Carolina,Onslow County,9,8824,4434,4390
North Carolina,Onslow County,10,7978,3795,4183
North Carolina,Onslow County,11,7670,3602,4068
North Carolina,Onslow County,12,8277,3775,4502
North Carolina,Onslow County,13,7606,3596,4010
North Carolina,Onslow County,14,6013,2842,3171
North Carolina,Onslow County,15,4770,2205,2565
North Carolina,Onslow County,16,3372,1474,1898
North Carolina,Onslow County,17,2211,915,1296
North Carolina,Onslow County,18,1900,712,1188
North Carolina,Orange County,0,146027,69739,76288
North Carolina,Orange County,1,6624,3363,3261
North Carolina,Orange County,2,7782,4039,3743
North Carolina,Orange County,3,8891,4620,4271
North Carolina,Orange County,4,13084,6163,6921
North Carolina,Orange County,5,17545,7942,9603
North Carolina,Orange County,6,10262,5009,5253
North Carolina,Orange County,7,8182,4004,4178
North Carolina,Orange County,8,8375,4031,4344
North Carolina,Orange County,9,8615,4178,4437
North Carolina,Orange County,10,9443,4584,4859
North Carolina,Orange County,11,9143,4437,4706
North Carolina,Orange County,12,9068,4272,4796
North Carolina,Orange County,13,8574,4036,4538
North Carolina,Orange County,14,7558,3546,4012
North Carolina,Orange County,15,5422,2500,2922
North Carolina,Orange County,16,3402,1518,1884
North Carolina,Orange County,17,2018,799,1219
North Carolina,Orange County,18,2039,698,1341
North Carolina,Pamlico County,0,12670,6412,6258
North Carolina,Pamlico County,1,449,221,228
North Carolina,Pamlico County,2,478,245,233
North Carolina,Pamlico County,3,610,316,294
North Carolina,Pamlico County,4,553,290,263
North Carolina,Pamlico County,5,566,316,250
North Carolina,Pamlico County,6,655,360,295
North Carolina,Pamlico County,7,669,394,275
North Carolina,Pamlico County,8,614,340,274
North Carolina,Pamlico County,9,565,308,257
North Carolina,Pamlico County,10,696,369,327
North Carolina,Pamlico County,11,750,392,358
North Carolina,Pamlico County,12,1102,509,593
North Carolina,Pamlico County,13,1184,577,607
North Carolina,Pamlico County,14,1213,556,657
North Carolina,Pamlico County,15,999,488,511
North Carolina,Pamlico County,16,734,383,351
North Carolina,Pamlico County,17,417,176,241
North Carolina,Pamlico County,18,416,172,244
North Carolina,Pasquotank County,0,39639,19393,20246
North Carolina,Pasquotank County,1,2466,1213,1253
North Carolina,Pasquotank County,2,2355,1199,1156
North Carolina,Pasquotank County,3,2508,1332,1176
North Carolina,Pasquotank County,4,2562,1319,1243
North Carolina,Pasquotank County,5,2585,1318,1267
North Carolina,Pasquotank County,6,2752,1467,1285
North Carolina,Pasquotank County,7,2754,1420,1334
North Carolina,Pasquotank County,8,2512,1250,1262
North Carolina,Pasquotank County,9,2184,1097,1087
North Carolina,Pasquotank County,10,2348,1168,1180
North Carolina,Pasquotank County,11,2453,1157,1296
North Carolina,Pasquotank County,12,2785,1360,1425
North Carolina,Pasquotank County,13,2685,1213,1472
North Carolina,Pasquotank County,14,2139,964,1175
North Carolina,Pasquotank County,15,1849,836,1013
North Carolina,Pasquotank County,16,1195,499,696
North Carolina,Pasquotank County,17,726,301,425
North Carolina,Pasquotank County,18,781,280,501
North Carolina,Pender County,0,62162,31012,31150
North Carolina,Pender County,1,3540,1791,1749
North Carolina,Pender County,2,3752,1926,1826
North Carolina,Pender County,3,4034,2073,1961
North Carolina,Pender County,4,3723,1929,1794
North Carolina,Pender County,5,2979,1574,1405
North Carolina,Pender County,6,3340,1706,1634
North Carolina,Pender County,7,3550,1806,1744
North Carolina,Pender County,8,4029,2017,2012
North Carolina,Pender County,9,3899,2023,1876
North Carolina,Pender County,10,4436,2210,2226
North Carolina,Pender County,11,4369,2208,2161
North Carolina,Pender County,12,4809,2418,2391
North Carolina,Pender County,13,4512,2156,2356
North Carolina,Pender County,14,3840,1824,2016
North Carolina,Pender County,15,3113,1506,1607
North Carolina,Pender County,16,2019,944,1075
North Carolina,Pender County,17,1184,523,661
North Carolina,Pender County,18,1034,378,656
North Carolina,Perquimans County,0,13422,6452,6970
North Carolina,Perquimans County,1,605,307,298
North Carolina,Perquimans County,2,678,337,341
North Carolina,Perquimans County,3,754,366,388
North Carolina,Perquimans County,4,669,350,319
North Carolina,Perquimans County,5,587,308,279
North Carolina,Perquimans County,6,648,300,348
North Carolina,Perquimans County,7,690,350,340
North Carolina,Perquimans County,8,689,333,356
North Carolina,Perquimans County,9,618,304,314
North Carolina,Perquimans County,10,771,374,397
North Carolina,Perquimans County,11,873,409,464
North Carolina,Perquimans County,12,1080,516,564
North Carolina,Perquimans County,13,1157,562,595
North Carolina,Perquimans County,14,1029,461,568
North Carolina,Perquimans County,15,1019,485,534
North Carolina,Perquimans County,16,714,314,400
North Carolina,Perquimans County,17,473,230,243
North Carolina,Perquimans County,18,368,146,222
North Carolina,Person County,0,39507,19115,20392
North Carolina,Person County,1,2128,1065,1063
North Carolina,Person County,2,2222,1123,1099
North Carolina,Person County,3,2364,1218,1146
North Carolina,Person County,4,2377,1265,1112
North Carolina,Person County,5,2127,1069,1058
North Carolina,Person County,6,2372,1206,1166
North Carolina,Person County,7,2076,1006,1070
North Carolina,Person County,8,2115,1057,1058
North Carolina,Person County,9,2257,1102,1155
North Carolina,Person County,10,2756,1302,1454
North Carolina,Person County,11,2760,1358,1402
North Carolina,Person County,12,3113,1517,1596
North Carolina,Person County,13,3115,1475,1640
North Carolina,Person County,14,2544,1171,1373
North Carolina,Person County,15,2043,953,1090
North Carolina,Person County,16,1394,608,786
North Carolina,Person County,17,919,369,550
North Carolina,Person County,18,825,251,574
North Carolina,Pitt County,0,179914,84481,95433
North Carolina,Pitt County,1,10303,5259,5044
North Carolina,Pitt County,2,10582,5443,5139
North Carolina,Pitt County,3,11099,5721,5378
North Carolina,Pitt County,4,14991,7126,7865
North Carolina,Pitt County,5,22806,10549,12257
North Carolina,Pitt County,6,14207,6821,7386
North Carolina,Pitt County,7,10967,5174,5793
North Carolina,Pitt County,8,10852,5041,5811
North Carolina,Pitt County,9,10119,4717,5402
North Carolina,Pitt County,10,10230,4756,5474
North Carolina,Pitt County,11,9753,4571,5182
North Carolina,Pitt County,12,10258,4694,5564
North Carolina,Pitt County,13,9958,4421,5537
North Carolina,Pitt County,14,8313,3826,4487
North Carolina,Pitt County,15,6167,2817,3350
North Carolina,Pitt County,16,3973,1752,2221
North Carolina,Pitt County,17,2700,1036,1664
North Carolina,Pitt County,18,2636,757,1879
North Carolina,Polk County,0,20611,9889,10722
North Carolina,Polk County,1,761,400,361
North Carolina,Polk County,2,856,413,443
North Carolina,Polk County,3,1038,527,511
North Carolina,Polk County,4,1037,560,477
North Carolina,Polk County,5,914,478,436
North Carolina,Polk County,6,891,440,451
North Carolina,Polk County,7,793,402,391
North Carolina,Polk County,8,874,461,413
North Carolina,Polk County,9,951,476,475
North Carolina,Polk County,10,1233,577,656
North Carolina,Polk County,11,1373,686,687
North Carolina,Polk County,12,1709,839,870
North Carolina,Polk County,13,1773,773,1000
North Carolina,Polk County,14,1812,816,996
North Carolina,Polk County,15,1561,741,820
North Carolina,Polk County,16,1270,591,679
North Carolina,Polk County,17,831,374,457
North Carolina,Polk County,18,934,335,599
North Carolina,Randolph County,0,143351,70703,72648
North Carolina,Randolph County,1,8084,4053,4031
North Carolina,Randolph County,2,8666,4490,4176
North Carolina,Randolph County,3,9477,4835,4642
North Carolina,Randolph County,4,9302,4841,4461
North Carolina,Randolph County,5,8163,4224,3939
North Carolina,Randolph County,6,8897,4539,4358
North Carolina,Randolph County,7,7984,3970,4014
North Carolina,Randolph County,8,8031,3880,4151
North Carolina,Randolph County,9,8474,4126,4348
North Carolina,Randolph County,10,10252,5156,5096
North Carolina,Randolph County,11,10435,5251,5184
North Carolina,Randolph County,12,10571,5239,5332
North Carolina,Randolph County,13,9575,4717,4858
North Carolina,Randolph County,14,8166,3888,4278
North Carolina,Randolph County,15,6972,3216,3756
North Carolina,Randolph County,16,4658,2118,2540
North Carolina,Randolph County,17,2976,1249,1727
North Carolina,Randolph County,18,2668,911,1757
North Carolina,Richmond County,0,44887,21990,22897
North Carolina,Richmond County,1,2687,1383,1304
North Carolina,Richmond County,2,2870,1482,1388
North Carolina,Richmond County,3,2941,1530,1411
North Carolina,Richmond County,4,2806,1474,1332
North Carolina,Richmond County,5,2898,1579,1319
North Carolina,Richmond County,6,3188,1613,1575
North Carolina,Richmond County,7,2363,1143,1220
North Carolina,Richmond County,8,2519,1222,1297
North Carolina,Richmond County,9,2641,1268,1373
North Carolina,Richmond County,10,2962,1449,1513
North Carolina,Richmond County,11,2905,1443,1462
North Carolina,Richmond County,12,3139,1503,1636
North Carolina,Richmond County,13,2912,1413,1499
North Carolina,Richmond County,14,2640,1208,1432
North Carolina,Richmond County,15,2152,991,1161
North Carolina,Richmond County,16,1486,619,867
North Carolina,Richmond County,17,965,386,579
North Carolina,Richmond County,18,813,284,529
North Carolina,Robeson County,0,131831,63581,68250
North Carolina,Robeson County,1,8725,4444,4281
North Carolina,Robeson County,2,9205,4577,4628
North Carolina,Robeson County,3,9357,4815,4542
North Carolina,Robeson County,4,9919,5014,4905
North Carolina,Robeson County,5,8939,4565,4374
North Carolina,Robeson County,6,9066,4476,4590
North Carolina,Robeson County,7,7629,3704,3925
North Carolina,Robeson County,8,7649,3602,4047
North Carolina,Robeson County,9,7969,3831,4138
North Carolina,Robeson County,10,8309,4053,4256
North Carolina,Robeson County,11,8018,3860,4158
North Carolina,Robeson County,12,8696,4121,4575
North Carolina,Robeson County,13,8285,3798,4487
North Carolina,Robeson County,14,6872,3141,3731
North Carolina,Robeson County,15,5538,2604,2934
North Carolina,Robeson County,16,3511,1515,1996
North Carolina,Robeson County,17,2213,849,1364
North Carolina,Robeson County,18,1931,612,1319
North Carolina,Rockingham County,0,90690,43698,46992
North Carolina,Rockingham County,1,4660,2360,2300
North Carolina,Rockingham County,2,4973,2511,2462
North Carolina,Rockingham County,3,5365,2748,2617
North Carolina,Rockingham County,4,5293,2730,2563
North Carolina,Rockingham County,5,4793,2396,2397
North Carolina,Rockingham County,6,5403,2702,2701
North Carolina,Rockingham County,7,4691,2279,2412
North Carolina,Rockingham County,8,4731,2274,2457
North Carolina,Rockingham County,9,5100,2451,2649
North Carolina,Rockingham County,10,6193,3048,3145
North Carolina,Rockingham County,11,6697,3199,3498
North Carolina,Rockingham County,12,7230,3556,3674
North Carolina,Rockingham County,13,7009,3315,3694
North Carolina,Rockingham County,14,5923,2809,3114
North Carolina,Rockingham County,15,4816,2225,2591
North Carolina,Rockingham County,16,3439,1542,1897
North Carolina,Rockingham County,17,2265,867,1398
North Carolina,Rockingham County,18,2109,686,1423
North Carolina,Rowan County,0,141262,69730,71532
North Carolina,Rowan County,1,8134,4178,3956
North Carolina,Rowan County,2,8226,4236,3990
North Carolina,Rowan County,3,9311,4807,4504
North Carolina,Rowan County,4,9132,4793,4339
North Carolina,Rowan County,5,8650,4360,4290
North Carolina,Rowan County,6,9407,4859,4548
North Carolina,Rowan County,7,8192,4008,4184
North Carolina,Rowan County,8,8284,4147,4137
North Carolina,Rowan County,9,8156,4084,4072
North Carolina,Rowan County,10,9541,4739,4802
North Carolina,Rowan County,11,9655,4790,4865
North Carolina,Rowan County,12,10372,5080,5292
North Carolina,Rowan County,13,9372,4618,4754
North Carolina,Rowan County,14,8012,3846,4166
North Carolina,Rowan County,15,6492,3012,3480
North Carolina,Rowan County,16,4606,2112,2494
North Carolina,Rowan County,17,2844,1107,1737
North Carolina,Rowan County,18,2876,954,1922
North Carolina,Rutherford County,0,66826,32232,34594
North Carolina,Rutherford County,1,3412,1762,1650
North Carolina,Rutherford County,2,3665,1871,1794
North Carolina,Rutherford County,3,4137,2088,2049
North Carolina,Rutherford County,4,3958,2010,1948
North Carolina,Rutherford County,5,3496,1779,1717
North Carolina,Rutherford County,6,3829,1868,1961
North Carolina,Rutherford County,7,3314,1594,1720
North Carolina,Rutherford County,8,3454,1695,1759
North Carolina,Rutherford County,9,3785,1838,1947
North Carolina,Rutherford County,10,4554,2219,2335
North Carolina,Rutherford County,11,4769,2321,2448
North Carolina,Rutherford County,12,5034,2462,2572
North Carolina,Rutherford County,13,4998,2343,2655
North Carolina,Rutherford County,14,4582,2186,2396
North Carolina,Rutherford County,15,3892,1827,2065
North Carolina,Rutherford County,16,2737,1210,1527
North Carolina,Rutherford County,17,1658,669,989
North Carolina,Rutherford County,18,1552,490,1062
North Carolina,Sampson County,0,63626,31415,32211
North Carolina,Sampson County,1,4103,2096,2007
North Carolina,Sampson County,2,4114,2103,2011
North Carolina,Sampson County,3,4480,2328,2152
North Carolina,Sampson County,4,4424,2343,2081
North Carolina,Sampson County,5,3811,1977,1834
North Carolina,Sampson County,6,3830,1941,1889
North Carolina,Sampson County,7,3283,1685,1598
North Carolina,Sampson County,8,3709,1831,1878
North Carolina,Sampson County,9,3852,1948,1904
North Carolina,Sampson County,10,4075,2078,1997
North Carolina,Sampson County,11,4277,2151,2126
North Carolina,Sampson County,12,4189,2113,2076
North Carolina,Sampson County,13,4143,1972,2171
North Carolina,Sampson County,14,3675,1695,1980
North Carolina,Sampson County,15,2908,1326,1582
North Carolina,Sampson County,16,2035,859,1176
North Carolina,Sampson County,17,1408,541,867
North Carolina,Sampson County,18,1310,428,882
North Carolina,Scotland County,0,34810,17282,17528
North Carolina,Scotland County,1,2210,1133,1077
North Carolina,Scotland County,2,2171,1112,1059
North Carolina,Scotland County,3,2271,1180,1091
North Carolina,Scotland County,4,2158,1163,995
North Carolina,Scotland County,5,2417,1207,1210
North Carolina,Scotland County,6,2441,1335,1106
North Carolina,Scotland County,7,1894,1031,863
North Carolina,Scotland County,8,2010,1061,949
North Carolina,Scotland County,9,1929,980,949
North Carolina,Scotland County,10,2263,1193,1070
North Carolina,Scotland County,11,2082,1013,1069
North Carolina,Scotland County,12,2320,1117,1203
North Carolina,Scotland County,13,2275,1061,1214
North Carolina,Scotland County,14,2109,940,1169
North Carolina,Scotland County,15,1707,807,900
North Carolina,Scotland County,16,1107,477,630
North Carolina,Scotland County,17,708,253,455
North Carolina,Scotland County,18,738,219,519
North Carolina,Stanly County,0,62075,30979,31096
North Carolina,Stanly County,1,3606,1877,1729
North Carolina,Stanly County,2,3520,1823,1697
North Carolina,Stanly County,3,3906,1952,1954
North Carolina,Stanly County,4,3798,1994,1804
North Carolina,Stanly County,5,3700,1926,1774
North Carolina,Stanly County,6,4142,2207,1935
North Carolina,Stanly County,7,3681,1909,1772
North Carolina,Stanly County,8,3531,1761,1770
North Carolina,Stanly County,9,3402,1773,1629
North Carolina,Stanly County,10,4162,2114,2048
North Carolina,Stanly County,11,4397,2219,2178
North Carolina,Stanly County,12,4336,2144,2192
North Carolina,Stanly County,13,4161,2038,2123
North Carolina,Stanly County,14,3679,1780,1899
North Carolina,Stanly County,15,3187,1459,1728
North Carolina,Stanly County,16,2255,1010,1245
North Carolina,Stanly County,17,1374,601,773
North Carolina,Stanly County,18,1238,392,846
North Carolina,Stokes County,0,45467,22364,23103
North Carolina,Stokes County,1,2041,1084,957
North Carolina,Stokes County,2,2279,1198,1081
North Carolina,Stokes County,3,2528,1274,1254
North Carolina,Stokes County,4,2572,1344,1228
North Carolina,Stokes County,5,2433,1243,1190
North Carolina,Stokes County,6,2514,1249,1265
North Carolina,Stokes County,7,2231,1135,1096
North Carolina,Stokes County,8,2326,1177,1149
North Carolina,Stokes County,9,2563,1266,1297
North Carolina,Stokes County,10,3348,1641,1707
North Carolina,Stokes County,11,3542,1773,1769
North Carolina,Stokes County,12,3770,1864,1906
North Carolina,Stokes County,13,3652,1760,1892
North Carolina,Stokes County,14,2945,1449,1496
North Carolina,Stokes County,15,2596,1216,1380
North Carolina,Stokes County,16,1831,807,1024
North Carolina,Stokes County,17,1206,506,700
North Carolina,Stokes County,18,1090,378,712
North Carolina,Surry County,0,71948,35001,36947
North Carolina,Surry County,1,3801,1943,1858
North Carolina,Surry County,2,4060,2032,2028
North Carolina,Surry County,3,4562,2342,2220
North Carolina,Surry County,4,4371,2225,2146
North Carolina,Surry County,5,4041,2090,1951
North Carolina,Surry County,6,4293,2254,2039
North Carolina,Surry County,7,3450,1674,1776
North Carolina,Surry County,8,3841,1877,1964
North Carolina,Surry County,9,4264,2073,2191
North Carolina,Surry County,10,5056,2517,2539
North Carolina,Surry County,11,5213,2548,2665
North Carolina,Surry County,12,5320,2627,2693
North Carolina,Surry County,13,4932,2348,2584
North Carolina,Surry County,14,4526,2200,2326
North Carolina,Surry County,15,3894,1767,2127
North Carolina,Surry County,16,2741,1196,1545
North Carolina,Surry County,17,1805,703,1102
North Carolina,Surry County,18,1778,585,1193
North Carolina,Swain County,0,14245,6864,7381
North Carolina,Swain County,1,962,501,461
North Carolina,Swain County,2,841,425,416
North Carolina,Swain County,3,849,438,411
North Carolina,Swain County,4,799,395,404
North Carolina,Swain County,5,883,438,445
North Carolina,Swain County,6,978,490,488
North Carolina,Swain County,7,813,379,434
North Carolina,Swain County,8,826,411,415
North Carolina,Swain County,9,816,394,422
North Carolina,Swain County,10,898,424,474
North Carolina,Swain County,11,897,442,455
North Carolina,Swain County,12,981,475,506
North Carolina,Swain County,13,973,444,529
North Carolina,Swain County,14,844,373,471
North Carolina,Swain County,15,757,358,399
North Carolina,Swain County,16,529,247,282
North Carolina,Swain County,17,314,123,191
North Carolina,Swain County,18,285,107,178
North Carolina,Transylvania County,0,34215,16539,17676
North Carolina,Transylvania County,1,1406,735,671
North Carolina,Transylvania County,2,1425,743,682
North Carolina,Transylvania County,3,1556,748,808
North Carolina,Transylvania County,4,1744,951,793
North Carolina,Transylvania County,5,1790,993,797
North Carolina,Transylvania County,6,1651,847,804
North Carolina,Transylvania County,7,1610,769,841
North Carolina,Transylvania County,8,1621,774,847
North Carolina,Transylvania County,9,1741,874,867
North Carolina,Transylvania County,10,1832,895,937
North Carolina,Transylvania County,11,1977,915,1062
North Carolina,Transylvania County,12,2521,1171,1350
North Carolina,Transylvania County,13,2896,1345,1551
North Carolina,Transylvania County,14,2881,1350,1531
North Carolina,Transylvania County,15,2740,1276,1464
North Carolina,Transylvania County,16,2137,957,1180
North Carolina,Transylvania County,17,1356,675,681
North Carolina,Transylvania County,18,1331,521,810
North Carolina,Tyrrell County,0,4131,2291,1840
North Carolina,Tyrrell County,1,223,115,108
North Carolina,Tyrrell County,2,211,95,116
North Carolina,Tyrrell County,3,216,118,98
North Carolina,Tyrrell County,4,201,107,94
North Carolina,Tyrrell County,5,230,158,72
North Carolina,Tyrrell County,6,323,223,100
North Carolina,Tyrrell County,7,293,204,89
North Carolina,Tyrrell County,8,288,188,100
North Carolina,Tyrrell County,9,255,168,87
North Carolina,Tyrrell County,10,248,136,112
North Carolina,Tyrrell County,11,263,142,121
North Carolina,Tyrrell County,12,284,133,151
North Carolina,Tyrrell County,13,297,148,149
North Carolina,Tyrrell County,14,210,108,102
North Carolina,Tyrrell County,15,208,98,110
North Carolina,Tyrrell County,16,152,68,84
North Carolina,Tyrrell County,17,124,50,74
North Carolina,Tyrrell County,18,105,32,73
North Carolina,Union County,0,235908,115992,119916
North Carolina,Union County,1,13353,6747,6606
North Carolina,Union County,2,16814,8598,8216
North Carolina,Union County,3,20275,10254,10021
North Carolina,Union County,4,20197,10396,9801
North Carolina,Union County,5,13974,7094,6880
North Carolina,Union County,6,11247,5598,5649
North Carolina,Union County,7,11688,5704,5984
North Carolina,Union County,8,14968,6964,8004
North Carolina,Union County,9,16932,8154,8778
North Carolina,Union County,10,20271,10087,10184
North Carolina,Union County,11,18147,9149,8998
North Carolina,Union County,12,15754,8007,7747
North Carolina,Union County,13,12360,6015,6345
North Carolina,Union County,14,10198,4686,5512
North Carolina,Union County,15,8312,3843,4469
North Carolina,Union County,16,5558,2497,3061
North Carolina,Union County,17,3164,1342,1822
North Carolina,Union County,18,2696,857,1839
North Carolina,Vance County,0,44582,20839,23743
North Carolina,Vance County,1,2752,1440,1312
North Carolina,Vance County,2,2927,1454,1473
North Carolina,Vance County,3,2973,1528,1445
North Carolina,Vance County,4,2983,1469,1514
North Carolina,Vance County,5,2729,1390,1339
North Carolina,Vance County,6,3039,1446,1593
North Carolina,Vance County,7,2302,1035,1267
North Carolina,Vance County,8,2425,1085,1340
North Carolina,Vance County,9,2315,1081,1234
North Carolina,Vance County,10,2849,1345,1504
North Carolina,Vance County,11,2907,1343,1564
North Carolina,Vance County,12,3003,1356,1647
North Carolina,Vance County,13,3134,1422,1712
North Carolina,Vance County,14,2730,1218,1512
North Carolina,Vance County,15,2153,972,1181
North Carolina,Vance County,16,1461,628,833
North Carolina,Vance County,17,950,380,570
North Carolina,Vance County,18,950,247,703
North Carolina,Wake County,0,1092305,531546,560759
North Carolina,Wake County,1,67753,34589,33164
North Carolina,Wake County,2,71913,36582,35331
North Carolina,Wake County,3,76649,38862,37787
North Carolina,Wake County,4,75694,38228,37466
North Carolina,Wake County,5,69041,34414,34627
North Carolina,Wake County,6,80478,39964,40514
North Carolina,Wake County,7,80634,39157,41477
North Carolina,Wake County,8,82253,39691,42562
North Carolina,Wake County,9,80757,39396,41361
North Carolina,Wake County,10,82030,40214,41816
North Carolina,Wake County,11,73857,36242,37615
North Carolina,Wake County,12,68143,32904,35239
North Carolina,Wake County,13,56217,26432,29785
North Carolina,Wake County,14,44539,20045,24494
North Carolina,Wake County,15,34405,15461,18944
North Carolina,Wake County,16,21063,9326,11737
North Carolina,Wake County,17,13293,5429,7864
North Carolina,Wake County,18,13586,4610,8976
North Carolina,Warren County,0,19807,9775,10032
North Carolina,Warren County,1,946,455,491
North Carolina,Warren County,2,941,461,480
North Carolina,Warren County,3,1108,555,553
North Carolina,Warren County,4,1005,508,497
North Carolina,Warren County,5,1010,539,471
North Carolina,Warren County,6,1133,632,501
North Carolina,Warren County,7,1009,548,461
North Carolina,Warren County,8,1040,573,467
North Carolina,Warren County,9,966,493,473
North Carolina,Warren County,10,1066,541,525
North Carolina,Warren County,11,1255,644,611
North Carolina,Warren County,12,1568,755,813
North Carolina,Warren County,13,1728,833,895
North Carolina,Warren County,14,1591,749,842
North Carolina,Warren County,15,1333,599,734
North Carolina,Warren County,16,900,451,449
North Carolina,Warren County,17,575,231,344
North Carolina,Warren County,18,633,208,425
North Carolina,Washington County,0,11859,5630,6229
North Carolina,Washington County,1,614,298,316
North Carolina,Washington County,2,672,356,316
North Carolina,Washington County,3,690,342,348
North Carolina,Washington County,4,635,326,309
North Carolina,Washington County,5,683,378,305
North Carolina,Washington County,6,718,367,351
North Carolina,Washington County,7,497,220,277
North Carolina,Washington County,8,528,273,255
North Carolina,Washington County,9,550,251,299
North Carolina,Washington County,10,656,264,392
North Carolina,Washington County,11,790,354,436
North Carolina,Washington County,12,875,413,462
North Carolina,Washington County,13,1062,513,549
North Carolina,Washington County,14,943,451,492
North Carolina,Washington County,15,726,335,391
North Carolina,Washington County,16,491,217,274
North Carolina,Washington County,17,377,166,211
North Carolina,Washington County,18,352,106,246
North Carolina,Watauga County,0,55945,27936,28009
North Carolina,Watauga County,1,1852,948,904
North Carolina,Watauga County,2,1951,998,953
North Carolina,Watauga County,3,2147,1098,1049
North Carolina,Watauga County,4,5965,2782,3183
North Carolina,Watauga County,5,11138,5800,5338
North Carolina,Watauga County,6,3659,1947,1712
North Carolina,Watauga County,7,2634,1444,1190
North Carolina,Watauga County,8,2661,1372,1289
North Carolina,Watauga County,9,2618,1324,1294
North Carolina,Watauga County,10,2844,1440,1404
North Carolina,Watauga County,11,2874,1451,1423
North Carolina,Watauga County,12,3309,1550,1759
North Carolina,Watauga County,13,3440,1646,1794
North Carolina,Watauga County,14,3109,1488,1621
North Carolina,Watauga County,15,2331,1139,1192
North Carolina,Watauga County,16,1584,768,816
North Carolina,Watauga County,17,931,429,502
North Carolina,Watauga County,18,898,312,586
North Carolina,Wayne County,0,123248,59930,63318
North Carolina,Wayne County,1,8174,4131,4043
North Carolina,Wayne County,2,8041,4069,3972
North Carolina,Wayne County,3,8132,4155,3977
North Carolina,Wayne County,4,7968,4158,3810
North Carolina,Wayne County,5,8915,4791,4124
North Carolina,Wayne County,6,9006,4726,4280
North Carolina,Wayne County,7,7693,3745,3948
North Carolina,Wayne County,8,7062,3510,3552
North Carolina,Wayne County,9,6796,3216,3580
North Carolina,Wayne County,10,7326,3400,3926
North Carolina,Wayne County,11,7715,3798,3917
North Carolina,Wayne County,12,8269,3933,4336
North Carolina,Wayne County,13,7885,3685,4200
North Carolina,Wayne County,14,6708,3057,3651
North Carolina,Wayne County,15,5189,2319,2870
North Carolina,Wayne County,16,3615,1502,2113
North Carolina,Wayne County,17,2543,1007,1536
North Carolina,Wayne County,18,2211,728,1483
North Carolina,Wilkes County,0,68557,33729,34828
North Carolina,Wilkes County,1,3461,1735,1726
North Carolina,Wilkes County,2,3641,1830,1811
North Carolina,Wilkes County,3,4179,2095,2084
North Carolina,Wilkes County,4,4221,2244,1977
North Carolina,Wilkes County,5,3668,1896,1772
North Carolina,Wilkes County,6,3900,1985,1915
North Carolina,Wilkes County,7,3513,1768,1745
North Carolina,Wilkes County,8,3606,1836,1770
North Carolina,Wilkes County,9,3966,1968,1998
North Carolina,Wilkes County,10,4621,2336,2285
North Carolina,Wilkes County,11,4804,2444,2360
North Carolina,Wilkes County,12,5140,2515,2625
North Carolina,Wilkes County,13,5060,2492,2568
North Carolina,Wilkes County,14,4531,2151,2380
North Carolina,Wilkes County,15,3959,1824,2135
North Carolina,Wilkes County,16,2747,1248,1499
North Carolina,Wilkes County,17,1879,783,1096
North Carolina,Wilkes County,18,1661,579,1082
North Carolina,Wilson County,0,81455,38539,42916
North Carolina,Wilson County,1,4794,2436,2358
North Carolina,Wilson County,2,5149,2679,2470
North Carolina,Wilson County,3,5418,2790,2628
North Carolina,Wilson County,4,5385,2644,2741
North Carolina,Wilson County,5,4866,2421,2445
North Carolina,Wilson County,6,5186,2502,2684
North Carolina,Wilson County,7,4611,2184,2427
North Carolina,Wilson County,8,4665,2254,2411
North Carolina,Wilson County,9,4635,2072,2563
North Carolina,Wilson County,10,5201,2470,2731
North Carolina,Wilson County,11,5310,2503,2807
North Carolina,Wilson County,12,5773,2734,3039
North Carolina,Wilson County,13,5581,2562,3019
North Carolina,Wilson County,14,4849,2225,2624
North Carolina,Wilson County,15,3887,1707,2180
North Carolina,Wilson County,16,2635,1142,1493
North Carolina,Wilson County,17,1797,684,1113
North Carolina,Wilson County,18,1713,530,1183
North Carolina,Yadkin County,0,37543,18479,19064
North Carolina,Yadkin County,1,1952,986,966
North Carolina,Yadkin County,2,2159,1120,1039
North Carolina,Yadkin County,3,2257,1203,1054
North Carolina,Yadkin County,4,2241,1161,1080
North Carolina,Yadkin County,5,2102,1121,981
North Carolina,Yadkin County,6,2170,1097,1073
North Carolina,Yadkin County,7,1910,922,988
North Carolina,Yadkin County,8,1983,984,999
North Carolina,Yadkin County,9,2084,1031,1053
North Carolina,Yadkin County,10,2713,1375,1338
North Carolina,Yadkin County,11,2897,1409,1488
North Carolina,Yadkin County,12,2932,1464,1468
North Carolina,Yadkin County,13,2577,1262,1315
North Carolina,Yadkin County,14,2302,1077,1225
North Carolina,Yadkin County,15,1953,920,1033
North Carolina,Yadkin County,16,1497,677,820
North Carolina,Yadkin County,17,933,373,560
North Carolina,Yadkin County,18,881,297,584
North Carolina,Yancey County,0,17903,8800,9103
North Carolina,Yancey County,1,822,423,399
North Carolina,Yancey County,2,823,429,394
North Carolina,Yancey County,3,1007,551,456
North Carolina,Yancey County,4,958,516,442
North Carolina,Yancey County,5,858,415,443
North Carolina,Yancey County,6,1018,542,476
North Carolina,Yancey County,7,880,474,406
North Carolina,Yancey County,8,912,442,470
North Carolina,Yancey County,9,971,472,499
North Carolina,Yancey County,10,1158,579,579
North Carolina,Yancey County,11,1226,622,604
North Carolina,Yancey County,12,1316,608,708
North Carolina,Yancey County,13,1347,639,708
North Carolina,Yancey County,14,1429,687,742
North Carolina,Yancey County,15,1196,542,654
North Carolina,Yancey County,16,866,423,443
North Carolina,Yancey County,17,635,264,371
North Carolina,Yancey County,18,481,172,309
North Dakota,Adams County,0,2294,1135,1159
North Dakota,Adams County,1,117,57,60
North Dakota,Adams County,2,128,65,63
North Dakota,Adams County,3,117,63,54
North Dakota,Adams County,4,117,60,57
North Dakota,Adams County,5,82,44,38
North Dakota,Adams County,6,98,53,45
North Dakota,Adams County,7,149,72,77
North Dakota,Adams County,8,120,74,46
North Dakota,Adams County,9,110,48,62
North Dakota,Adams County,10,106,50,56
North Dakota,Adams County,11,130,65,65
North Dakota,Adams County,12,185,92,93
North Dakota,Adams County,13,196,92,104
North Dakota,Adams County,14,173,87,86
North Dakota,Adams County,15,139,73,66
North Dakota,Adams County,16,103,50,53
North Dakota,Adams County,17,101,49,52
North Dakota,Adams County,18,123,41,82
North Dakota,Barnes County,0,10542,5315,5227
North Dakota,Barnes County,1,555,288,267
North Dakota,Barnes County,2,554,283,271
North Dakota,Barnes County,3,615,327,288
North Dakota,Barnes County,4,720,366,354
North Dakota,Barnes County,5,694,368,326
North Dakota,Barnes County,6,570,326,244
North Dakota,Barnes County,7,531,282,249
North Dakota,Barnes County,8,600,311,289
North Dakota,Barnes County,9,519,272,247
North Dakota,Barnes County,10,573,284,289
North Dakota,Barnes County,11,624,320,304
North Dakota,Barnes County,12,812,407,405
North Dakota,Barnes County,13,774,392,382
North Dakota,Barnes County,14,726,366,360
North Dakota,Barnes County,15,538,274,264
North Dakota,Barnes County,16,435,192,243
North Dakota,Barnes County,17,293,126,167
North Dakota,Barnes County,18,409,131,278
North Dakota,Benson County,0,6962,3555,3407
North Dakota,Benson County,1,766,390,376
North Dakota,Benson County,2,663,365,298
North Dakota,Benson County,3,689,331,358
North Dakota,Benson County,4,519,284,235
North Dakota,Benson County,5,381,183,198
North Dakota,Benson County,6,421,222,199
North Dakota,Benson County,7,394,209,185
North Dakota,Benson County,8,367,192,175
North Dakota,Benson County,9,282,132,150
North Dakota,Benson County,10,296,146,150
North Dakota,Benson County,11,374,195,179
North Dakota,Benson County,12,417,205,212
North Dakota,Benson County,13,425,213,212
North Dakota,Benson County,14,362,182,180
North Dakota,Benson County,15,223,104,119
North Dakota,Benson County,16,164,87,77
North Dakota,Benson County,17,120,62,58
North Dakota,Benson County,18,99,53,46
North Dakota,Billings County,0,919,501,418
North Dakota,Billings County,1,69,39,30
North Dakota,Billings County,2,45,26,19
North Dakota,Billings County,3,46,18,28
North Dakota,Billings County,4,37,15,22
North Dakota,Billings County,5,35,22,13
North Dakota,Billings County,6,51,25,26
North Dakota,Billings County,7,71,48,23
North Dakota,Billings County,8,69,38,31
North Dakota,Billings County,9,47,29,18
North Dakota,Billings County,10,46,25,21
North Dakota,Billings County,11,63,29,34
North Dakota,Billings County,12,66,37,29
North Dakota,Billings County,13,68,33,35
North Dakota,Billings County,14,65,37,28
North Dakota,Billings County,15,48,31,17
North Dakota,Billings County,16,28,16,12
North Dakota,Billings County,17,32,16,16
North Dakota,Billings County,18,33,17,16
North Dakota,Bottineau County,0,6411,3313,3098
North Dakota,Bottineau County,1,348,165,183
North Dakota,Bottineau County,2,385,217,168
North Dakota,Bottineau County,3,400,193,207
North Dakota,Bottineau County,4,402,220,182
North Dakota,Bottineau County,5,348,194,154
North Dakota,Bottineau County,6,343,200,143
North Dakota,Bottineau County,7,311,165,146
North Dakota,Bottineau County,8,349,188,161
North Dakota,Bottineau County,9,297,151,146
North Dakota,Bottineau County,10,308,164,144
North Dakota,Bottineau County,11,369,183,186
North Dakota,Bottineau County,12,499,255,244
North Dakota,Bottineau County,13,523,286,237
North Dakota,Bottineau County,14,516,271,245
North Dakota,Bottineau County,15,376,184,192
North Dakota,Bottineau County,16,258,121,137
North Dakota,Bottineau County,17,170,68,102
North Dakota,Bottineau County,18,209,88,121
North Dakota,Bowman County,0,3076,1548,1528
North Dakota,Bowman County,1,192,97,95
North Dakota,Bowman County,2,227,114,113
North Dakota,Bowman County,3,215,111,104
North Dakota,Bowman County,4,171,97,74
North Dakota,Bowman County,5,155,71,84
North Dakota,Bowman County,6,156,75,81
North Dakota,Bowman County,7,167,98,69
North Dakota,Bowman County,8,191,96,95
North Dakota,Bowman County,9,158,87,71
North Dakota,Bowman County,10,154,85,69
North Dakota,Bowman County,11,140,71,69
North Dakota,Bowman County,12,215,102,113
North Dakota,Bowman County,13,276,132,144
North Dakota,Bowman County,14,190,100,90
North Dakota,Bowman County,15,142,68,74
North Dakota,Bowman County,16,117,57,60
North Dakota,Bowman County,17,93,44,49
North Dakota,Bowman County,18,117,43,74
North Dakota,Burke County,0,2100,1095,1005
North Dakota,Burke County,1,175,79,96
North Dakota,Burke County,2,135,70,65
North Dakota,Burke County,3,134,71,63
North Dakota,Burke County,4,122,68,54
North Dakota,Burke County,5,88,53,35
North Dakota,Burke County,6,129,71,58
North Dakota,Burke County,7,107,57,50
North Dakota,Burke County,8,131,67,64
North Dakota,Burke County,9,102,56,46
North Dakota,Burke County,10,99,48,51
North Dakota,Burke County,11,109,64,45
North Dakota,Burke County,12,163,95,68
North Dakota,Burke County,13,170,88,82
North Dakota,Burke County,14,153,83,70
North Dakota,Burke County,15,114,56,58
North Dakota,Burke County,16,69,34,35
North Dakota,Burke County,17,42,18,24
North Dakota,Burke County,18,58,17,41
North Dakota,Burleigh County,0,95273,47746,47527
North Dakota,Burleigh County,1,6551,3292,3259
North Dakota,Burleigh County,2,6163,3181,2982
North Dakota,Burleigh County,3,6069,3094,2975
North Dakota,Burleigh County,4,5911,3028,2883
North Dakota,Burleigh County,5,5989,3040,2949
North Dakota,Burleigh County,6,6923,3716,3207
North Dakota,Burleigh County,7,6921,3698,3223
North Dakota,Burleigh County,8,6778,3595,3183
North Dakota,Burleigh County,9,5576,2904,2672
North Dakota,Burleigh County,10,5347,2746,2601
North Dakota,Burleigh County,11,5360,2767,2593
North Dakota,Burleigh County,12,6407,3047,3360
North Dakota,Burleigh County,13,5963,2875,3088
North Dakota,Burleigh County,14,4980,2386,2594
North Dakota,Burleigh County,15,3561,1692,1869
North Dakota,Burleigh County,16,2461,1127,1334
North Dakota,Burleigh County,17,1859,728,1131
North Dakota,Burleigh County,18,2454,830,1624
North Dakota,Cass County,0,181516,91810,89706
North Dakota,Cass County,1,12904,6631,6273
North Dakota,Cass County,2,11545,5926,5619
North Dakota,Cass County,3,10665,5413,5252
North Dakota,Cass County,4,11523,5940,5583
North Dakota,Cass County,5,19984,10015,9969
North Dakota,Cass County,6,17379,9166,8213
North Dakota,Cass County,7,14395,7621,6774
North Dakota,Cass County,8,13286,6962,6324
North Dakota,Cass County,9,10433,5528,4905
North Dakota,Cass County,10,9533,4948,4585
North Dakota,Cass County,11,9238,4757,4481
North Dakota,Cass County,12,9676,4707,4969
North Dakota,Cass County,13,9161,4425,4736
North Dakota,Cass County,14,7537,3700,3837
North Dakota,Cass County,15,5114,2480,2634
North Dakota,Cass County,16,3240,1453,1787
North Dakota,Cass County,17,2551,1028,1523
North Dakota,Cass County,18,3352,1110,2242
North Dakota,Cavalier County,0,3829,1958,1871
North Dakota,Cavalier County,1,270,134,136
North Dakota,Cavalier County,2,228,124,104
North Dakota,Cavalier County,3,222,117,105
North Dakota,Cavalier County,4,197,108,89
North Dakota,Cavalier County,5,197,105,92
North Dakota,Cavalier County,6,173,88,85
North Dakota,Cavalier County,7,189,109,80
North Dakota,Cavalier County,8,163,76,87
North Dakota,Cavalier County,9,165,86,79
North Dakota,Cavalier County,10,183,97,86
North Dakota,Cavalier County,11,224,110,114
North Dakota,Cavalier County,12,296,156,140
North Dakota,Cavalier County,13,290,166,124
North Dakota,Cavalier County,14,285,146,139
North Dakota,Cavalier County,15,232,121,111
North Dakota,Cavalier County,16,179,83,96
North Dakota,Cavalier County,17,156,66,90
North Dakota,Cavalier County,18,180,66,114
North Dakota,Dickey County,0,4903,2435,2468
North Dakota,Dickey County,1,323,153,170
North Dakota,Dickey County,2,307,173,134
North Dakota,Dickey County,3,363,185,178
North Dakota,Dickey County,4,360,186,174
North Dakota,Dickey County,5,318,152,166
North Dakota,Dickey County,6,240,121,119
North Dakota,Dickey County,7,242,126,116
North Dakota,Dickey County,8,268,143,125
North Dakota,Dickey County,9,244,127,117
North Dakota,Dickey County,10,254,122,132
North Dakota,Dickey County,11,277,141,136
North Dakota,Dickey County,12,336,174,162
North Dakota,Dickey County,13,369,184,185
North Dakota,Dickey County,14,258,135,123
North Dakota,Dickey County,15,229,116,113
North Dakota,Dickey County,16,195,86,109
North Dakota,Dickey County,17,132,50,82
North Dakota,Dickey County,18,188,61,127
North Dakota,Divide County,0,2283,1194,1089
North Dakota,Divide County,1,143,90,53
North Dakota,Divide County,2,136,85,51
North Dakota,Divide County,3,162,75,87
North Dakota,Divide County,4,101,49,52
North Dakota,Divide County,5,80,45,35
North Dakota,Divide County,6,107,58,49
North Dakota,Divide County,7,123,75,48
North Dakota,Divide County,8,124,62,62
North Dakota,Divide County,9,97,51,46
North Dakota,Divide County,10,89,50,39
North Dakota,Divide County,11,159,67,92
North Dakota,Divide County,12,202,98,104
North Dakota,Divide County,13,183,99,84
North Dakota,Divide County,14,157,93,64
North Dakota,Divide County,15,149,82,67
North Dakota,Divide County,16,87,41,46
North Dakota,Divide County,17,78,41,37
North Dakota,Divide County,18,106,33,73
North Dakota,Dunn County,0,4332,2306,2026
North Dakota,Dunn County,1,326,169,157
North Dakota,Dunn County,2,296,134,162
North Dakota,Dunn County,3,267,152,115
North Dakota,Dunn County,4,222,109,113
North Dakota,Dunn County,5,219,118,101
North Dakota,Dunn County,6,327,183,144
North Dakota,Dunn County,7,304,175,129
North Dakota,Dunn County,8,264,153,111
North Dakota,Dunn County,9,223,123,100
North Dakota,Dunn County,10,209,119,90
North Dakota,Dunn County,11,266,138,128
North Dakota,Dunn County,12,366,199,167
North Dakota,Dunn County,13,353,189,164
North Dakota,Dunn County,14,249,136,113
North Dakota,Dunn County,15,126,59,67
North Dakota,Dunn County,16,110,53,57
North Dakota,Dunn County,17,118,62,56
North Dakota,Dunn County,18,87,35,52
North Dakota,Eddy County,0,2313,1148,1165
North Dakota,Eddy County,1,163,86,77
North Dakota,Eddy County,2,132,73,59
North Dakota,Eddy County,3,154,85,69
North Dakota,Eddy County,4,145,66,79
North Dakota,Eddy County,5,97,51,46
North Dakota,Eddy County,6,114,59,55
North Dakota,Eddy County,7,123,65,58
North Dakota,Eddy County,8,109,54,55
North Dakota,Eddy County,9,122,61,61
North Dakota,Eddy County,10,98,50,48
North Dakota,Eddy County,11,143,67,76
North Dakota,Eddy County,12,183,98,85
North Dakota,Eddy County,13,198,103,95
North Dakota,Eddy County,14,168,86,82
North Dakota,Eddy County,15,104,52,52
North Dakota,Eddy County,16,82,37,45
North Dakota,Eddy County,17,74,30,44
North Dakota,Eddy County,18,104,25,79
North Dakota,Emmons County,0,3295,1672,1623
North Dakota,Emmons County,1,171,81,90
North Dakota,Emmons County,2,166,88,78
North Dakota,Emmons County,3,191,93,98
North Dakota,Emmons County,4,180,94,86
North Dakota,Emmons County,5,193,111,82
North Dakota,Emmons County,6,144,77,67
North Dakota,Emmons County,7,120,62,58
North Dakota,Emmons County,8,139,63,76
North Dakota,Emmons County,9,144,76,68
North Dakota,Emmons County,10,164,83,81
North Dakota,Emmons County,11,211,100,111
North Dakota,Emmons County,12,273,157,116
North Dakota,Emmons County,13,280,148,132
North Dakota,Emmons County,14,245,132,113
North Dakota,Emmons County,15,201,94,107
North Dakota,Emmons County,16,156,71,85
North Dakota,Emmons County,17,149,73,76
North Dakota,Emmons County,18,168,69,99
North Dakota,Foster County,0,3216,1594,1622
North Dakota,Foster County,1,205,88,117
North Dakota,Foster County,2,166,81,85
North Dakota,Foster County,3,205,101,104
North Dakota,Foster County,4,168,72,96
North Dakota,Foster County,5,176,91,85
North Dakota,Foster County,6,172,94,78
North Dakota,Foster County,7,171,106,65
North Dakota,Foster County,8,154,80,74
North Dakota,Foster County,9,175,96,79
North Dakota,Foster County,10,184,95,89
North Dakota,Foster County,11,182,82,100
North Dakota,Foster County,12,271,143,128
North Dakota,Foster County,13,263,141,122
North Dakota,Foster County,14,181,89,92
North Dakota,Foster County,15,177,85,92
North Dakota,Foster County,16,106,47,59
North Dakota,Foster County,17,106,49,57
North Dakota,Foster County,18,154,54,100
North Dakota,Golden Valley County,0,1769,880,889
North Dakota,Golden Valley County,1,107,56,51
North Dakota,Golden Valley County,2,87,41,46
North Dakota,Golden Valley County,3,105,55,50
North Dakota,Golden Valley County,4,121,64,57
North Dakota,Golden Valley County,5,75,48,27
North Dakota,Golden Valley County,6,81,46,35
North Dakota,Golden Valley County,7,79,40,39
North Dakota,Golden Valley County,8,115,51,64
North Dakota,Golden Valley County,9,109,60,49
North Dakota,Golden Valley County,10,81,38,43
North Dakota,Golden Valley County,11,100,51,49
North Dakota,Golden Valley County,12,123,58,65
North Dakota,Golden Valley County,13,154,84,70
North Dakota,Golden Valley County,14,152,83,69
North Dakota,Golden Valley County,15,77,30,47
North Dakota,Golden Valley County,16,62,26,36
North Dakota,Golden Valley County,17,55,21,34
North Dakota,Golden Valley County,18,86,28,58
North Dakota,Grand Forks County,0,70770,36545,34225
North Dakota,Grand Forks County,1,4914,2496,2418
North Dakota,Grand Forks County,2,4255,2115,2140
North Dakota,Grand Forks County,3,3797,1990,1807
North Dakota,Grand Forks County,4,5105,2673,2432
North Dakota,Grand Forks County,5,10981,5886,5095
North Dakota,Grand Forks County,6,6675,3770,2905
North Dakota,Grand Forks County,7,4888,2731,2157
North Dakota,Grand Forks County,8,4167,2234,1933
North Dakota,Grand Forks County,9,3179,1705,1474
North Dakota,Grand Forks County,10,3136,1589,1547
North Dakota,Grand Forks County,11,3071,1516,1555
North Dakota,Grand Forks County,12,3952,1964,1988
North Dakota,Grand Forks County,13,3673,1834,1839
North Dakota,Grand Forks County,14,3011,1523,1488
North Dakota,Grand Forks County,15,2169,1006,1163
North Dakota,Grand Forks County,16,1492,687,805
North Dakota,Grand Forks County,17,1010,409,601
North Dakota,Grand Forks County,18,1295,417,878
North Dakota,Grant County,0,2374,1185,1189
North Dakota,Grant County,1,148,65,83
North Dakota,Grant County,2,158,75,83
North Dakota,Grant County,3,121,50,71
North Dakota,Grant County,4,96,50,46
North Dakota,Grant County,5,94,46,48
North Dakota,Grant County,6,103,52,51
North Dakota,Grant County,7,113,57,56
North Dakota,Grant County,8,106,55,51
North Dakota,Grant County,9,105,62,43
North Dakota,Grant County,10,119,60,59
North Dakota,Grant County,11,129,69,60
North Dakota,Grant County,12,192,100,92
North Dakota,Grant County,13,180,91,89
North Dakota,Grant County,14,210,118,92
North Dakota,Grant County,15,170,81,89
North Dakota,Grant County,16,132,69,63
North Dakota,Grant County,17,91,36,55
North Dakota,Grant County,18,107,49,58
North Dakota,Griggs County,0,2232,1149,1083
North Dakota,Griggs County,1,115,55,60
North Dakota,Griggs County,2,141,69,72
North Dakota,Griggs County,3,124,62,62
North Dakota,Griggs County,4,114,69,45
North Dakota,Griggs County,5,100,58,42
North Dakota,Griggs County,6,82,42,40
North Dakota,Griggs County,7,92,41,51
North Dakota,Griggs County,8,115,64,51
North Dakota,Griggs County,9,94,48,46
North Dakota,Griggs County,10,111,62,49
North Dakota,Griggs County,11,115,61,54
North Dakota,Griggs County,12,167,85,82
North Dakota,Griggs County,13,188,96,92
North Dakota,Griggs County,14,194,112,82
North Dakota,Griggs County,15,173,102,71
North Dakota,Griggs County,16,112,56,56
North Dakota,Griggs County,17,77,34,43
North Dakota,Griggs County,18,118,33,85
North Dakota,Hettinger County,0,2514,1218,1296
North Dakota,Hettinger County,1,179,87,92
North Dakota,Hettinger County,2,171,84,87
North Dakota,Hettinger County,3,179,87,92
North Dakota,Hettinger County,4,131,67,64
North Dakota,Hettinger County,5,104,44,60
North Dakota,Hettinger County,6,164,71,93
North Dakota,Hettinger County,7,142,66,76
North Dakota,Hettinger County,8,131,63,68
North Dakota,Hettinger County,9,123,49,74
North Dakota,Hettinger County,10,124,69,55
North Dakota,Hettinger County,11,139,69,70
North Dakota,Hettinger County,12,182,90,92
North Dakota,Hettinger County,13,181,96,85
North Dakota,Hettinger County,14,145,81,64
North Dakota,Hettinger County,15,121,56,65
North Dakota,Hettinger County,16,93,48,45
North Dakota,Hettinger County,17,102,47,55
North Dakota,Hettinger County,18,103,44,59
North Dakota,Kidder County,0,2450,1268,1182
North Dakota,Kidder County,1,149,71,78
North Dakota,Kidder County,2,144,76,68
North Dakota,Kidder County,3,139,69,70
North Dakota,Kidder County,4,128,71,57
North Dakota,Kidder County,5,95,50,45
North Dakota,Kidder County,6,108,63,45
North Dakota,Kidder County,7,143,82,61
North Dakota,Kidder County,8,140,72,68
North Dakota,Kidder County,9,111,59,52
North Dakota,Kidder County,10,131,64,67
North Dakota,Kidder County,11,139,71,68
North Dakota,Kidder County,12,183,95,88
North Dakota,Kidder County,13,240,127,113
North Dakota,Kidder County,14,179,95,84
North Dakota,Kidder County,15,133,76,57
North Dakota,Kidder County,16,113,56,57
North Dakota,Kidder County,17,92,43,49
North Dakota,Kidder County,18,83,28,55
North Dakota,LaMoure County,0,4062,2096,1966
North Dakota,LaMoure County,1,228,119,109
North Dakota,LaMoure County,2,228,131,97
North Dakota,LaMoure County,3,252,135,117
North Dakota,LaMoure County,4,231,126,105
North Dakota,LaMoure County,5,179,99,80
North Dakota,LaMoure County,6,188,92,96
North Dakota,LaMoure County,7,176,83,93
North Dakota,LaMoure County,8,186,97,89
North Dakota,LaMoure County,9,184,99,85
North Dakota,LaMoure County,10,205,108,97
North Dakota,LaMoure County,11,213,110,103
North Dakota,LaMoure County,12,341,188,153
North Dakota,LaMoure County,13,353,176,177
North Dakota,LaMoure County,14,293,164,129
North Dakota,LaMoure County,15,237,125,112
North Dakota,LaMoure County,16,182,85,97
North Dakota,LaMoure County,17,164,72,92
North Dakota,LaMoure County,18,222,87,135
North Dakota,Logan County,0,1903,983,920
North Dakota,Logan County,1,127,80,47
North Dakota,Logan County,2,116,63,53
North Dakota,Logan County,3,124,62,62
North Dakota,Logan County,4,107,48,59
North Dakota,Logan County,5,101,54,47
North Dakota,Logan County,6,81,46,35
North Dakota,Logan County,7,82,41,41
North Dakota,Logan County,8,79,43,36
North Dakota,Logan County,9,89,44,45
North Dakota,Logan County,10,98,51,47
North Dakota,Logan County,11,106,58,48
North Dakota,Logan County,12,157,85,72
North Dakota,Logan County,13,142,78,64
North Dakota,Logan County,14,117,55,62
North Dakota,Logan County,15,111,54,57
North Dakota,Logan County,16,99,51,48
North Dakota,Logan County,17,80,35,45
North Dakota,Logan County,18,87,35,52
North Dakota,McHenry County,0,5816,3012,2804
North Dakota,McHenry County,1,359,183,176
North Dakota,McHenry County,2,402,228,174
North Dakota,McHenry County,3,404,198,206
North Dakota,McHenry County,4,347,190,157
North Dakota,McHenry County,5,215,120,95
North Dakota,McHenry County,6,304,161,143
North Dakota,McHenry County,7,328,184,144
North Dakota,McHenry County,8,350,167,183
North Dakota,McHenry County,9,317,179,138
North Dakota,McHenry County,10,312,160,152
North Dakota,McHenry County,11,408,224,184
North Dakota,McHenry County,12,410,212,198
North Dakota,McHenry County,13,473,240,233
North Dakota,McHenry County,14,336,167,169
North Dakota,McHenry County,15,309,166,143
North Dakota,McHenry County,16,207,106,101
North Dakota,McHenry County,17,152,68,84
North Dakota,McHenry County,18,183,59,124
North Dakota,McIntosh County,0,2585,1261,1324
North Dakota,McIntosh County,1,121,65,56
North Dakota,McIntosh County,2,145,75,70
North Dakota,McIntosh County,3,142,72,70
North Dakota,McIntosh County,4,110,60,50
North Dakota,McIntosh County,5,126,64,62
North Dakota,McIntosh County,6,101,42,59
North Dakota,McIntosh County,7,124,59,65
North Dakota,McIntosh County,8,116,59,57
North Dakota,McIntosh County,9,92,43,49
North Dakota,McIntosh County,10,104,69,35
North Dakota,McIntosh County,11,162,78,84
North Dakota,McIntosh County,12,225,118,107
North Dakota,McIntosh County,13,224,124,100
North Dakota,McIntosh County,14,162,81,81
North Dakota,McIntosh County,15,152,71,81
North Dakota,McIntosh County,16,139,63,76
North Dakota,McIntosh County,17,145,63,82
North Dakota,McIntosh County,18,195,55,140
North Dakota,McKenzie County,0,13632,7277,6355
North Dakota,McKenzie County,1,1354,707,647
North Dakota,McKenzie County,2,1251,663,588
North Dakota,McKenzie County,3,1083,570,513
North Dakota,McKenzie County,4,879,448,431
North Dakota,McKenzie County,5,836,413,423
North Dakota,McKenzie County,6,1242,700,542
North Dakota,McKenzie County,7,1154,656,498
North Dakota,McKenzie County,8,960,541,419
North Dakota,McKenzie County,9,705,391,314
North Dakota,McKenzie County,10,726,387,339
North Dakota,McKenzie County,11,719,384,335
North Dakota,McKenzie County,12,798,432,366
North Dakota,McKenzie County,13,677,375,302
North Dakota,McKenzie County,14,483,249,234
North Dakota,McKenzie County,15,276,142,134
North Dakota,McKenzie County,16,200,93,107
North Dakota,McKenzie County,17,133,67,66
North Dakota,McKenzie County,18,156,59,97
North Dakota,McLean County,0,9541,4867,4674
North Dakota,McLean County,1,603,320,283
North Dakota,McLean County,2,592,274,318
North Dakota,McLean County,3,584,290,294
North Dakota,McLean County,4,455,239,216
North Dakota,McLean County,5,417,223,194
North Dakota,McLean County,6,502,251,251
North Dakota,McLean County,7,496,265,231
North Dakota,McLean County,8,531,275,256
North Dakota,McLean County,9,498,269,229
North Dakota,McLean County,10,512,259,253
North Dakota,McLean County,11,520,283,237
North Dakota,McLean County,12,735,365,370
North Dakota,McLean County,13,848,427,421
North Dakota,McLean County,14,737,390,347
North Dakota,McLean County,15,598,304,294
North Dakota,McLean County,16,388,200,188
North Dakota,McLean County,17,266,137,129
North Dakota,McLean County,18,259,96,163
North Dakota,Mercer County,0,8267,4269,3998
North Dakota,Mercer County,1,518,276,242
North Dakota,Mercer County,2,558,256,302
North Dakota,Mercer County,3,519,269,250
North Dakota,Mercer County,4,451,255,196
North Dakota,Mercer County,5,368,208,160
North Dakota,Mercer County,6,428,229,199
North Dakota,Mercer County,7,490,262,228
North Dakota,Mercer County,8,497,278,219
North Dakota,Mercer County,9,428,218,210
North Dakota,Mercer County,10,404,211,193
North Dakota,Mercer County,11,529,272,257
North Dakota,Mercer County,12,762,411,351
North Dakota,Mercer County,13,723,381,342
North Dakota,Mercer County,14,501,276,225
North Dakota,Mercer County,15,382,172,210
North Dakota,Mercer County,16,272,143,129
North Dakota,Mercer County,17,202,73,129
North Dakota,Mercer County,18,235,79,156
North Dakota,Morton County,0,31095,15731,15364
North Dakota,Morton County,1,2235,1123,1112
North Dakota,Morton County,2,1991,1017,974
North Dakota,Morton County,3,1941,986,955
North Dakota,Morton County,4,1561,793,768
North Dakota,Morton County,5,1713,861,852
North Dakota,Morton County,6,2442,1310,1132
North Dakota,Morton County,7,2321,1256,1065
North Dakota,Morton County,8,2198,1192,1006
North Dakota,Morton County,9,1810,953,857
North Dakota,Morton County,10,1726,879,847
North Dakota,Morton County,11,1789,922,867
North Dakota,Morton County,12,2086,1051,1035
North Dakota,Morton County,13,2079,1035,1044
North Dakota,Morton County,14,1641,836,805
North Dakota,Morton County,15,1201,597,604
North Dakota,Morton County,16,811,374,437
North Dakota,Morton County,17,670,280,390
North Dakota,Morton County,18,880,266,614
North Dakota,Mountrail County,0,10218,5482,4736
North Dakota,Mountrail County,1,864,427,437
North Dakota,Mountrail County,2,800,404,396
North Dakota,Mountrail County,3,655,336,319
North Dakota,Mountrail County,4,649,347,302
North Dakota,Mountrail County,5,706,426,280
North Dakota,Mountrail County,6,932,543,389
North Dakota,Mountrail County,7,745,437,308
North Dakota,Mountrail County,8,650,373,277
North Dakota,Mountrail County,9,597,333,264
North Dakota,Mountrail County,10,582,297,285
North Dakota,Mountrail County,11,559,273,286
North Dakota,Mountrail County,12,666,360,306
North Dakota,Mountrail County,13,620,341,279
North Dakota,Mountrail County,14,455,218,237
North Dakota,Mountrail County,15,295,166,129
North Dakota,Mountrail County,16,204,97,107
North Dakota,Mountrail County,17,104,45,59
North Dakota,Mountrail County,18,135,59,76
North Dakota,Nelson County,0,2869,1472,1397
North Dakota,Nelson County,1,148,63,85
North Dakota,Nelson County,2,153,83,70
North Dakota,Nelson County,3,160,82,78
North Dakota,Nelson County,4,140,69,71
North Dakota,Nelson County,5,127,77,50
North Dakota,Nelson County,6,118,66,52
North Dakota,Nelson County,7,135,74,61
North Dakota,Nelson County,8,139,80,59
North Dakota,Nelson County,9,135,74,61
North Dakota,Nelson County,10,128,58,70
North Dakota,Nelson County,11,169,81,88
North Dakota,Nelson County,12,270,139,131
North Dakota,Nelson County,13,275,145,130
North Dakota,Nelson County,14,214,115,99
North Dakota,Nelson County,15,186,103,83
North Dakota,Nelson County,16,135,68,67
North Dakota,Nelson County,17,109,47,62
North Dakota,Nelson County,18,128,48,80
North Dakota,Oliver County,0,1952,1020,932
North Dakota,Oliver County,1,128,69,59
North Dakota,Oliver County,2,141,56,85
North Dakota,Oliver County,3,146,78,68
North Dakota,Oliver County,4,114,62,52
North Dakota,Oliver County,5,63,37,26
North Dakota,Oliver County,6,82,42,40
North Dakota,Oliver County,7,111,65,46
North Dakota,Oliver County,8,107,55,52
North Dakota,Oliver County,9,93,50,43
North Dakota,Oliver County,10,92,56,36
North Dakota,Oliver County,11,131,70,61
North Dakota,Oliver County,12,143,65,78
North Dakota,Oliver County,13,168,90,78
North Dakota,Oliver County,14,168,92,76
North Dakota,Oliver County,15,114,56,58
North Dakota,Oliver County,16,62,36,26
North Dakota,Oliver County,17,36,19,17
North Dakota,Oliver County,18,53,22,31
North Dakota,Pembina County,0,6947,3669,3278
North Dakota,Pembina County,1,395,201,194
North Dakota,Pembina County,2,398,229,169
North Dakota,Pembina County,3,390,202,188
North Dakota,Pembina County,4,380,189,191
North Dakota,Pembina County,5,304,165,139
North Dakota,Pembina County,6,318,172,146
North Dakota,Pembina County,7,485,292,193
North Dakota,Pembina County,8,427,245,182
North Dakota,Pembina County,9,354,204,150
North Dakota,Pembina County,10,321,172,149
North Dakota,Pembina County,11,392,181,211
North Dakota,Pembina County,12,564,287,277
North Dakota,Pembina County,13,612,315,297
North Dakota,Pembina County,14,522,314,208
North Dakota,Pembina County,15,344,179,165
North Dakota,Pembina County,16,253,128,125
North Dakota,Pembina County,17,195,78,117
North Dakota,Pembina County,18,293,116,177
North Dakota,Pierce County,0,4081,2089,1992
North Dakota,Pierce County,1,221,119,102
North Dakota,Pierce County,2,292,149,143
North Dakota,Pierce County,3,258,118,140
North Dakota,Pierce County,4,217,114,103
North Dakota,Pierce County,5,212,134,78
North Dakota,Pierce County,6,213,128,85
North Dakota,Pierce County,7,187,102,85
North Dakota,Pierce County,8,221,113,108
North Dakota,Pierce County,9,238,120,118
North Dakota,Pierce County,10,195,115,80
North Dakota,Pierce County,11,253,130,123
North Dakota,Pierce County,12,287,144,143
North Dakota,Pierce County,13,325,173,152
North Dakota,Pierce County,14,257,129,128
North Dakota,Pierce County,15,209,112,97
North Dakota,Pierce County,16,167,74,93
North Dakota,Pierce County,17,120,51,69
North Dakota,Pierce County,18,209,64,145
North Dakota,Ramsey County,0,11481,5783,5698
North Dakota,Ramsey County,1,810,408,402
North Dakota,Ramsey County,2,778,385,393
North Dakota,Ramsey County,3,710,376,334
North Dakota,Ramsey County,4,703,347,356
North Dakota,Ramsey County,5,666,346,320
North Dakota,Ramsey County,6,699,375,324
North Dakota,Ramsey County,7,654,336,318
North Dakota,Ramsey County,8,620,333,287
North Dakota,Ramsey County,9,571,287,284
North Dakota,Ramsey County,10,586,299,287
North Dakota,Ramsey County,11,703,341,362
North Dakota,Ramsey County,12,863,439,424
North Dakota,Ramsey County,13,836,426,410
North Dakota,Ramsey County,14,689,351,338
North Dakota,Ramsey County,15,526,272,254
North Dakota,Ramsey County,16,404,191,213
North Dakota,Ramsey County,17,287,135,152
North Dakota,Ramsey County,18,376,136,240
North Dakota,Ransom County,0,5237,2723,2514
North Dakota,Ransom County,1,320,188,132
North Dakota,Ransom County,2,308,156,152
North Dakota,Ransom County,3,358,191,167
North Dakota,Ransom County,4,315,170,145
North Dakota,Ransom County,5,279,151,128
North Dakota,Ransom County,6,271,151,120
North Dakota,Ransom County,7,233,136,97
North Dakota,Ransom County,8,300,147,153
North Dakota,Ransom County,9,294,145,149
North Dakota,Ransom County,10,321,167,154
North Dakota,Ransom County,11,347,181,166
North Dakota,Ransom County,12,406,207,199
North Dakota,Ransom County,13,404,195,209
North Dakota,Ransom County,14,307,173,134
North Dakota,Ransom County,15,236,137,99
North Dakota,Ransom County,16,158,72,86
North Dakota,Ransom County,17,150,69,81
North Dakota,Ransom County,18,230,87,143
North Dakota,Renville County,0,2374,1241,1133
North Dakota,Renville County,1,144,84,60
North Dakota,Renville County,2,148,73,75
North Dakota,Renville County,3,143,76,67
North Dakota,Renville County,4,149,73,76
North Dakota,Renville County,5,108,55,53
North Dakota,Renville County,6,128,77,51
North Dakota,Renville County,7,126,74,52
North Dakota,Renville County,8,135,80,55
North Dakota,Renville County,9,114,51,63
North Dakota,Renville County,10,140,76,64
North Dakota,Renville County,11,164,79,85
North Dakota,Renville County,12,208,119,89
North Dakota,Renville County,13,185,87,98
North Dakota,Renville County,14,145,75,70
North Dakota,Renville County,15,107,61,46
North Dakota,Renville County,16,76,37,39
North Dakota,Renville County,17,72,34,38
North Dakota,Renville County,18,82,30,52
North Dakota,Richland County,0,16239,8369,7870
North Dakota,Richland County,1,1024,512,512
North Dakota,Richland County,2,983,498,485
North Dakota,Richland County,3,1005,517,488
North Dakota,Richland County,4,1275,690,585
North Dakota,Richland County,5,1491,843,648
North Dakota,Richland County,6,985,520,465
North Dakota,Richland County,7,857,451,406
North Dakota,Richland County,8,929,472,457
North Dakota,Richland County,9,742,394,348
North Dakota,Richland County,10,761,402,359
North Dakota,Richland County,11,899,430,469
North Dakota,Richland County,12,1187,631,556
North Dakota,Richland County,13,1197,609,588
North Dakota,Richland County,14,896,489,407
North Dakota,Richland County,15,630,315,315
North Dakota,Richland County,16,465,228,237
North Dakota,Richland County,17,388,168,220
North Dakota,Richland County,18,525,200,325
North Dakota,Rolette County,0,14301,7121,7180
North Dakota,Rolette County,1,1304,687,617
North Dakota,Rolette County,2,1439,738,701
North Dakota,Rolette County,3,1422,706,716
North Dakota,Rolette County,4,1063,570,493
North Dakota,Rolette County,5,856,442,414
North Dakota,Rolette County,6,896,441,455
North Dakota,Rolette County,7,834,398,436
North Dakota,Rolette County,8,830,413,417
North Dakota,Rolette County,9,737,368,369
North Dakota,Rolette County,10,725,360,365
North Dakota,Rolette County,11,796,369,427
North Dakota,Rolette County,12,913,461,452
North Dakota,Rolette County,13,815,402,413
North Dakota,Rolette County,14,609,280,329
North Dakota,Rolette County,15,425,216,209
North Dakota,Rolette County,16,276,121,155
North Dakota,Rolette County,17,192,89,103
North Dakota,Rolette County,18,169,60,109
North Dakota,Sargent County,0,3870,2080,1790
North Dakota,Sargent County,1,221,112,109
North Dakota,Sargent County,2,228,127,101
North Dakota,Sargent County,3,224,121,103
North Dakota,Sargent County,4,199,102,97
North Dakota,Sargent County,5,204,114,90
North Dakota,Sargent County,6,248,150,98
North Dakota,Sargent County,7,194,110,84
North Dakota,Sargent County,8,215,118,97
North Dakota,Sargent County,9,208,126,82
North Dakota,Sargent County,10,218,114,104
North Dakota,Sargent County,11,258,130,128
North Dakota,Sargent County,12,302,171,131
North Dakota,Sargent County,13,279,165,114
North Dakota,Sargent County,14,287,145,142
North Dakota,Sargent County,15,218,115,103
North Dakota,Sargent County,16,157,73,84
North Dakota,Sargent County,17,90,43,47
North Dakota,Sargent County,18,120,44,76
North Dakota,Sheridan County,0,1349,677,672
North Dakota,Sheridan County,1,76,41,35
North Dakota,Sheridan County,2,66,31,35
North Dakota,Sheridan County,3,61,32,29
North Dakota,Sheridan County,4,71,39,32
North Dakota,Sheridan County,5,50,29,21
North Dakota,Sheridan County,6,49,23,26
North Dakota,Sheridan County,7,65,30,35
North Dakota,Sheridan County,8,54,28,26
North Dakota,Sheridan County,9,39,26,13
North Dakota,Sheridan County,10,73,36,37
North Dakota,Sheridan County,11,88,40,48
North Dakota,Sheridan County,12,107,58,49
North Dakota,Sheridan County,13,113,63,50
North Dakota,Sheridan County,14,96,51,45
North Dakota,Sheridan County,15,95,41,54
North Dakota,Sheridan County,16,87,48,39
North Dakota,Sheridan County,17,70,23,47
North Dakota,Sheridan County,18,89,38,51
North Dakota,Sioux County,0,4358,2173,2185
North Dakota,Sioux County,1,447,205,242
North Dakota,Sioux County,2,423,202,221
North Dakota,Sioux County,3,433,219,214
North Dakota,Sioux County,4,414,225,189
North Dakota,Sioux County,5,287,151,136
North Dakota,Sioux County,6,303,157,146
North Dakota,Sioux County,7,275,133,142
North Dakota,Sioux County,8,257,122,135
North Dakota,Sioux County,9,234,118,116
North Dakota,Sioux County,10,222,119,103
North Dakota,Sioux County,11,277,132,145
North Dakota,Sioux County,12,262,131,131
North Dakota,Sioux County,13,171,88,83
North Dakota,Sioux County,14,123,58,65
North Dakota,Sioux County,15,81,34,47
North Dakota,Sioux County,16,71,38,33
North Dakota,Sioux County,17,43,22,21
North Dakota,Sioux County,18,35,19,16
North Dakota,Slope County,0,763,399,364
North Dakota,Slope County,1,43,19,24
North Dakota,Slope County,2,48,20,28
North Dakota,Slope County,3,40,20,20
North Dakota,Slope County,4,41,28,13
North Dakota,Slope County,5,33,17,16
North Dakota,Slope County,6,36,22,14
North Dakota,Slope County,7,33,16,17
North Dakota,Slope County,8,45,26,19
North Dakota,Slope County,9,31,20,11
North Dakota,Slope County,10,33,15,18
North Dakota,Slope County,11,47,30,17
North Dakota,Slope County,12,78,38,40
North Dakota,Slope County,13,80,44,36
North Dakota,Slope County,14,53,23,30
North Dakota,Slope County,15,49,29,20
North Dakota,Slope County,16,17,11,6
North Dakota,Slope County,17,28,10,18
North Dakota,Slope County,18,28,11,17
North Dakota,Stark County,0,30997,16051,14946
North Dakota,Stark County,1,2679,1391,1288
North Dakota,Stark County,2,2348,1211,1137
North Dakota,Stark County,3,2148,1121,1027
North Dakota,Stark County,4,1766,876,890
North Dakota,Stark County,5,1779,909,870
North Dakota,Stark County,6,2780,1480,1300
North Dakota,Stark County,7,2531,1426,1105
North Dakota,Stark County,8,2302,1257,1045
North Dakota,Stark County,9,1578,895,683
North Dakota,Stark County,10,1552,837,715
North Dakota,Stark County,11,1651,841,810
North Dakota,Stark County,12,1966,1002,964
North Dakota,Stark County,13,1713,908,805
North Dakota,Stark County,14,1230,661,569
North Dakota,Stark County,15,913,438,475
North Dakota,Stark County,16,651,285,366
North Dakota,Stark County,17,570,237,333
North Dakota,Stark County,18,840,276,564
North Dakota,Steele County,0,1903,995,908
North Dakota,Steele County,1,136,68,68
North Dakota,Steele County,2,109,57,52
North Dakota,Steele County,3,105,59,46
North Dakota,Steele County,4,96,45,51
North Dakota,Steele County,5,103,51,52
North Dakota,Steele County,6,107,53,54
North Dakota,Steele County,7,84,45,39
North Dakota,Steele County,8,90,53,37
North Dakota,Steele County,9,86,41,45
North Dakota,Steele County,10,101,53,48
North Dakota,Steele County,11,106,57,49
North Dakota,Steele County,12,162,85,77
North Dakota,Steele County,13,159,94,65
North Dakota,Steele County,14,150,82,68
North Dakota,Steele County,15,112,57,55
North Dakota,Steele County,16,87,49,38
North Dakota,Steele County,17,63,25,38
North Dakota,Steele County,18,47,21,26
North Dakota,Stutsman County,0,20917,10758,10159
North Dakota,Stutsman County,1,1123,581,542
North Dakota,Stutsman County,2,1178,549,629
North Dakota,Stutsman County,3,1205,606,599
North Dakota,Stutsman County,4,1290,659,631
North Dakota,Stutsman County,5,1619,908,711
North Dakota,Stutsman County,6,1318,743,575
North Dakota,Stutsman County,7,1258,725,533
North Dakota,Stutsman County,8,1268,681,587
North Dakota,Stutsman County,9,1153,640,513
North Dakota,Stutsman County,10,1116,599,517
North Dakota,Stutsman County,11,1277,668,609
North Dakota,Stutsman County,12,1544,797,747
North Dakota,Stutsman County,13,1575,796,779
North Dakota,Stutsman County,14,1312,675,637
North Dakota,Stutsman County,15,868,394,474
North Dakota,Stutsman County,16,634,287,347
North Dakota,Stutsman County,17,495,221,274
North Dakota,Stutsman County,18,684,229,455
North Dakota,Towner County,0,2192,1107,1085
North Dakota,Towner County,1,122,66,56
North Dakota,Towner County,2,138,66,72
North Dakota,Towner County,3,123,59,64
North Dakota,Towner County,4,111,58,53
North Dakota,Towner County,5,105,58,47
North Dakota,Towner County,6,71,40,31
North Dakota,Towner County,7,106,54,52
North Dakota,Towner County,8,103,57,46
North Dakota,Towner County,9,82,37,45
North Dakota,Towner County,10,111,57,54
North Dakota,Towner County,11,168,84,84
North Dakota,Towner County,12,191,113,78
North Dakota,Towner County,13,211,109,102
North Dakota,Towner County,14,159,79,80
North Dakota,Towner County,15,114,54,60
North Dakota,Towner County,16,95,49,46
North Dakota,Towner County,17,91,44,47
North Dakota,Towner County,18,91,23,68
North Dakota,Traill County,0,8037,4079,3958
North Dakota,Traill County,1,502,260,242
North Dakota,Traill County,2,493,261,232
North Dakota,Traill County,3,500,263,237
North Dakota,Traill County,4,582,289,293
North Dakota,Traill County,5,475,257,218
North Dakota,Traill County,6,460,257,203
North Dakota,Traill County,7,465,234,231
North Dakota,Traill County,8,417,207,210
North Dakota,Traill County,9,439,230,209
North Dakota,Traill County,10,443,218,225
North Dakota,Traill County,11,518,274,244
North Dakota,Traill County,12,595,317,278
North Dakota,Traill County,13,573,292,281
North Dakota,Traill County,14,452,242,210
North Dakota,Traill County,15,333,165,168
North Dakota,Traill County,16,277,129,148
North Dakota,Traill County,17,205,93,112
North Dakota,Traill County,18,308,91,217
North Dakota,Walsh County,0,10667,5460,5207
North Dakota,Walsh County,1,721,366,355
North Dakota,Walsh County,2,659,376,283
North Dakota,Walsh County,3,636,336,300
North Dakota,Walsh County,4,636,341,295
North Dakota,Walsh County,5,529,276,253
North Dakota,Walsh County,6,625,344,281
North Dakota,Walsh County,7,521,267,254
North Dakota,Walsh County,8,584,306,278
North Dakota,Walsh County,9,535,252,283
North Dakota,Walsh County,10,592,302,290
North Dakota,Walsh County,11,677,355,322
North Dakota,Walsh County,12,856,461,395
North Dakota,Walsh County,13,834,438,396
North Dakota,Walsh County,14,650,334,316
North Dakota,Walsh County,15,509,260,249
North Dakota,Walsh County,16,418,194,224
North Dakota,Walsh County,17,305,119,186
North Dakota,Walsh County,18,380,133,247
North Dakota,Ward County,0,67744,35487,32257
North Dakota,Ward County,1,5196,2680,2516
North Dakota,Ward County,2,4434,2212,2222
North Dakota,Ward County,3,4104,2115,1989
North Dakota,Ward County,4,4123,2234,1889
North Dakota,Ward County,5,6709,4057,2652
North Dakota,Ward County,6,6960,3915,3045
North Dakota,Ward County,7,5386,2987,2399
North Dakota,Ward County,8,4702,2502,2200
North Dakota,Ward County,9,3564,1831,1733
North Dakota,Ward County,10,3399,1750,1649
North Dakota,Ward County,11,3204,1608,1596
North Dakota,Ward County,12,3849,1938,1911
North Dakota,Ward County,13,3474,1706,1768
North Dakota,Ward County,14,2648,1368,1280
North Dakota,Ward County,15,2011,949,1062
North Dakota,Ward County,16,1442,655,787
North Dakota,Ward County,17,1153,460,693
North Dakota,Ward County,18,1386,520,866
North Dakota,Wells County,0,3957,2006,1951
North Dakota,Wells County,1,231,127,104
North Dakota,Wells County,2,241,122,119
North Dakota,Wells County,3,224,121,103
North Dakota,Wells County,4,204,103,101
North Dakota,Wells County,5,150,79,71
North Dakota,Wells County,6,172,88,84
North Dakota,Wells County,7,211,126,85
North Dakota,Wells County,8,158,83,75
North Dakota,Wells County,9,160,84,76
North Dakota,Wells County,10,187,95,92
North Dakota,Wells County,11,266,131,135
North Dakota,Wells County,12,334,153,181
North Dakota,Wells County,13,320,176,144
North Dakota,Wells County,14,283,142,141
North Dakota,Wells County,15,239,113,126
North Dakota,Wells County,16,205,107,98
North Dakota,Wells County,17,164,71,93
North Dakota,Wells County,18,208,85,123
North Dakota,Williams County,0,35350,19043,16307
North Dakota,Williams County,1,3405,1750,1655
North Dakota,Williams County,2,2886,1448,1438
North Dakota,Williams County,3,2570,1343,1227
North Dakota,Williams County,4,2013,1019,994
North Dakota,Williams County,5,2284,1250,1034
North Dakota,Williams County,6,3534,2044,1490
North Dakota,Williams County,7,3205,1874,1331
North Dakota,Williams County,8,2539,1447,1092
North Dakota,Williams County,9,1985,1141,844
North Dakota,Williams County,10,1882,1026,856
North Dakota,Williams County,11,1835,987,848
North Dakota,Williams County,12,2042,1152,890
North Dakota,Williams County,13,1782,983,799
North Dakota,Williams County,14,1166,641,525
North Dakota,Williams County,15,749,366,383
North Dakota,Williams County,16,529,227,302
North Dakota,Williams County,17,414,169,245
North Dakota,Williams County,18,530,176,354
Ohio,Adams County,0,27724,13750,13974
Ohio,Adams County,1,1651,843,808
Ohio,Adams County,2,1777,930,847
Ohio,Adams County,3,1974,1032,942
Ohio,Adams County,4,1821,925,896
Ohio,Adams County,5,1426,709,717
Ohio,Adams County,6,1630,805,825
Ohio,Adams County,7,1434,697,737
Ohio,Adams County,8,1521,744,777
Ohio,Adams County,9,1713,842,871
Ohio,Adams County,10,1886,937,949
Ohio,Adams County,11,1841,921,920
Ohio,Adams County,12,2075,1031,1044
Ohio,Adams County,13,2004,988,1016
Ohio,Adams County,14,1652,832,820
Ohio,Adams County,15,1259,644,615
Ohio,Adams County,16,958,432,526
Ohio,Adams County,17,615,265,350
Ohio,Adams County,18,487,173,314
Ohio,Allen County,0,102663,51787,50876
Ohio,Allen County,1,6323,3236,3087
Ohio,Allen County,2,6420,3333,3087
Ohio,Allen County,3,6797,3501,3296
Ohio,Allen County,4,7206,3884,3322
Ohio,Allen County,5,6905,3815,3090
Ohio,Allen County,6,6944,3840,3104
Ohio,Allen County,7,5702,2926,2776
Ohio,Allen County,8,6173,3135,3038
Ohio,Allen County,9,5813,2887,2926
Ohio,Allen County,10,5901,3025,2876
Ohio,Allen County,11,6338,3231,3107
Ohio,Allen County,12,7085,3516,3569
Ohio,Allen County,13,6939,3409,3530
Ohio,Allen County,14,5927,2917,3010
Ohio,Allen County,15,4339,2047,2292
Ohio,Allen County,16,3109,1355,1754
Ohio,Allen County,17,2178,903,1275
Ohio,Allen County,18,2564,827,1737
Ohio,Ashland County,0,53745,26466,27279
Ohio,Ashland County,1,3108,1608,1500
Ohio,Ashland County,2,3290,1707,1583
Ohio,Ashland County,3,3490,1769,1721
Ohio,Ashland County,4,4102,2031,2071
Ohio,Ashland County,5,3975,1974,2001
Ohio,Ashland County,6,3058,1563,1495
Ohio,Ashland County,7,2907,1457,1450
Ohio,Ashland County,8,2985,1540,1445
Ohio,Ashland County,9,2826,1434,1392
Ohio,Ashland County,10,3174,1562,1612
Ohio,Ashland County,11,3345,1644,1701
Ohio,Ashland County,12,3632,1763,1869
Ohio,Ashland County,13,3797,1829,1968
Ohio,Ashland County,14,3155,1543,1612
Ohio,Ashland County,15,2441,1168,1273
Ohio,Ashland County,16,1914,858,1056
Ohio,Ashland County,17,1238,564,674
Ohio,Ashland County,18,1308,452,856
Ohio,Ashtabula County,0,97493,49141,48352
Ohio,Ashtabula County,1,5562,2881,2681
Ohio,Ashtabula County,2,5843,3004,2839
Ohio,Ashtabula County,3,6281,3268,3013
Ohio,Ashtabula County,4,5892,3085,2807
Ohio,Ashtabula County,5,5337,2848,2489
Ohio,Ashtabula County,6,5965,3208,2757
Ohio,Ashtabula County,7,5352,2811,2541
Ohio,Ashtabula County,8,5523,2833,2690
Ohio,Ashtabula County,9,5380,2735,2645
Ohio,Ashtabula County,10,6360,3294,3066
Ohio,Ashtabula County,11,6778,3396,3382
Ohio,Ashtabula County,12,7265,3634,3631
Ohio,Ashtabula County,13,7366,3614,3752
Ohio,Ashtabula County,14,6068,2983,3085
Ohio,Ashtabula County,15,4658,2195,2463
Ohio,Ashtabula County,16,3406,1618,1788
Ohio,Ashtabula County,17,2180,943,1237
Ohio,Ashtabula County,18,2277,791,1486
Ohio,Athens County,0,65818,32768,33050
Ohio,Athens County,1,2545,1325,1220
Ohio,Athens County,2,2548,1282,1266
Ohio,Athens County,3,2708,1368,1340
Ohio,Athens County,4,8430,4033,4397
Ohio,Athens County,5,11915,6121,5794
Ohio,Athens County,6,4531,2411,2120
Ohio,Athens County,7,3735,1990,1745
Ohio,Athens County,8,3610,1803,1807
Ohio,Athens County,9,3095,1613,1482
Ohio,Athens County,10,3331,1666,1665
Ohio,Athens County,11,3360,1668,1692
Ohio,Athens County,12,3685,1827,1858
Ohio,Athens County,13,3654,1793,1861
Ohio,Athens County,14,3166,1529,1637
Ohio,Athens County,15,2194,1034,1160
Ohio,Athens County,16,1471,664,807
Ohio,Athens County,17,952,379,573
Ohio,Athens County,18,888,262,626
Ohio,Auglaize County,0,45804,22885,22919
Ohio,Auglaize County,1,2926,1497,1429
Ohio,Auglaize County,2,3032,1520,1512
Ohio,Auglaize County,3,3164,1653,1511
Ohio,Auglaize County,4,2936,1522,1414
Ohio,Auglaize County,5,2595,1389,1206
Ohio,Auglaize County,6,2709,1378,1331
Ohio,Auglaize County,7,2522,1274,1248
Ohio,Auglaize County,8,2675,1337,1338
Ohio,Auglaize County,9,2532,1307,1225
Ohio,Auglaize County,10,2767,1393,1374
Ohio,Auglaize County,11,2994,1484,1510
Ohio,Auglaize County,12,3329,1706,1623
Ohio,Auglaize County,13,3197,1600,1597
Ohio,Auglaize County,14,2700,1347,1353
Ohio,Auglaize County,15,1994,930,1064
Ohio,Auglaize County,16,1421,653,768
Ohio,Auglaize County,17,1105,480,625
Ohio,Auglaize County,18,1206,415,791
Ohio,Belmont County,0,67505,34507,32998
Ohio,Belmont County,1,3242,1625,1617
Ohio,Belmont County,2,3579,1872,1707
Ohio,Belmont County,3,3627,1831,1796
Ohio,Belmont County,4,3544,1917,1627
Ohio,Belmont County,5,3808,2271,1537
Ohio,Belmont County,6,4463,2565,1898
Ohio,Belmont County,7,4071,2306,1765
Ohio,Belmont County,8,4052,2169,1883
Ohio,Belmont County,9,3831,2037,1794
Ohio,Belmont County,10,4289,2275,2014
Ohio,Belmont County,11,4352,2190,2162
Ohio,Belmont County,12,5220,2575,2645
Ohio,Belmont County,13,5355,2621,2734
Ohio,Belmont County,14,4639,2269,2370
Ohio,Belmont County,15,3411,1648,1763
Ohio,Belmont County,16,2312,1017,1295
Ohio,Belmont County,17,1736,674,1062
Ohio,Belmont County,18,1974,645,1329
Ohio,Brown County,0,43602,21616,21986
Ohio,Brown County,1,2506,1267,1239
Ohio,Brown County,2,2710,1378,1332
Ohio,Brown County,3,2927,1476,1451
Ohio,Brown County,4,2727,1387,1340
Ohio,Brown County,5,2319,1136,1183
Ohio,Brown County,6,2583,1319,1264
Ohio,Brown County,7,2355,1207,1148
Ohio,Brown County,8,2570,1240,1330
Ohio,Brown County,9,2579,1340,1239
Ohio,Brown County,10,2959,1470,1489
Ohio,Brown County,11,2961,1493,1468
Ohio,Brown County,12,3368,1650,1718
Ohio,Brown County,13,3176,1556,1620
Ohio,Brown County,14,2478,1213,1265
Ohio,Brown County,15,2025,988,1037
Ohio,Brown County,16,1482,691,791
Ohio,Brown County,17,1002,457,545
Ohio,Brown County,18,875,348,527
Ohio,Butler County,0,382378,187579,194799
Ohio,Butler County,1,23019,11725,11294
Ohio,Butler County,2,24982,12850,12132
Ohio,Butler County,3,25889,13257,12632
Ohio,Butler County,4,29667,14701,14966
Ohio,Butler County,5,32945,16628,16317
Ohio,Butler County,6,22961,11432,11529
Ohio,Butler County,7,22400,11144,11256
Ohio,Butler County,8,24129,11957,12172
Ohio,Butler County,9,22001,10821,11180
Ohio,Butler County,10,24016,11843,12173
Ohio,Butler County,11,24416,12135,12281
Ohio,Butler County,12,25878,12607,13271
Ohio,Butler County,13,23899,11511,12388
Ohio,Butler County,14,19084,8978,10106
Ohio,Butler County,15,14184,6691,7493
Ohio,Butler County,16,9584,4204,5380
Ohio,Butler County,17,6623,2718,3905
Ohio,Butler County,18,6701,2377,4324
Ohio,Carroll County,0,27081,13557,13524
Ohio,Carroll County,1,1375,720,655
Ohio,Carroll County,2,1470,753,717
Ohio,Carroll County,3,1728,938,790
Ohio,Carroll County,4,1682,844,838
Ohio,Carroll County,5,1343,685,658
Ohio,Carroll County,6,1419,734,685
Ohio,Carroll County,7,1381,700,681
Ohio,Carroll County,8,1431,736,695
Ohio,Carroll County,9,1518,743,775
Ohio,Carroll County,10,1745,893,852
Ohio,Carroll County,11,1838,941,897
Ohio,Carroll County,12,2252,1119,1133
Ohio,Carroll County,13,2179,1093,1086
Ohio,Carroll County,14,1820,898,922
Ohio,Carroll County,15,1476,722,754
Ohio,Carroll County,16,1066,493,573
Ohio,Carroll County,17,666,306,360
Ohio,Carroll County,18,692,239,453
Ohio,Champaign County,0,38754,19307,19447
Ohio,Champaign County,1,2051,1052,999
Ohio,Champaign County,2,2301,1188,1113
Ohio,Champaign County,3,2600,1317,1283
Ohio,Champaign County,4,2567,1343,1224
Ohio,Champaign County,5,2321,1232,1089
Ohio,Champaign County,6,2366,1193,1173
Ohio,Champaign County,7,2109,1077,1032
Ohio,Champaign County,8,2128,1060,1068
Ohio,Champaign County,9,2207,1104,1103
Ohio,Champaign County,10,2654,1343,1311
Ohio,Champaign County,11,2781,1418,1363
Ohio,Champaign County,12,2897,1425,1472
Ohio,Champaign County,13,2739,1364,1375
Ohio,Champaign County,14,2201,1052,1149
Ohio,Champaign County,15,1852,864,988
Ohio,Champaign County,16,1331,615,716
Ohio,Champaign County,17,883,383,500
Ohio,Champaign County,18,766,277,489
Ohio,Clark County,0,134585,65152,69433
Ohio,Clark County,1,7930,3990,3940
Ohio,Clark County,2,8161,4232,3929
Ohio,Clark County,3,8730,4519,4211
Ohio,Clark County,4,9157,4584,4573
Ohio,Clark County,5,8411,4127,4284
Ohio,Clark County,6,8130,3995,4135
Ohio,Clark County,7,7615,3711,3904
Ohio,Clark County,8,7388,3545,3843
Ohio,Clark County,9,7165,3463,3702
Ohio,Clark County,10,8342,4115,4227
Ohio,Clark County,11,8742,4340,4402
Ohio,Clark County,12,9476,4573,4903
Ohio,Clark County,13,9216,4420,4796
Ohio,Clark County,14,8451,3937,4514
Ohio,Clark County,15,6469,2982,3487
Ohio,Clark County,16,4741,2123,2618
Ohio,Clark County,17,3115,1272,1843
Ohio,Clark County,18,3346,1224,2122
Ohio,Clermont County,0,205466,101344,104122
Ohio,Clermont County,1,11805,6027,5778
Ohio,Clermont County,2,12963,6591,6372
Ohio,Clermont County,3,14011,7194,6817
Ohio,Clermont County,4,12893,6771,6122
Ohio,Clermont County,5,11417,5741,5676
Ohio,Clermont County,6,13092,6643,6449
Ohio,Clermont County,7,12614,6402,6212
Ohio,Clermont County,8,13157,6700,6457
Ohio,Clermont County,9,12379,6054,6325
Ohio,Clermont County,10,13527,6640,6887
Ohio,Clermont County,11,14135,7017,7118
Ohio,Clermont County,12,15414,7508,7906
Ohio,Clermont County,13,14526,6936,7590
Ohio,Clermont County,14,11536,5517,6019
Ohio,Clermont County,15,8757,4096,4661
Ohio,Clermont County,16,5979,2722,3257
Ohio,Clermont County,17,3624,1535,2089
Ohio,Clermont County,18,3637,1250,2387
Ohio,Clinton County,0,42057,20748,21309
Ohio,Clinton County,1,2516,1296,1220
Ohio,Clinton County,2,2631,1364,1267
Ohio,Clinton County,3,2833,1500,1333
Ohio,Clinton County,4,2902,1435,1467
Ohio,Clinton County,5,2809,1432,1377
Ohio,Clinton County,6,2478,1271,1207
Ohio,Clinton County,7,2355,1172,1183
Ohio,Clinton County,8,2542,1249,1293
Ohio,Clinton County,9,2388,1174,1214
Ohio,Clinton County,10,2630,1288,1342
Ohio,Clinton County,11,2765,1412,1353
Ohio,Clinton County,12,3009,1453,1556
Ohio,Clinton County,13,3023,1482,1541
Ohio,Clinton County,14,2388,1136,1252
Ohio,Clinton County,15,1833,883,950
Ohio,Clinton County,16,1268,567,701
Ohio,Clinton County,17,834,337,497
Ohio,Clinton County,18,853,297,556
Ohio,Columbiana County,0,102665,51934,50731
Ohio,Columbiana County,1,5280,2705,2575
Ohio,Columbiana County,2,5817,2981,2836
Ohio,Columbiana County,3,5937,3047,2890
Ohio,Columbiana County,4,5889,3054,2835
Ohio,Columbiana County,5,5404,2823,2581
Ohio,Columbiana County,6,6074,3229,2845
Ohio,Columbiana County,7,5680,3093,2587
Ohio,Columbiana County,8,5997,3318,2679
Ohio,Columbiana County,9,5999,3194,2805
Ohio,Columbiana County,10,6592,3464,3128
Ohio,Columbiana County,11,6877,3512,3365
Ohio,Columbiana County,12,7968,4012,3956
Ohio,Columbiana County,13,8101,3977,4124
Ohio,Columbiana County,14,6904,3440,3464
Ohio,Columbiana County,15,5231,2500,2731
Ohio,Columbiana County,16,3759,1654,2105
Ohio,Columbiana County,17,2492,1028,1464
Ohio,Columbiana County,18,2664,903,1761
Ohio,Coshocton County,0,36629,18159,18470
Ohio,Coshocton County,1,2363,1272,1091
Ohio,Coshocton County,2,2381,1229,1152
Ohio,Coshocton County,3,2434,1255,1179
Ohio,Coshocton County,4,2251,1194,1057
Ohio,Coshocton County,5,1924,963,961
Ohio,Coshocton County,6,2184,1083,1101
Ohio,Coshocton County,7,1988,987,1001
Ohio,Coshocton County,8,2196,1107,1089
Ohio,Coshocton County,9,1895,941,954
Ohio,Coshocton County,10,2248,1114,1134
Ohio,Coshocton County,11,2387,1213,1174
Ohio,Coshocton County,12,2600,1294,1306
Ohio,Coshocton County,13,2647,1289,1358
Ohio,Coshocton County,14,2247,1105,1142
Ohio,Coshocton County,15,1750,844,906
Ohio,Coshocton County,16,1315,562,753
Ohio,Coshocton County,17,963,412,551
Ohio,Coshocton County,18,856,295,561
Ohio,Crawford County,0,41550,20314,21236
Ohio,Crawford County,1,2361,1193,1168
Ohio,Crawford County,2,2465,1256,1209
Ohio,Crawford County,3,2561,1317,1244
Ohio,Crawford County,4,2438,1245,1193
Ohio,Crawford County,5,2305,1190,1115
Ohio,Crawford County,6,2472,1255,1217
Ohio,Crawford County,7,2140,1057,1083
Ohio,Crawford County,8,2269,1084,1185
Ohio,Crawford County,9,2451,1197,1254
Ohio,Crawford County,10,2688,1368,1320
Ohio,Crawford County,11,2692,1385,1307
Ohio,Crawford County,12,3014,1482,1532
Ohio,Crawford County,13,2972,1460,1512
Ohio,Crawford County,14,2703,1270,1433
Ohio,Crawford County,15,2110,962,1148
Ohio,Crawford County,16,1642,726,916
Ohio,Crawford County,17,1146,470,676
Ohio,Crawford County,18,1121,397,724
Ohio,Cuyahoga County,0,1243857,593444,650413
Ohio,Cuyahoga County,1,71339,36695,34644
Ohio,Cuyahoga County,2,69653,35692,33961
Ohio,Cuyahoga County,3,71981,36556,35425
Ohio,Cuyahoga County,4,74415,37765,36650
Ohio,Cuyahoga County,5,79161,39297,39864
Ohio,Cuyahoga County,6,93415,45686,47729
Ohio,Cuyahoga County,7,82700,40370,42330
Ohio,Cuyahoga County,8,75859,36723,39136
Ohio,Cuyahoga County,9,67236,32254,34982
Ohio,Cuyahoga County,10,74768,35654,39114
Ohio,Cuyahoga County,11,79454,37692,41762
Ohio,Cuyahoga County,12,90163,42769,47394
Ohio,Cuyahoga County,13,87730,41293,46437
Ohio,Cuyahoga County,14,72197,33421,38776
Ohio,Cuyahoga County,15,53250,23617,29633
Ohio,Cuyahoga County,16,38769,16056,22713
Ohio,Cuyahoga County,17,27863,10809,17054
Ohio,Cuyahoga County,18,33904,11095,22809
Ohio,Darke County,0,51323,25478,25845
Ohio,Darke County,1,3144,1658,1486
Ohio,Darke County,2,3260,1648,1612
Ohio,Darke County,3,3588,1838,1750
Ohio,Darke County,4,3307,1724,1583
Ohio,Darke County,5,2796,1477,1319
Ohio,Darke County,6,2848,1436,1412
Ohio,Darke County,7,2621,1346,1275
Ohio,Darke County,8,2927,1464,1463
Ohio,Darke County,9,2828,1447,1381
Ohio,Darke County,10,3143,1591,1552
Ohio,Darke County,11,3453,1698,1755
Ohio,Darke County,12,3745,1858,1887
Ohio,Darke County,13,3585,1791,1794
Ohio,Darke County,14,3042,1457,1585
Ohio,Darke County,15,2431,1123,1308
Ohio,Darke County,16,2000,908,1092
Ohio,Darke County,17,1267,559,708
Ohio,Darke County,18,1338,455,883
Ohio,Defiance County,0,38165,18932,19233
Ohio,Defiance County,1,2174,1112,1062
Ohio,Defiance County,2,2384,1197,1187
Ohio,Defiance County,3,2554,1330,1224
Ohio,Defiance County,4,2659,1373,1286
Ohio,Defiance County,5,2343,1228,1115
Ohio,Defiance County,6,2297,1195,1102
Ohio,Defiance County,7,2218,1135,1083
Ohio,Defiance County,8,2370,1153,1217
Ohio,Defiance County,9,2125,1032,1093
Ohio,Defiance County,10,2337,1178,1159
Ohio,Defiance County,11,2221,1127,1094
Ohio,Defiance County,12,2602,1241,1361
Ohio,Defiance County,13,2781,1392,1389
Ohio,Defiance County,14,2270,1124,1146
Ohio,Defiance County,15,1785,884,901
Ohio,Defiance County,16,1313,559,754
Ohio,Defiance County,17,874,390,484
Ohio,Defiance County,18,858,282,576
Ohio,Delaware County,0,204826,101563,103263
Ohio,Delaware County,1,12440,6291,6149
Ohio,Delaware County,2,14965,7681,7284
Ohio,Delaware County,3,16538,8490,8048
Ohio,Delaware County,4,15161,7770,7391
Ohio,Delaware County,5,10766,5560,5206
Ohio,Delaware County,6,8496,4139,4357
Ohio,Delaware County,7,11582,5525,6057
Ohio,Delaware County,8,15243,7504,7739
Ohio,Delaware County,9,15628,7837,7791
Ohio,Delaware County,10,16808,8499,8309
Ohio,Delaware County,11,14371,7200,7171
Ohio,Delaware County,12,13210,6619,6591
Ohio,Delaware County,13,11556,5568,5988
Ohio,Delaware County,14,9915,4826,5089
Ohio,Delaware County,15,7521,3544,3977
Ohio,Delaware County,16,4738,2137,2601
Ohio,Delaware County,17,3000,1285,1715
Ohio,Delaware County,18,2888,1088,1800
Ohio,Erie County,0,74615,36441,38174
Ohio,Erie County,1,3940,1975,1965
Ohio,Erie County,2,3993,2053,1940
Ohio,Erie County,3,4340,2181,2159
Ohio,Erie County,4,4288,2192,2096
Ohio,Erie County,5,4362,2215,2147
Ohio,Erie County,6,4529,2303,2226
Ohio,Erie County,7,4035,2009,2026
Ohio,Erie County,8,4026,1963,2063
Ohio,Erie County,9,3801,1881,1920
Ohio,Erie County,10,4525,2184,2341
Ohio,Erie County,11,4881,2382,2499
Ohio,Erie County,12,5662,2714,2948
Ohio,Erie County,13,5893,2835,3058
Ohio,Erie County,14,5089,2478,2611
Ohio,Erie County,15,4209,1975,2234
Ohio,Erie County,16,2936,1364,1572
Ohio,Erie County,17,1973,882,1091
Ohio,Erie County,18,2133,855,1278
Ohio,Fairfield County,0,155782,77509,78273
Ohio,Fairfield County,1,9272,4731,4541
Ohio,Fairfield County,2,10198,5290,4908
Ohio,Fairfield County,3,11026,5676,5350
Ohio,Fairfield County,4,10569,5463,5106
Ohio,Fairfield County,5,9283,5061,4222
Ohio,Fairfield County,6,9127,4761,4366
Ohio,Fairfield County,7,9342,4640,4702
Ohio,Fairfield County,8,10215,4953,5262
Ohio,Fairfield County,9,9872,4914,4958
Ohio,Fairfield County,10,10875,5480,5395
Ohio,Fairfield County,11,10743,5322,5421
Ohio,Fairfield County,12,10971,5431,5540
Ohio,Fairfield County,13,9654,4660,4994
Ohio,Fairfield County,14,8092,3864,4228
Ohio,Fairfield County,15,6464,2995,3469
Ohio,Fairfield County,16,4493,1996,2497
Ohio,Fairfield County,17,2895,1292,1603
Ohio,Fairfield County,18,2691,980,1711
Ohio,Fayette County,0,28666,14095,14571
Ohio,Fayette County,1,1704,866,838
Ohio,Fayette County,2,1886,939,947
Ohio,Fayette County,3,2000,1040,960
Ohio,Fayette County,4,1720,902,818
Ohio,Fayette County,5,1591,826,765
Ohio,Fayette County,6,1797,935,862
Ohio,Fayette County,7,1652,815,837
Ohio,Fayette County,8,1706,840,866
Ohio,Fayette County,9,1700,819,881
Ohio,Fayette County,10,1960,970,990
Ohio,Fayette County,11,1859,928,931
Ohio,Fayette County,12,2078,1040,1038
Ohio,Fayette County,13,1922,926,996
Ohio,Fayette County,14,1699,776,923
Ohio,Fayette County,15,1292,614,678
Ohio,Fayette County,16,998,428,570
Ohio,Fayette County,17,614,271,343
Ohio,Fayette County,18,488,160,328
Ohio,Franklin County,0,1310300,640086,670214
Ohio,Franklin County,1,92798,47294,45504
Ohio,Franklin County,2,85463,43603,41860
Ohio,Franklin County,3,80364,40856,39508
Ohio,Franklin County,4,83395,42257,41138
Ohio,Franklin County,5,91154,44838,46316
Ohio,Franklin County,6,126901,62993,63908
Ohio,Franklin County,7,113177,56902,56275
Ohio,Franklin County,8,95313,47460,47853
Ohio,Franklin County,9,80020,39797,40223
Ohio,Franklin County,10,79775,39336,40439
Ohio,Franklin County,11,75642,37314,38328
Ohio,Franklin County,12,78394,37636,40758
Ohio,Franklin County,13,70513,32933,37580
Ohio,Franklin County,14,56155,25428,30727
Ohio,Franklin County,15,39476,17333,22143
Ohio,Franklin County,16,26330,11038,15292
Ohio,Franklin County,17,17260,6771,10489
Ohio,Franklin County,18,18170,6297,11873
Ohio,Fulton County,0,42276,21003,21273
Ohio,Fulton County,1,2537,1336,1201
Ohio,Fulton County,2,2688,1424,1264
Ohio,Fulton County,3,2915,1499,1416
Ohio,Fulton County,4,2798,1482,1316
Ohio,Fulton County,5,2517,1266,1251
Ohio,Fulton County,6,2423,1246,1177
Ohio,Fulton County,7,2292,1147,1145
Ohio,Fulton County,8,2549,1259,1290
Ohio,Fulton County,9,2394,1204,1190
Ohio,Fulton County,10,2684,1335,1349
Ohio,Fulton County,11,2759,1351,1408
Ohio,Fulton County,12,3130,1541,1589
Ohio,Fulton County,13,3079,1545,1534
Ohio,Fulton County,14,2552,1258,1294
Ohio,Fulton County,15,1787,832,955
Ohio,Fulton County,16,1300,580,720
Ohio,Fulton County,17,865,365,500
Ohio,Fulton County,18,1007,333,674
Ohio,Gallia County,0,29979,14839,15140
Ohio,Gallia County,1,1847,945,902
Ohio,Gallia County,2,1862,985,877
Ohio,Gallia County,3,1917,997,920
Ohio,Gallia County,4,1908,1003,905
Ohio,Gallia County,5,1838,991,847
Ohio,Gallia County,6,1736,864,872
Ohio,Gallia County,7,1687,869,818
Ohio,Gallia County,8,1694,844,850
Ohio,Gallia County,9,1682,809,873
Ohio,Gallia County,10,1912,962,950
Ohio,Gallia County,11,1840,905,935
Ohio,Gallia County,12,2189,1061,1128
Ohio,Gallia County,13,2146,1043,1103
Ohio,Gallia County,14,1834,905,929
Ohio,Gallia County,15,1369,615,754
Ohio,Gallia County,16,1133,514,619
Ohio,Gallia County,17,732,324,408
Ohio,Gallia County,18,653,203,450
Ohio,Geauga County,0,94031,46668,47363
Ohio,Geauga County,1,4962,2518,2444
Ohio,Geauga County,2,5530,2789,2741
Ohio,Geauga County,3,6557,3371,3186
Ohio,Geauga County,4,6676,3447,3229
Ohio,Geauga County,5,5581,2948,2633
Ohio,Geauga County,6,4313,2262,2051
Ohio,Geauga County,7,3915,1932,1983
Ohio,Geauga County,8,4824,2390,2434
Ohio,Geauga County,9,4988,2514,2474
Ohio,Geauga County,10,5932,2917,3015
Ohio,Geauga County,11,6961,3452,3509
Ohio,Geauga County,12,7389,3603,3786
Ohio,Geauga County,13,7244,3691,3553
Ohio,Geauga County,14,6139,3036,3103
Ohio,Geauga County,15,4884,2352,2532
Ohio,Geauga County,16,3519,1618,1901
Ohio,Geauga County,17,2189,969,1220
Ohio,Geauga County,18,2428,859,1569
Ohio,Greene County,0,167995,82804,85191
Ohio,Greene County,1,9512,4913,4599
Ohio,Greene County,2,9471,4910,4561
Ohio,Greene County,3,9679,4956,4723
Ohio,Greene County,4,12199,6088,6111
Ohio,Greene County,5,13876,6981,6895
Ohio,Greene County,6,11744,6033,5711
Ohio,Greene County,7,10635,5437,5198
Ohio,Greene County,8,10330,5246,5084
Ohio,Greene County,9,8744,4392,4352
Ohio,Greene County,10,9598,4683,4915
Ohio,Greene County,11,10429,5044,5385
Ohio,Greene County,12,11694,5758,5936
Ohio,Greene County,13,11255,5323,5932
Ohio,Greene County,14,9440,4537,4903
Ohio,Greene County,15,7297,3511,3786
Ohio,Greene County,16,5039,2254,2785
Ohio,Greene County,17,3456,1455,2001
Ohio,Greene County,18,3597,1283,2314
Ohio,Guernsey County,0,39022,19472,19550
Ohio,Guernsey County,1,2284,1184,1100
Ohio,Guernsey County,2,2353,1217,1136
Ohio,Guernsey County,3,2492,1294,1198
Ohio,Guernsey County,4,2335,1218,1117
Ohio,Guernsey County,5,2206,1155,1051
Ohio,Guernsey County,6,2454,1241,1213
Ohio,Guernsey County,7,2133,1122,1011
Ohio,Guernsey County,8,2218,1112,1106
Ohio,Guernsey County,9,2054,1026,1028
Ohio,Guernsey County,10,2506,1249,1257
Ohio,Guernsey County,11,2610,1348,1262
Ohio,Guernsey County,12,2906,1414,1492
Ohio,Guernsey County,13,2846,1343,1503
Ohio,Guernsey County,14,2501,1241,1260
Ohio,Guernsey County,15,1915,922,993
Ohio,Guernsey County,16,1395,648,747
Ohio,Guernsey County,17,959,417,542
Ohio,Guernsey County,18,855,321,534
Ohio,Hamilton County,0,816684,394506,422178
Ohio,Hamilton County,1,53083,27269,25814
Ohio,Hamilton County,2,52225,26560,25665
Ohio,Hamilton County,3,51958,26188,25770
Ohio,Hamilton County,4,53338,27391,25947
Ohio,Hamilton County,5,52829,26445,26384
Ohio,Hamilton County,6,65620,32649,32971
Ohio,Hamilton County,7,59312,28929,30383
Ohio,Hamilton County,8,52637,25675,26962
Ohio,Hamilton County,9,44527,21664,22863
Ohio,Hamilton County,10,47386,22971,24415
Ohio,Hamilton County,11,50168,24089,26079
Ohio,Hamilton County,12,55178,26332,28846
Ohio,Hamilton County,13,53172,25045,28127
Ohio,Hamilton County,14,42134,19470,22664
Ohio,Hamilton County,15,29841,13420,16421
Ohio,Hamilton County,16,20888,8819,12069
Ohio,Hamilton County,17,15026,5853,9173
Ohio,Hamilton County,18,17362,5737,11625
Ohio,Hancock County,0,75930,37555,38375
Ohio,Hancock County,1,4542,2326,2216
Ohio,Hancock County,2,4631,2293,2338
Ohio,Hancock County,3,4733,2422,2311
Ohio,Hancock County,4,5066,2542,2524
Ohio,Hancock County,5,4740,2426,2314
Ohio,Hancock County,6,5439,2783,2656
Ohio,Hancock County,7,4952,2573,2379
Ohio,Hancock County,8,4591,2365,2226
Ohio,Hancock County,9,4245,2081,2164
Ohio,Hancock County,10,4621,2369,2252
Ohio,Hancock County,11,4806,2461,2345
Ohio,Hancock County,12,5438,2662,2776
Ohio,Hancock County,13,5014,2467,2547
Ohio,Hancock County,14,4137,1953,2184
Ohio,Hancock County,15,3292,1563,1729
Ohio,Hancock County,16,2311,1002,1309
Ohio,Hancock County,17,1656,689,967
Ohio,Hancock County,18,1716,578,1138
Ohio,Hardin County,0,31480,15674,15806
Ohio,Hardin County,1,1947,993,954
Ohio,Hardin County,2,2005,1063,942
Ohio,Hardin County,3,2057,1093,964
Ohio,Hardin County,4,2652,1339,1313
Ohio,Hardin County,5,3428,1702,1726
Ohio,Hardin County,6,1687,879,808
Ohio,Hardin County,7,1602,830,772
Ohio,Hardin County,8,1655,794,861
Ohio,Hardin County,9,1714,886,828
Ohio,Hardin County,10,1863,928,935
Ohio,Hardin County,11,1848,923,925
Ohio,Hardin County,12,2036,1017,1019
Ohio,Hardin County,13,1933,967,966
Ohio,Hardin County,14,1635,784,851
Ohio,Hardin County,15,1274,578,696
Ohio,Hardin County,16,936,428,508
Ohio,Hardin County,17,608,257,351
Ohio,Hardin County,18,600,213,387
Ohio,Harrison County,0,15174,7552,7622
Ohio,Harrison County,1,813,435,378
Ohio,Harrison County,2,814,411,403
Ohio,Harrison County,3,932,464,468
Ohio,Harrison County,4,930,496,434
Ohio,Harrison County,5,724,382,342
Ohio,Harrison County,6,849,420,429
Ohio,Harrison County,7,754,375,379
Ohio,Harrison County,8,808,386,422
Ohio,Harrison County,9,781,382,399
Ohio,Harrison County,10,955,497,458
Ohio,Harrison County,11,1061,533,528
Ohio,Harrison County,12,1225,591,634
Ohio,Harrison County,13,1301,665,636
Ohio,Harrison County,14,1070,542,528
Ohio,Harrison County,15,780,374,406
Ohio,Harrison County,16,609,299,310
Ohio,Harrison County,17,374,173,201
Ohio,Harrison County,18,394,127,267
Ohio,Henry County,0,27086,13378,13708
Ohio,Henry County,1,1547,758,789
Ohio,Henry County,2,1755,873,882
Ohio,Henry County,3,1829,936,893
Ohio,Henry County,4,1755,902,853
Ohio,Henry County,5,1477,777,700
Ohio,Henry County,6,1604,819,785
Ohio,Henry County,7,1484,714,770
Ohio,Henry County,8,1623,813,810
Ohio,Henry County,9,1616,808,808
Ohio,Henry County,10,1655,849,806
Ohio,Henry County,11,1720,848,872
Ohio,Henry County,12,1970,978,992
Ohio,Henry County,13,1996,1004,992
Ohio,Henry County,14,1586,778,808
Ohio,Henry County,15,1178,563,615
Ohio,Henry County,16,895,396,499
Ohio,Henry County,17,693,314,379
Ohio,Henry County,18,703,248,455
Ohio,Highland County,0,43058,21138,21920
Ohio,Highland County,1,2743,1362,1381
Ohio,Highland County,2,2721,1403,1318
Ohio,Highland County,3,2939,1456,1483
Ohio,Highland County,4,2807,1437,1370
Ohio,Highland County,5,2257,1173,1084
Ohio,Highland County,6,2610,1295,1315
Ohio,Highland County,7,2333,1176,1157
Ohio,Highland County,8,2542,1247,1295
Ohio,Highland County,9,2493,1245,1248
Ohio,Highland County,10,2833,1412,1421
Ohio,Highland County,11,2850,1422,1428
Ohio,Highland County,12,2972,1440,1532
Ohio,Highland County,13,3003,1457,1546
Ohio,Highland County,14,2560,1218,1342
Ohio,Highland County,15,2018,933,1085
Ohio,Highland County,16,1479,701,778
Ohio,Highland County,17,941,410,531
Ohio,Highland County,18,957,351,606
Ohio,Hocking County,0,28385,14083,14302
Ohio,Hocking County,1,1590,791,799
Ohio,Hocking County,2,1690,869,821
Ohio,Hocking County,3,1771,900,871
Ohio,Hocking County,4,1821,943,878
Ohio,Hocking County,5,1498,769,729
Ohio,Hocking County,6,1706,851,855
Ohio,Hocking County,7,1475,756,719
Ohio,Hocking County,8,1624,797,827
Ohio,Hocking County,9,1675,803,872
Ohio,Hocking County,10,1895,978,917
Ohio,Hocking County,11,1927,955,972
Ohio,Hocking County,12,2184,1063,1121
Ohio,Hocking County,13,2113,1062,1051
Ohio,Hocking County,14,1734,844,890
Ohio,Hocking County,15,1410,683,727
Ohio,Hocking County,16,1063,525,538
Ohio,Hocking County,17,712,299,413
Ohio,Hocking County,18,497,195,302
Ohio,Holmes County,0,43892,21977,21915
Ohio,Holmes County,1,3569,1877,1692
Ohio,Holmes County,2,3758,1927,1831
Ohio,Holmes County,3,3860,1939,1921
Ohio,Holmes County,4,3703,1891,1812
Ohio,Holmes County,5,3095,1593,1502
Ohio,Holmes County,6,3083,1600,1483
Ohio,Holmes County,7,2543,1274,1269
Ohio,Holmes County,8,2397,1203,1194
Ohio,Holmes County,9,2370,1167,1203
Ohio,Holmes County,10,2363,1163,1200
Ohio,Holmes County,11,2291,1164,1127
Ohio,Holmes County,12,2544,1307,1237
Ohio,Holmes County,13,2297,1140,1157
Ohio,Holmes County,14,1952,940,1012
Ohio,Holmes County,15,1443,689,754
Ohio,Holmes County,16,1043,495,548
Ohio,Holmes County,17,764,318,446
Ohio,Holmes County,18,817,290,527
Ohio,Huron County,0,58504,28903,29601
Ohio,Huron County,1,3799,1896,1903
Ohio,Huron County,2,3676,1889,1787
Ohio,Huron County,3,4113,2092,2021
Ohio,Huron County,4,3829,1967,1862
Ohio,Huron County,5,3531,1836,1695
Ohio,Huron County,6,3604,1872,1732
Ohio,Huron County,7,3291,1699,1592
Ohio,Huron County,8,3406,1703,1703
Ohio,Huron County,9,3301,1636,1665
Ohio,Huron County,10,3769,1933,1836
Ohio,Huron County,11,3928,1922,2006
Ohio,Huron County,12,4231,2057,2174
Ohio,Huron County,13,3996,1908,2088
Ohio,Huron County,14,3393,1595,1798
Ohio,Huron County,15,2566,1222,1344
Ohio,Huron County,16,1735,780,955
Ohio,Huron County,17,1153,477,676
Ohio,Huron County,18,1183,419,764
Ohio,Jackson County,0,32384,15868,16516
Ohio,Jackson County,1,2080,1040,1040
Ohio,Jackson County,2,2110,1085,1025
Ohio,Jackson County,3,2189,1101,1088
Ohio,Jackson County,4,2005,1091,914
Ohio,Jackson County,5,1739,854,885
Ohio,Jackson County,6,2112,1065,1047
Ohio,Jackson County,7,1965,1008,957
Ohio,Jackson County,8,1980,963,1017
Ohio,Jackson County,9,1939,977,962
Ohio,Jackson County,10,2085,1037,1048
Ohio,Jackson County,11,2122,1048,1074
Ohio,Jackson County,12,2188,1067,1121
Ohio,Jackson County,13,2268,1090,1178
Ohio,Jackson County,14,1942,937,1005
Ohio,Jackson County,15,1476,648,828
Ohio,Jackson County,16,969,421,548
Ohio,Jackson County,17,640,261,379
Ohio,Jackson County,18,575,175,400
Ohio,Jefferson County,0,65767,31955,33812
Ohio,Jefferson County,1,3290,1712,1578
Ohio,Jefferson County,2,3336,1725,1611
Ohio,Jefferson County,3,3706,1885,1821
Ohio,Jefferson County,4,4134,2065,2069
Ohio,Jefferson County,5,4385,2128,2257
Ohio,Jefferson County,6,3873,1895,1978
Ohio,Jefferson County,7,3309,1672,1637
Ohio,Jefferson County,8,3430,1732,1698
Ohio,Jefferson County,9,3406,1648,1758
Ohio,Jefferson County,10,4157,2058,2099
Ohio,Jefferson County,11,4266,2115,2151
Ohio,Jefferson County,12,5015,2419,2596
Ohio,Jefferson County,13,5287,2575,2712
Ohio,Jefferson County,14,4619,2248,2371
Ohio,Jefferson County,15,3476,1645,1831
Ohio,Jefferson County,16,2526,1107,1419
Ohio,Jefferson County,17,1814,756,1058
Ohio,Jefferson County,18,1738,570,1168
Ohio,Knox County,0,61893,30310,31583
Ohio,Knox County,1,3764,1881,1883
Ohio,Knox County,2,3783,1953,1830
Ohio,Knox County,3,4041,2097,1944
Ohio,Knox County,4,4778,2367,2411
Ohio,Knox County,5,4767,2316,2451
Ohio,Knox County,6,3505,1787,1718
Ohio,Knox County,7,3287,1600,1687
Ohio,Knox County,8,3353,1664,1689
Ohio,Knox County,9,3273,1657,1616
Ohio,Knox County,10,3665,1827,1838
Ohio,Knox County,11,3819,1909,1910
Ohio,Knox County,12,4329,2105,2224
Ohio,Knox County,13,4298,2055,2243
Ohio,Knox County,14,3674,1729,1945
Ohio,Knox County,15,2836,1352,1484
Ohio,Knox County,16,2046,951,1095
Ohio,Knox County,17,1306,556,750
Ohio,Knox County,18,1369,504,865
Ohio,Lake County,0,230514,112549,117965
Ohio,Lake County,1,11345,5826,5519
Ohio,Lake County,2,12206,6283,5923
Ohio,Lake County,3,13806,6963,6843
Ohio,Lake County,4,13798,7135,6663
Ohio,Lake County,5,12817,6570,6247
Ohio,Lake County,6,14371,7346,7025
Ohio,Lake County,7,13476,6789,6687
Ohio,Lake County,8,13530,6903,6627
Ohio,Lake County,9,12650,6218,6432
Ohio,Lake County,10,14929,7409,7520
Ohio,Lake County,11,15889,7887,8002
Ohio,Lake County,12,17954,8682,9272
Ohio,Lake County,13,17677,8475,9202
Ohio,Lake County,14,14498,6916,7582
Ohio,Lake County,15,11585,5228,6357
Ohio,Lake County,16,8484,3757,4727
Ohio,Lake County,17,5433,2173,3260
Ohio,Lake County,18,6066,1989,4077
Ohio,Lawrence County,0,59866,29139,30727
Ohio,Lawrence County,1,3300,1732,1568
Ohio,Lawrence County,2,3550,1811,1739
Ohio,Lawrence County,3,3839,1930,1909
Ohio,Lawrence County,4,3505,1850,1655
Ohio,Lawrence County,5,3243,1613,1630
Ohio,Lawrence County,6,3782,1927,1855
Ohio,Lawrence County,7,3417,1687,1730
Ohio,Lawrence County,8,3691,1773,1918
Ohio,Lawrence County,9,3586,1787,1799
Ohio,Lawrence County,10,4093,1983,2110
Ohio,Lawrence County,11,4165,2036,2129
Ohio,Lawrence County,12,4216,2021,2195
Ohio,Lawrence County,13,4166,1943,2223
Ohio,Lawrence County,14,3586,1718,1868
Ohio,Lawrence County,15,2917,1309,1608
Ohio,Lawrence County,16,2201,968,1233
Ohio,Lawrence County,17,1417,605,812
Ohio,Lawrence County,18,1192,446,746
Ohio,Licking County,0,175769,86261,89508
Ohio,Licking County,1,10599,5469,5130
Ohio,Licking County,2,11322,5820,5502
Ohio,Licking County,3,11629,5971,5658
Ohio,Licking County,4,11954,6160,5794
Ohio,Licking County,5,10988,5575,5413
Ohio,Licking County,6,10280,5097,5183
Ohio,Licking County,7,10568,5085,5483
Ohio,Licking County,8,10950,5413,5537
Ohio,Licking County,9,10206,5083,5123
Ohio,Licking County,10,11693,5731,5962
Ohio,Licking County,11,12012,5936,6076
Ohio,Licking County,12,12902,6390,6512
Ohio,Licking County,13,11760,5674,6086
Ohio,Licking County,14,9428,4518,4910
Ohio,Licking County,15,7705,3520,4185
Ohio,Licking County,16,5415,2388,3027
Ohio,Licking County,17,3298,1373,1925
Ohio,Licking County,18,3060,1058,2002
Ohio,Logan County,0,45358,22471,22887
Ohio,Logan County,1,2652,1336,1316
Ohio,Logan County,2,2773,1457,1316
Ohio,Logan County,3,3118,1559,1559
Ohio,Logan County,4,2903,1558,1345
Ohio,Logan County,5,2490,1265,1225
Ohio,Logan County,6,2715,1401,1314
Ohio,Logan County,7,2481,1203,1278
Ohio,Logan County,8,2683,1293,1390
Ohio,Logan County,9,2603,1293,1310
Ohio,Logan County,10,2842,1441,1401
Ohio,Logan County,11,3082,1523,1559
Ohio,Logan County,12,3463,1753,1710
Ohio,Logan County,13,3328,1649,1679
Ohio,Logan County,14,2839,1383,1456
Ohio,Logan County,15,2095,982,1113
Ohio,Logan County,16,1475,643,832
Ohio,Logan County,17,904,406,498
Ohio,Logan County,18,912,326,586
Ohio,Lorain County,0,309461,152269,157192
Ohio,Lorain County,1,17335,8865,8470
Ohio,Lorain County,2,18712,9637,9075
Ohio,Lorain County,3,19636,10039,9597
Ohio,Lorain County,4,20528,10541,9987
Ohio,Lorain County,5,18647,9620,9027
Ohio,Lorain County,6,17847,9221,8626
Ohio,Lorain County,7,17210,8728,8482
Ohio,Lorain County,8,18665,9231,9434
Ohio,Lorain County,9,18395,9185,9210
Ohio,Lorain County,10,20412,10171,10241
Ohio,Lorain County,11,21013,10512,10501
Ohio,Lorain County,12,22709,11014,11695
Ohio,Lorain County,13,21723,10382,11341
Ohio,Lorain County,14,18593,8851,9742
Ohio,Lorain County,15,14294,6674,7620
Ohio,Lorain County,16,9918,4385,5533
Ohio,Lorain County,17,6680,2746,3934
Ohio,Lorain County,18,7144,2467,4677
Ohio,Lucas County,0,429899,208402,221497
Ohio,Lucas County,1,27386,14093,13293
Ohio,Lucas County,2,27207,13834,13373
Ohio,Lucas County,3,27735,14092,13643
Ohio,Lucas County,4,26989,13860,13129
Ohio,Lucas County,5,27264,13702,13562
Ohio,Lucas County,6,33088,16548,16540
Ohio,Lucas County,7,28350,13930,14420
Ohio,Lucas County,8,25877,12707,13170
Ohio,Lucas County,9,23657,11364,12293
Ohio,Lucas County,10,26478,12846,13632
Ohio,Lucas County,11,26605,12817,13788
Ohio,Lucas County,12,30112,14436,15676
Ohio,Lucas County,13,29104,13880,15224
Ohio,Lucas County,14,23782,11147,12635
Ohio,Lucas County,15,17299,7895,9404
Ohio,Lucas County,16,11820,5046,6774
Ohio,Lucas County,17,8013,3191,4822
Ohio,Lucas County,18,9133,3014,6119
Ohio,Madison County,0,44413,24092,20321
Ohio,Madison County,1,2250,1159,1091
Ohio,Madison County,2,2520,1248,1272
Ohio,Madison County,3,2693,1339,1354
Ohio,Madison County,4,2598,1418,1180
Ohio,Madison County,5,2599,1544,1055
Ohio,Madison County,6,2957,1817,1140
Ohio,Madison County,7,3080,1877,1203
Ohio,Madison County,8,3212,1904,1308
Ohio,Madison County,9,3119,1875,1244
Ohio,Madison County,10,3285,1928,1357
Ohio,Madison County,11,3259,1739,1520
Ohio,Madison County,12,3180,1682,1498
Ohio,Madison County,13,2798,1440,1358
Ohio,Madison County,14,2192,1044,1148
Ohio,Madison County,15,1789,875,914
Ohio,Madison County,16,1287,575,712
Ohio,Madison County,17,879,368,511
Ohio,Madison County,18,716,260,456
Ohio,Mahoning County,0,229642,112452,117190
Ohio,Mahoning County,1,12161,6106,6055
Ohio,Mahoning County,2,12242,6349,5893
Ohio,Mahoning County,3,13164,6801,6363
Ohio,Mahoning County,4,13780,7152,6628
Ohio,Mahoning County,5,14010,7189,6821
Ohio,Mahoning County,6,14814,7852,6962
Ohio,Mahoning County,7,12646,6567,6079
Ohio,Mahoning County,8,12986,6543,6443
Ohio,Mahoning County,9,12602,6455,6147
Ohio,Mahoning County,10,13816,6873,6943
Ohio,Mahoning County,11,14504,7228,7276
Ohio,Mahoning County,12,17014,8154,8860
Ohio,Mahoning County,13,17758,8371,9387
Ohio,Mahoning County,14,15421,7356,8065
Ohio,Mahoning County,15,11174,5178,5996
Ohio,Mahoning County,16,8264,3519,4745
Ohio,Mahoning County,17,5929,2384,3545
Ohio,Mahoning County,18,7357,2375,4982
Ohio,Marion County,0,65256,34658,30598
Ohio,Marion County,1,3738,1872,1866
Ohio,Marion County,2,3892,2006,1886
Ohio,Marion County,3,3659,1933,1726
Ohio,Marion County,4,3688,1961,1727
Ohio,Marion County,5,4011,2328,1683
Ohio,Marion County,6,4602,2614,1988
Ohio,Marion County,7,4144,2398,1746
Ohio,Marion County,8,4067,2332,1735
Ohio,Marion County,9,3990,2291,1699
Ohio,Marion County,10,4351,2513,1838
Ohio,Marion County,11,4421,2468,1953
Ohio,Marion County,12,4646,2472,2174
Ohio,Marion County,13,4469,2267,2202
Ohio,Marion County,14,3778,1854,1924
Ohio,Marion County,15,2970,1377,1593
Ohio,Marion County,16,1992,879,1113
Ohio,Marion County,17,1379,546,833
Ohio,Marion County,18,1459,547,912
Ohio,Medina County,0,179146,88684,90462
Ohio,Medina County,1,9585,4964,4621
Ohio,Medina County,2,10621,5367,5254
Ohio,Medina County,3,12075,6202,5873
Ohio,Medina County,4,11697,6112,5585
Ohio,Medina County,5,9471,4847,4624
Ohio,Medina County,6,9392,4776,4616
Ohio,Medina County,7,10012,4989,5023
Ohio,Medina County,8,11232,5617,5615
Ohio,Medina County,9,10986,5473,5513
Ohio,Medina County,10,12617,6263,6354
Ohio,Medina County,11,13398,6599,6799
Ohio,Medina County,12,13515,6674,6841
Ohio,Medina County,13,12555,6147,6408
Ohio,Medina County,14,10657,5096,5561
Ohio,Medina County,15,8447,4037,4410
Ohio,Medina County,16,5769,2673,3096
Ohio,Medina County,17,3534,1580,1954
Ohio,Medina County,18,3583,1268,2315
Ohio,Meigs County,0,23106,11391,11715
Ohio,Meigs County,1,1215,636,579
Ohio,Meigs County,2,1323,680,643
Ohio,Meigs County,3,1442,703,739
Ohio,Meigs County,4,1429,734,695
Ohio,Meigs County,5,1087,550,537
Ohio,Meigs County,6,1313,663,650
Ohio,Meigs County,7,1236,628,608
Ohio,Meigs County,8,1432,708,724
Ohio,Meigs County,9,1356,671,685
Ohio,Meigs County,10,1528,751,777
Ohio,Meigs County,11,1603,820,783
Ohio,Meigs County,12,1782,865,917
Ohio,Meigs County,13,1770,876,894
Ohio,Meigs County,14,1552,763,789
Ohio,Meigs County,15,1121,539,582
Ohio,Meigs County,16,817,397,420
Ohio,Meigs County,17,571,225,346
Ohio,Meigs County,18,529,182,347
Ohio,Mercer County,0,40959,20660,20299
Ohio,Mercer County,1,3064,1566,1498
Ohio,Mercer County,2,2826,1463,1363
Ohio,Mercer County,3,2928,1500,1428
Ohio,Mercer County,4,2649,1398,1251
Ohio,Mercer County,5,2289,1181,1108
Ohio,Mercer County,6,2499,1326,1173
Ohio,Mercer County,7,2336,1232,1104
Ohio,Mercer County,8,2320,1200,1120
Ohio,Mercer County,9,2131,1119,1012
Ohio,Mercer County,10,2242,1113,1129
Ohio,Mercer County,11,2421,1221,1200
Ohio,Mercer County,12,3001,1514,1487
Ohio,Mercer County,13,2968,1492,1476
Ohio,Mercer County,14,2363,1176,1187
Ohio,Mercer County,15,1735,849,886
Ohio,Mercer County,16,1203,549,654
Ohio,Mercer County,17,904,383,521
Ohio,Mercer County,18,1080,378,702
Ohio,Miami County,0,106222,52324,53898
Ohio,Miami County,1,6394,3258,3136
Ohio,Miami County,2,6621,3379,3242
Ohio,Miami County,3,7002,3631,3371
Ohio,Miami County,4,6541,3316,3225
Ohio,Miami County,5,5490,2855,2635
Ohio,Miami County,6,6371,3186,3185
Ohio,Miami County,7,6360,3227,3133
Ohio,Miami County,8,6711,3391,3320
Ohio,Miami County,9,6098,3043,3055
Ohio,Miami County,10,7036,3477,3559
Ohio,Miami County,11,6921,3535,3386
Ohio,Miami County,12,7638,3697,3941
Ohio,Miami County,13,7266,3504,3762
Ohio,Miami County,14,6250,2924,3326
Ohio,Miami County,15,5214,2449,2765
Ohio,Miami County,16,3636,1616,2020
Ohio,Miami County,17,2457,1022,1435
Ohio,Miami County,18,2216,814,1402
Ohio,Monroe County,0,13790,6933,6857
Ohio,Monroe County,1,696,339,357
Ohio,Monroe County,2,791,425,366
Ohio,Monroe County,3,790,382,408
Ohio,Monroe County,4,784,410,374
Ohio,Monroe County,5,652,355,297
Ohio,Monroe County,6,718,353,365
Ohio,Monroe County,7,727,364,363
Ohio,Monroe County,8,742,381,361
Ohio,Monroe County,9,720,366,354
Ohio,Monroe County,10,885,462,423
Ohio,Monroe County,11,945,496,449
Ohio,Monroe County,12,1048,513,535
Ohio,Monroe County,13,1049,532,517
Ohio,Monroe County,14,1026,502,524
Ohio,Monroe County,15,805,395,410
Ohio,Monroe County,16,630,322,308
Ohio,Monroe County,17,417,216,201
Ohio,Monroe County,18,365,120,245
Ohio,Montgomery County,0,532331,256382,275949
Ohio,Montgomery County,1,32518,16714,15804
Ohio,Montgomery County,2,32326,16318,16008
Ohio,Montgomery County,3,32506,16735,15771
Ohio,Montgomery County,4,34044,17456,16588
Ohio,Montgomery County,5,35044,17759,17285
Ohio,Montgomery County,6,38494,19036,19458
Ohio,Montgomery County,7,34209,16914,17295
Ohio,Montgomery County,8,32409,15640,16769
Ohio,Montgomery County,9,28253,13691,14562
Ohio,Montgomery County,10,31799,15308,16491
Ohio,Montgomery County,11,33253,16083,17170
Ohio,Montgomery County,12,36728,17653,19075
Ohio,Montgomery County,13,35165,16443,18722
Ohio,Montgomery County,14,29925,13715,16210
Ohio,Montgomery County,15,23610,10508,13102
Ohio,Montgomery County,16,16875,7228,9647
Ohio,Montgomery County,17,11857,4671,7186
Ohio,Montgomery County,18,13316,4510,8806
Ohio,Morgan County,0,14604,7284,7320
Ohio,Morgan County,1,748,361,387
Ohio,Morgan County,2,802,404,398
Ohio,Morgan County,3,932,491,441
Ohio,Morgan County,4,892,498,394
Ohio,Morgan County,5,747,399,348
Ohio,Morgan County,6,795,402,393
Ohio,Morgan County,7,767,381,386
Ohio,Morgan County,8,847,436,411
Ohio,Morgan County,9,784,369,415
Ohio,Morgan County,10,929,453,476
Ohio,Morgan County,11,967,491,476
Ohio,Morgan County,12,1174,569,605
Ohio,Morgan County,13,1101,550,551
Ohio,Morgan County,14,1013,519,494
Ohio,Morgan County,15,719,367,352
Ohio,Morgan County,16,573,284,289
Ohio,Morgan County,17,451,193,258
Ohio,Morgan County,18,363,117,246
Ohio,Morrow County,0,35112,17495,17617
Ohio,Morrow County,1,1869,918,951
Ohio,Morrow County,2,2075,1077,998
Ohio,Morrow County,3,2474,1268,1206
Ohio,Morrow County,4,2384,1243,1141
Ohio,Morrow County,5,1706,905,801
Ohio,Morrow County,6,1967,964,1003
Ohio,Morrow County,7,1895,941,954
Ohio,Morrow County,8,2129,1080,1049
Ohio,Morrow County,9,2187,1109,1078
Ohio,Morrow County,10,2509,1264,1245
Ohio,Morrow County,11,2453,1249,1204
Ohio,Morrow County,12,2753,1385,1368
Ohio,Morrow County,13,2656,1293,1363
Ohio,Morrow County,14,2040,1002,1038
Ohio,Morrow County,15,1533,725,808
Ohio,Morrow County,16,1089,513,576
Ohio,Morrow County,17,720,323,397
Ohio,Morrow County,18,673,236,437
Ohio,Muskingum County,0,86183,41821,44362
Ohio,Muskingum County,1,5190,2669,2521
Ohio,Muskingum County,2,5369,2715,2654
Ohio,Muskingum County,3,5506,2786,2720
Ohio,Muskingum County,4,5410,2816,2594
Ohio,Muskingum County,5,5693,2821,2872
Ohio,Muskingum County,6,5589,2785,2804
Ohio,Muskingum County,7,4887,2384,2503
Ohio,Muskingum County,8,5152,2547,2605
Ohio,Muskingum County,9,4836,2352,2484
Ohio,Muskingum County,10,5441,2641,2800
Ohio,Muskingum County,11,5659,2840,2819
Ohio,Muskingum County,12,6089,2930,3159
Ohio,Muskingum County,13,5981,2903,3078
Ohio,Muskingum County,14,4951,2311,2640
Ohio,Muskingum County,15,3780,1682,2098
Ohio,Muskingum County,16,2820,1229,1591
Ohio,Muskingum County,17,1856,738,1118
Ohio,Muskingum County,18,1974,672,1302
Ohio,Noble County,0,14354,8371,5983
Ohio,Noble County,1,680,357,323
Ohio,Noble County,2,750,389,361
Ohio,Noble County,3,755,375,380
Ohio,Noble County,4,667,333,334
Ohio,Noble County,5,619,294,325
Ohio,Noble County,6,675,329,346
Ohio,Noble County,7,633,316,317
Ohio,Noble County,8,639,336,303
Ohio,Noble County,9,532,251,281
Ohio,Noble County,10,733,403,330
Ohio,Noble County,11,912,558,354
Ohio,Noble County,12,1099,699,400
Ohio,Noble County,13,1709,1312,397
Ohio,Noble County,14,1167,788,379
Ohio,Noble County,15,1231,885,346
Ohio,Noble County,16,650,380,270
Ohio,Noble County,17,475,228,247
Ohio,Noble County,18,428,138,290
Ohio,Ottawa County,0,40769,20227,20542
Ohio,Ottawa County,1,1739,882,857
Ohio,Ottawa County,2,2018,1000,1018
Ohio,Ottawa County,3,2302,1123,1179
Ohio,Ottawa County,4,2290,1188,1102
Ohio,Ottawa County,5,1935,1044,891
Ohio,Ottawa County,6,1961,998,963
Ohio,Ottawa County,7,1949,1010,939
Ohio,Ottawa County,8,2089,1036,1053
Ohio,Ottawa County,9,2008,1007,1001
Ohio,Ottawa County,10,2468,1257,1211
Ohio,Ottawa County,11,2720,1338,1382
Ohio,Ottawa County,12,3469,1706,1763
Ohio,Ottawa County,13,3623,1774,1849
Ohio,Ottawa County,14,3296,1647,1649
Ohio,Ottawa County,15,2627,1305,1322
Ohio,Ottawa County,16,1923,931,992
Ohio,Ottawa County,17,1155,535,620
Ohio,Ottawa County,18,1197,446,751
Ohio,Paulding County,0,18760,9357,9403
Ohio,Paulding County,1,1082,550,532
Ohio,Paulding County,2,1130,575,555
Ohio,Paulding County,3,1391,714,677
Ohio,Paulding County,4,1208,619,589
Ohio,Paulding County,5,1016,507,509
Ohio,Paulding County,6,1033,542,491
Ohio,Paulding County,7,1055,531,524
Ohio,Paulding County,8,1106,567,539
Ohio,Paulding County,9,1062,525,537
Ohio,Paulding County,10,1161,583,578
Ohio,Paulding County,11,1257,647,610
Ohio,Paulding County,12,1435,720,715
Ohio,Paulding County,13,1339,687,652
Ohio,Paulding County,14,1166,591,575
Ohio,Paulding County,15,872,386,486
Ohio,Paulding County,16,646,306,340
Ohio,Paulding County,17,397,176,221
Ohio,Paulding County,18,404,131,273
Ohio,Perry County,0,36033,18051,17982
Ohio,Perry County,1,2177,1142,1035
Ohio,Perry County,2,2296,1191,1105
Ohio,Perry County,3,2497,1241,1256
Ohio,Perry County,4,2261,1180,1081
Ohio,Perry County,5,1953,1033,920
Ohio,Perry County,6,2261,1130,1131
Ohio,Perry County,7,2076,1055,1021
Ohio,Perry County,8,2196,1095,1101
Ohio,Perry County,9,2118,1053,1065
Ohio,Perry County,10,2421,1220,1201
Ohio,Perry County,11,2567,1306,1261
Ohio,Perry County,12,2636,1280,1356
Ohio,Perry County,13,2632,1404,1228
Ohio,Perry County,14,2061,1019,1042
Ohio,Perry County,15,1621,761,860
Ohio,Perry County,16,1023,470,553
Ohio,Perry County,17,669,294,375
Ohio,Perry County,18,568,177,391
Ohio,Pickaway County,0,58086,30479,27607
Ohio,Pickaway County,1,3128,1565,1563
Ohio,Pickaway County,2,3376,1685,1691
Ohio,Pickaway County,3,3619,1826,1793
Ohio,Pickaway County,4,3747,2036,1711
Ohio,Pickaway County,5,3758,2246,1512
Ohio,Pickaway County,6,4033,2360,1673
Ohio,Pickaway County,7,3728,2161,1567
Ohio,Pickaway County,8,3886,2141,1745
Ohio,Pickaway County,9,3877,2115,1762
Ohio,Pickaway County,10,4176,2279,1897
Ohio,Pickaway County,11,4097,2232,1865
Ohio,Pickaway County,12,3855,1971,1884
Ohio,Pickaway County,13,3691,1810,1881
Ohio,Pickaway County,14,2903,1351,1552
Ohio,Pickaway County,15,2343,1071,1272
Ohio,Pickaway County,16,1683,774,909
Ohio,Pickaway County,17,1119,465,654
Ohio,Pickaway County,18,1067,391,676
Ohio,Pike County,0,28067,13942,14125
Ohio,Pike County,1,1727,849,878
Ohio,Pike County,2,1732,927,805
Ohio,Pike County,3,1916,1013,903
Ohio,Pike County,4,1857,1003,854
Ohio,Pike County,5,1555,788,767
Ohio,Pike County,6,1728,891,837
Ohio,Pike County,7,1441,712,729
Ohio,Pike County,8,1658,810,848
Ohio,Pike County,9,1730,830,900
Ohio,Pike County,10,1838,932,906
Ohio,Pike County,11,1923,962,961
Ohio,Pike County,12,2047,1019,1028
Ohio,Pike County,13,1906,938,968
Ohio,Pike County,14,1587,804,783
Ohio,Pike County,15,1265,585,680
Ohio,Pike County,16,906,401,505
Ohio,Pike County,17,614,242,372
Ohio,Pike County,18,637,236,401
Ohio,Portage County,0,162927,79918,83009
Ohio,Portage County,1,7492,3906,3586
Ohio,Portage County,2,8038,4118,3920
Ohio,Portage County,3,9168,4702,4466
Ohio,Portage County,4,13254,6183,7071
Ohio,Portage County,5,18748,8933,9815
Ohio,Portage County,6,10284,5375,4909
Ohio,Portage County,7,8456,4314,4142
Ohio,Portage County,8,8893,4533,4360
Ohio,Portage County,9,8346,4148,4198
Ohio,Portage County,10,9940,4912,5028
Ohio,Portage County,11,10535,5119,5416
Ohio,Portage County,12,11745,5794,5951
Ohio,Portage County,13,11234,5577,5657
Ohio,Portage County,14,9059,4338,4721
Ohio,Portage County,15,6904,3305,3599
Ohio,Portage County,16,4803,2179,2624
Ohio,Portage County,17,3062,1345,1717
Ohio,Portage County,18,2966,1137,1829
Ohio,Preble County,0,40997,20299,20698
Ohio,Preble County,1,2206,1131,1075
Ohio,Preble County,2,2413,1273,1140
Ohio,Preble County,3,2843,1406,1437
Ohio,Preble County,4,2622,1374,1248
Ohio,Preble County,5,2127,1079,1048
Ohio,Preble County,6,2269,1147,1122
Ohio,Preble County,7,2246,1111,1135
Ohio,Preble County,8,2439,1218,1221
Ohio,Preble County,9,2412,1210,1202
Ohio,Preble County,10,2649,1317,1332
Ohio,Preble County,11,2813,1402,1411
Ohio,Preble County,12,3095,1519,1576
Ohio,Preble County,13,2970,1460,1510
Ohio,Preble County,14,2668,1307,1361
Ohio,Preble County,15,2012,960,1052
Ohio,Preble County,16,1410,629,781
Ohio,Preble County,17,988,456,532
Ohio,Preble County,18,815,300,515
Ohio,Putnam County,0,33780,16863,16917
Ohio,Putnam County,1,2296,1127,1169
Ohio,Putnam County,2,2465,1290,1175
Ohio,Putnam County,3,2438,1255,1183
Ohio,Putnam County,4,2148,1092,1056
Ohio,Putnam County,5,1878,958,920
Ohio,Putnam County,6,1875,943,932
Ohio,Putnam County,7,1857,930,927
Ohio,Putnam County,8,2023,1011,1012
Ohio,Putnam County,9,1775,903,872
Ohio,Putnam County,10,1977,1025,952
Ohio,Putnam County,11,2184,1112,1072
Ohio,Putnam County,12,2539,1259,1280
Ohio,Putnam County,13,2451,1271,1180
Ohio,Putnam County,14,1895,959,936
Ohio,Putnam County,15,1317,646,671
Ohio,Putnam County,16,1043,468,575
Ohio,Putnam County,17,764,307,457
Ohio,Putnam County,18,855,307,548
Ohio,Richland County,0,121099,61512,59587
Ohio,Richland County,1,6839,3495,3344
Ohio,Richland County,2,7249,3684,3565
Ohio,Richland County,3,7555,3867,3688
Ohio,Richland County,4,7225,3783,3442
Ohio,Richland County,5,7330,4163,3167
Ohio,Richland County,6,8061,4583,3478
Ohio,Richland County,7,7237,4015,3222
Ohio,Richland County,8,7178,3861,3317
Ohio,Richland County,9,7095,3824,3271
Ohio,Richland County,10,7262,3841,3421
Ohio,Richland County,11,7629,3911,3718
Ohio,Richland County,12,8408,4155,4253
Ohio,Richland County,13,8466,4138,4328
Ohio,Richland County,14,7206,3341,3865
Ohio,Richland County,15,5761,2630,3131
Ohio,Richland County,16,4278,1843,2435
Ohio,Richland County,17,3062,1242,1820
Ohio,Richland County,18,3258,1136,2122
Ohio,Ross County,0,76931,40281,36650
Ohio,Ross County,1,4253,2175,2078
Ohio,Ross County,2,4299,2211,2088
Ohio,Ross County,3,4769,2408,2361
Ohio,Ross County,4,4551,2447,2104
Ohio,Ross County,5,4449,2430,2019
Ohio,Ross County,6,4996,2809,2187
Ohio,Ross County,7,4620,2685,1935
Ohio,Ross County,8,5054,2820,2234
Ohio,Ross County,9,5040,2819,2221
Ohio,Ross County,10,5440,3052,2388
Ohio,Ross County,11,5492,3009,2483
Ohio,Ross County,12,5697,2905,2792
Ohio,Ross County,13,5419,2734,2685
Ohio,Ross County,14,4270,2036,2234
Ohio,Ross County,15,3230,1520,1710
Ohio,Ross County,16,2462,1081,1381
Ohio,Ross County,17,1603,693,910
Ohio,Ross County,18,1287,447,840
Ohio,Sandusky County,0,58799,29117,29682
Ohio,Sandusky County,1,3307,1702,1605
Ohio,Sandusky County,2,3501,1800,1701
Ohio,Sandusky County,3,3817,1944,1873
Ohio,Sandusky County,4,3764,1996,1768
Ohio,Sandusky County,5,3223,1620,1603
Ohio,Sandusky County,6,3450,1720,1730
Ohio,Sandusky County,7,3292,1692,1600
Ohio,Sandusky County,8,3594,1806,1788
Ohio,Sandusky County,9,3368,1710,1658
Ohio,Sandusky County,10,3652,1827,1825
Ohio,Sandusky County,11,4020,2029,1991
Ohio,Sandusky County,12,4331,2156,2175
Ohio,Sandusky County,13,4439,2169,2270
Ohio,Sandusky County,14,3598,1757,1841
Ohio,Sandusky County,15,2789,1325,1464
Ohio,Sandusky County,16,1863,821,1042
Ohio,Sandusky County,17,1368,551,817
Ohio,Sandusky County,18,1423,492,931
Ohio,Scioto County,0,75502,37285,38217
Ohio,Scioto County,1,4367,2191,2176
Ohio,Scioto County,2,4391,2240,2151
Ohio,Scioto County,3,4720,2405,2315
Ohio,Scioto County,4,4792,2521,2271
Ohio,Scioto County,5,4644,2526,2118
Ohio,Scioto County,6,5079,2769,2310
Ohio,Scioto County,7,4490,2359,2131
Ohio,Scioto County,8,4549,2277,2272
Ohio,Scioto County,9,4538,2245,2293
Ohio,Scioto County,10,4896,2446,2450
Ohio,Scioto County,11,4785,2314,2471
Ohio,Scioto County,12,5149,2467,2682
Ohio,Scioto County,13,5310,2480,2830
Ohio,Scioto County,14,4372,2106,2266
Ohio,Scioto County,15,3415,1571,1844
Ohio,Scioto County,16,2453,1046,1407
Ohio,Scioto County,17,1832,750,1082
Ohio,Scioto County,18,1720,572,1148
Ohio,Seneca County,0,55207,27592,27615
Ohio,Seneca County,1,2991,1504,1487
Ohio,Seneca County,2,3172,1655,1517
Ohio,Seneca County,3,3667,1947,1720
Ohio,Seneca County,4,4252,2197,2055
Ohio,Seneca County,5,3829,2030,1799
Ohio,Seneca County,6,3386,1760,1626
Ohio,Seneca County,7,3020,1567,1453
Ohio,Seneca County,8,3249,1674,1575
Ohio,Seneca County,9,3173,1566,1607
Ohio,Seneca County,10,3128,1593,1535
Ohio,Seneca County,11,3425,1737,1688
Ohio,Seneca County,12,3923,1941,1982
Ohio,Seneca County,13,3975,1993,1982
Ohio,Seneca County,14,3347,1645,1702
Ohio,Seneca County,15,2357,1098,1259
Ohio,Seneca County,16,1759,794,965
Ohio,Seneca County,17,1157,484,673
Ohio,Seneca County,18,1397,407,990
Ohio,Shelby County,0,48627,24423,24204
Ohio,Shelby County,1,3129,1602,1527
Ohio,Shelby County,2,3231,1675,1556
Ohio,Shelby County,3,3538,1863,1675
Ohio,Shelby County,4,3338,1757,1581
Ohio,Shelby County,5,2836,1448,1388
Ohio,Shelby County,6,3007,1534,1473
Ohio,Shelby County,7,2683,1349,1334
Ohio,Shelby County,8,2773,1415,1358
Ohio,Shelby County,9,2772,1360,1412
Ohio,Shelby County,10,3022,1539,1483
Ohio,Shelby County,11,3383,1726,1657
Ohio,Shelby County,12,3530,1812,1718
Ohio,Shelby County,13,3344,1680,1664
Ohio,Shelby County,14,2643,1328,1315
Ohio,Shelby County,15,2014,940,1074
Ohio,Shelby County,16,1390,609,781
Ohio,Shelby County,17,948,415,533
Ohio,Shelby County,18,1046,371,675
Ohio,Stark County,0,371574,180539,191035
Ohio,Stark County,1,20919,10821,10098
Ohio,Stark County,2,21364,10980,10384
Ohio,Stark County,3,23000,11743,11257
Ohio,Stark County,4,23449,11953,11496
Ohio,Stark County,5,22640,11551,11089
Ohio,Stark County,6,23372,11604,11768
Ohio,Stark County,7,20991,10450,10541
Ohio,Stark County,8,21788,10679,11109
Ohio,Stark County,9,20207,9904,10303
Ohio,Stark County,10,23319,11415,11904
Ohio,Stark County,11,24372,11932,12440
Ohio,Stark County,12,26915,12980,13935
Ohio,Stark County,13,26945,12895,14050
Ohio,Stark County,14,23040,10895,12145
Ohio,Stark County,15,17778,8187,9591
Ohio,Stark County,16,12784,5571,7213
Ohio,Stark County,17,8878,3695,5183
Ohio,Stark County,18,9813,3284,6529
Ohio,Summit County,0,541918,262912,279006
Ohio,Summit County,1,30222,15272,14950
Ohio,Summit County,2,30748,15744,15004
Ohio,Summit County,3,31930,16248,15682
Ohio,Summit County,4,33377,17139,16238
Ohio,Summit County,5,33258,16855,16403
Ohio,Summit County,6,38313,19233,19080
Ohio,Summit County,7,34064,16891,17173
Ohio,Summit County,8,32775,16237,16538
Ohio,Summit County,9,30391,14919,15472
Ohio,Summit County,10,34526,16818,17708
Ohio,Summit County,11,36323,17699,18624
Ohio,Summit County,12,39805,19149,20656
Ohio,Summit County,13,38954,18438,20516
Ohio,Summit County,14,32004,15113,16891
Ohio,Summit County,15,24313,10996,13317
Ohio,Summit County,16,16193,6957,9236
Ohio,Summit County,17,11580,4714,6866
Ohio,Summit County,18,13142,4490,8652
Ohio,Trumbull County,0,198627,96722,101905
Ohio,Trumbull County,1,10545,5492,5053
Ohio,Trumbull County,2,10786,5443,5343
Ohio,Trumbull County,3,11926,6076,5850
Ohio,Trumbull County,4,11567,5978,5589
Ohio,Trumbull County,5,11219,5692,5527
Ohio,Trumbull County,6,12106,6140,5966
Ohio,Trumbull County,7,10559,5344,5215
Ohio,Trumbull County,8,10697,5260,5437
Ohio,Trumbull County,9,10750,5363,5387
Ohio,Trumbull County,10,12275,6020,6255
Ohio,Trumbull County,11,13181,6456,6725
Ohio,Trumbull County,12,14987,7171,7816
Ohio,Trumbull County,13,15098,7331,7767
Ohio,Trumbull County,14,13811,6426,7385
Ohio,Trumbull County,15,10609,4948,5661
Ohio,Trumbull County,16,7558,3379,4179
Ohio,Trumbull County,17,5226,2207,3019
Ohio,Trumbull County,18,5727,1996,3731
Ohio,Tuscarawas County,0,92176,45484,46692
Ohio,Tuscarawas County,1,5702,2906,2796
Ohio,Tuscarawas County,2,5772,3005,2767
Ohio,Tuscarawas County,3,5864,2983,2881
Ohio,Tuscarawas County,4,5694,2984,2710
Ohio,Tuscarawas County,5,5200,2681,2519
Ohio,Tuscarawas County,6,5430,2790,2640
Ohio,Tuscarawas County,7,5241,2678,2563
Ohio,Tuscarawas County,8,5451,2758,2693
Ohio,Tuscarawas County,9,5205,2668,2537
Ohio,Tuscarawas County,10,5534,2734,2800
Ohio,Tuscarawas County,11,5796,2859,2937
Ohio,Tuscarawas County,12,6648,3282,3366
Ohio,Tuscarawas County,13,6564,3240,3324
Ohio,Tuscarawas County,14,5688,2684,3004
Ohio,Tuscarawas County,15,4397,2056,2341
Ohio,Tuscarawas County,16,3140,1379,1761
Ohio,Tuscarawas County,17,2337,926,1411
Ohio,Tuscarawas County,18,2513,871,1642
Ohio,Union County,0,57835,27731,30104
Ohio,Union County,1,3664,1890,1774
Ohio,Union County,2,3875,1958,1917
Ohio,Union County,3,4252,2125,2127
Ohio,Union County,4,3828,1996,1832
Ohio,Union County,5,3287,1547,1740
Ohio,Union County,6,3748,1676,2072
Ohio,Union County,7,3932,1712,2220
Ohio,Union County,8,4338,2007,2331
Ohio,Union County,9,4305,1981,2324
Ohio,Union County,10,4400,2140,2260
Ohio,Union County,11,4044,2018,2026
Ohio,Union County,12,3890,1919,1971
Ohio,Union County,13,3156,1544,1612
Ohio,Union County,14,2477,1196,1281
Ohio,Union County,15,1866,863,1003
Ohio,Union County,16,1232,546,686
Ohio,Union County,17,780,313,467
Ohio,Union County,18,761,300,461
Ohio,Van Wert County,0,28281,14010,14271
Ohio,Van Wert County,1,1784,951,833
Ohio,Van Wert County,2,1712,869,843
Ohio,Van Wert County,3,1911,953,958
Ohio,Van Wert County,4,1781,907,874
Ohio,Van Wert County,5,1617,839,778
Ohio,Van Wert County,6,1734,888,846
Ohio,Van Wert County,7,1499,758,741
Ohio,Van Wert County,8,1748,914,834
Ohio,Van Wert County,9,1605,830,775
Ohio,Van Wert County,10,1711,858,853
Ohio,Van Wert County,11,1783,880,903
Ohio,Van Wert County,12,2026,996,1030
Ohio,Van Wert County,13,2004,970,1034
Ohio,Van Wert County,14,1660,836,824
Ohio,Van Wert County,15,1314,595,719
Ohio,Van Wert County,16,969,436,533
Ohio,Van Wert County,17,670,297,373
Ohio,Van Wert County,18,753,233,520
Ohio,Vinton County,0,13139,6587,6552
Ohio,Vinton County,1,737,388,349
Ohio,Vinton County,2,730,365,365
Ohio,Vinton County,3,853,443,410
Ohio,Vinton County,4,833,423,410
Ohio,Vinton County,5,693,367,326
Ohio,Vinton County,6,825,435,390
Ohio,Vinton County,7,677,349,328
Ohio,Vinton County,8,769,369,400
Ohio,Vinton County,9,839,429,410
Ohio,Vinton County,10,888,439,449
Ohio,Vinton County,11,892,428,464
Ohio,Vinton County,12,1082,567,515
Ohio,Vinton County,13,983,482,501
Ohio,Vinton County,14,804,395,409
Ohio,Vinton County,15,615,326,289
Ohio,Vinton County,16,419,197,222
Ohio,Vinton County,17,293,118,175
Ohio,Vinton County,18,207,67,140
Ohio,Warren County,0,232173,116699,115474
Ohio,Warren County,1,13434,6878,6556
Ohio,Warren County,2,15628,8036,7592
Ohio,Warren County,3,17301,8917,8384
Ohio,Warren County,4,16547,8559,7988
Ohio,Warren County,5,12984,7076,5908
Ohio,Warren County,6,12233,6559,5674
Ohio,Warren County,7,13702,7102,6600
Ohio,Warren County,8,15926,8016,7910
Ohio,Warren County,9,15536,7832,7704
Ohio,Warren County,10,17476,8784,8692
Ohio,Warren County,11,17014,8527,8487
Ohio,Warren County,12,16468,8277,8191
Ohio,Warren County,13,14278,7009,7269
Ohio,Warren County,14,11107,5284,5823
Ohio,Warren County,15,8788,4122,4666
Ohio,Warren County,16,6083,2761,3322
Ohio,Warren County,17,3913,1628,2285
Ohio,Warren County,18,3755,1332,2423
Ohio,Washington County,0,60155,29533,30622
Ohio,Washington County,1,2964,1506,1458
Ohio,Washington County,2,3230,1650,1580
Ohio,Washington County,3,3426,1710,1716
Ohio,Washington County,4,3757,1938,1819
Ohio,Washington County,5,3726,1914,1812
Ohio,Washington County,6,3512,1776,1736
Ohio,Washington County,7,3241,1669,1572
Ohio,Washington County,8,3443,1736,1707
Ohio,Washington County,9,3285,1570,1715
Ohio,Washington County,10,3761,1836,1925
Ohio,Washington County,11,3916,1962,1954
Ohio,Washington County,12,4575,2215,2360
Ohio,Washington County,13,4656,2329,2327
Ohio,Washington County,14,3967,1916,2051
Ohio,Washington County,15,3148,1470,1678
Ohio,Washington County,16,2453,1102,1351
Ohio,Washington County,17,1567,686,881
Ohio,Washington County,18,1528,548,980
Ohio,Wayne County,0,115967,57649,58318
Ohio,Wayne County,1,7597,3900,3697
Ohio,Wayne County,2,7733,3985,3748
Ohio,Wayne County,3,7909,4075,3834
Ohio,Wayne County,4,8338,4301,4037
Ohio,Wayne County,5,7711,4001,3710
Ohio,Wayne County,6,7131,3635,3496
Ohio,Wayne County,7,6543,3322,3221
Ohio,Wayne County,8,6557,3327,3230
Ohio,Wayne County,9,6262,3149,3113
Ohio,Wayne County,10,6699,3304,3395
Ohio,Wayne County,11,6955,3430,3525
Ohio,Wayne County,12,8061,4005,4056
Ohio,Wayne County,13,7744,3837,3907
Ohio,Wayne County,14,6624,3209,3415
Ohio,Wayne County,15,5051,2373,2678
Ohio,Wayne County,16,3769,1704,2065
Ohio,Wayne County,17,2577,1128,1449
Ohio,Wayne County,18,2706,964,1742
Ohio,Williams County,0,36804,18324,18480
Ohio,Williams County,1,2177,1113,1064
Ohio,Williams County,2,2190,1080,1110
Ohio,Williams County,3,2477,1251,1226
Ohio,Williams County,4,2367,1238,1129
Ohio,Williams County,5,2049,1066,983
Ohio,Williams County,6,2185,1159,1026
Ohio,Williams County,7,2109,1128,981
Ohio,Williams County,8,2208,1105,1103
Ohio,Williams County,9,2101,1120,981
Ohio,Williams County,10,2184,1084,1100
Ohio,Williams County,11,2331,1174,1157
Ohio,Williams County,12,2798,1370,1428
Ohio,Williams County,13,2700,1346,1354
Ohio,Williams County,14,2125,1028,1097
Ohio,Williams County,15,1673,793,880
Ohio,Williams County,16,1326,593,733
Ohio,Williams County,17,861,363,498
Ohio,Williams County,18,943,313,630
Ohio,Wood County,0,130696,64394,66302
Ohio,Wood County,1,7065,3571,3494
Ohio,Wood County,2,7224,3768,3456
Ohio,Wood County,3,7745,3993,3752
Ohio,Wood County,4,11113,5417,5696
Ohio,Wood County,5,16073,7960,8113
Ohio,Wood County,6,8586,4420,4166
Ohio,Wood County,7,7354,3761,3593
Ohio,Wood County,8,7492,3848,3644
Ohio,Wood County,9,7019,3583,3436
Ohio,Wood County,10,7557,3727,3830
Ohio,Wood County,11,7339,3621,3718
Ohio,Wood County,12,8092,3938,4154
Ohio,Wood County,13,8039,3873,4166
Ohio,Wood County,14,6790,3285,3505
Ohio,Wood County,15,5001,2339,2662
Ohio,Wood County,16,3322,1430,1892
Ohio,Wood County,17,2351,972,1379
Ohio,Wood County,18,2534,888,1646
Ohio,Wyandot County,0,21935,10903,11032
Ohio,Wyandot County,1,1238,633,605
Ohio,Wyandot County,2,1337,679,658
Ohio,Wyandot County,3,1494,778,716
Ohio,Wyandot County,4,1345,711,634
Ohio,Wyandot County,5,1194,628,566
Ohio,Wyandot County,6,1188,635,553
Ohio,Wyandot County,7,1242,593,649
Ohio,Wyandot County,8,1386,699,687
Ohio,Wyandot County,9,1293,658,635
Ohio,Wyandot County,10,1369,676,693
Ohio,Wyandot County,11,1462,741,721
Ohio,Wyandot County,12,1563,779,784
Ohio,Wyandot County,13,1551,773,778
Ohio,Wyandot County,14,1298,635,663
Ohio,Wyandot County,15,1012,487,525
Ohio,Wyandot County,16,790,382,408
Ohio,Wyandot County,17,560,224,336
Ohio,Wyandot County,18,613,192,421
Oklahoma,Adair County,0,22082,11015,11067
Oklahoma,Adair County,1,1637,847,790
Oklahoma,Adair County,2,1557,801,756
Oklahoma,Adair County,3,1677,843,834
Oklahoma,Adair County,4,1522,786,736
Oklahoma,Adair County,5,1311,655,656
Oklahoma,Adair County,6,1446,743,703
Oklahoma,Adair County,7,1220,592,628
Oklahoma,Adair County,8,1309,632,677
Oklahoma,Adair County,9,1317,690,627
Oklahoma,Adair County,10,1376,689,687
Oklahoma,Adair County,11,1422,698,724
Oklahoma,Adair County,12,1518,742,776
Oklahoma,Adair County,13,1258,615,643
Oklahoma,Adair County,14,1149,588,561
Oklahoma,Adair County,15,937,437,500
Oklahoma,Adair County,16,683,335,348
Oklahoma,Adair County,17,407,189,218
Oklahoma,Adair County,18,336,133,203
Oklahoma,Alfalfa County,0,5754,3434,2320
Oklahoma,Alfalfa County,1,304,181,123
Oklahoma,Alfalfa County,2,350,180,170
Oklahoma,Alfalfa County,3,296,148,148
Oklahoma,Alfalfa County,4,290,160,130
Oklahoma,Alfalfa County,5,238,126,112
Oklahoma,Alfalfa County,6,289,169,120
Oklahoma,Alfalfa County,7,317,193,124
Oklahoma,Alfalfa County,8,461,340,121
Oklahoma,Alfalfa County,9,428,314,114
Oklahoma,Alfalfa County,10,425,313,112
Oklahoma,Alfalfa County,11,428,294,134
Oklahoma,Alfalfa County,12,395,234,161
Oklahoma,Alfalfa County,13,404,238,166
Oklahoma,Alfalfa County,14,338,189,149
Oklahoma,Alfalfa County,15,247,122,125
Oklahoma,Alfalfa County,16,207,92,115
Oklahoma,Alfalfa County,17,168,76,92
Oklahoma,Alfalfa County,18,169,65,104
Oklahoma,Atoka County,0,13838,7200,6638
Oklahoma,Atoka County,1,832,461,371
Oklahoma,Atoka County,2,884,438,446
Oklahoma,Atoka County,3,881,466,415
Oklahoma,Atoka County,4,803,406,397
Oklahoma,Atoka County,5,752,431,321
Oklahoma,Atoka County,6,952,536,416
Oklahoma,Atoka County,7,877,487,390
Oklahoma,Atoka County,8,849,507,342
Oklahoma,Atoka County,9,780,453,327
Oklahoma,Atoka County,10,830,421,409
Oklahoma,Atoka County,11,814,420,394
Oklahoma,Atoka County,12,923,467,456
Oklahoma,Atoka County,13,915,442,473
Oklahoma,Atoka County,14,828,409,419
Oklahoma,Atoka County,15,743,336,407
Oklahoma,Atoka County,16,538,236,302
Oklahoma,Atoka County,17,357,161,196
Oklahoma,Atoka County,18,280,123,157
Oklahoma,Beaver County,0,5319,2688,2631
Oklahoma,Beaver County,1,310,161,149
Oklahoma,Beaver County,2,375,179,196
Oklahoma,Beaver County,3,427,226,201
Oklahoma,Beaver County,4,410,219,191
Oklahoma,Beaver County,5,233,119,114
Oklahoma,Beaver County,6,289,157,132
Oklahoma,Beaver County,7,269,138,131
Oklahoma,Beaver County,8,316,153,163
Oklahoma,Beaver County,9,270,136,134
Oklahoma,Beaver County,10,326,162,164
Oklahoma,Beaver County,11,331,157,174
Oklahoma,Beaver County,12,374,184,190
Oklahoma,Beaver County,13,340,195,145
Oklahoma,Beaver County,14,300,139,161
Oklahoma,Beaver County,15,269,140,129
Oklahoma,Beaver County,16,186,97,89
Oklahoma,Beaver County,17,144,65,79
Oklahoma,Beaver County,18,150,61,89
Oklahoma,Beckham County,0,21709,11653,10056
Oklahoma,Beckham County,1,1485,724,761
Oklahoma,Beckham County,2,1537,780,757
Oklahoma,Beckham County,3,1498,787,711
Oklahoma,Beckham County,4,1263,671,592
Oklahoma,Beckham County,5,1426,902,524
Oklahoma,Beckham County,6,1744,1045,699
Oklahoma,Beckham County,7,1650,997,653
Oklahoma,Beckham County,8,1546,905,641
Oklahoma,Beckham County,9,1294,748,546
Oklahoma,Beckham County,10,1259,695,564
Oklahoma,Beckham County,11,1221,676,545
Oklahoma,Beckham County,12,1365,707,658
Oklahoma,Beckham County,13,1307,631,676
Oklahoma,Beckham County,14,1057,496,561
Oklahoma,Beckham County,15,708,331,377
Oklahoma,Beckham County,16,508,225,283
Oklahoma,Beckham County,17,421,174,247
Oklahoma,Beckham County,18,420,159,261
Oklahoma,Blaine County,0,9485,4670,4815
Oklahoma,Blaine County,1,687,332,355
Oklahoma,Blaine County,2,703,402,301
Oklahoma,Blaine County,3,713,361,352
Oklahoma,Blaine County,4,596,296,300
Oklahoma,Blaine County,5,468,229,239
Oklahoma,Blaine County,6,496,243,253
Oklahoma,Blaine County,7,486,243,243
Oklahoma,Blaine County,8,507,254,253
Oklahoma,Blaine County,9,489,233,256
Oklahoma,Blaine County,10,525,262,263
Oklahoma,Blaine County,11,566,317,249
Oklahoma,Blaine County,12,696,336,360
Oklahoma,Blaine County,13,691,346,345
Oklahoma,Blaine County,14,576,278,298
Oklahoma,Blaine County,15,439,199,240
Oklahoma,Blaine County,16,359,163,196
Oklahoma,Blaine County,17,227,96,131
Oklahoma,Blaine County,18,261,80,181
Oklahoma,Bryan County,0,47192,23069,24123
Oklahoma,Bryan County,1,3054,1594,1460
Oklahoma,Bryan County,2,3107,1594,1513
Oklahoma,Bryan County,3,3051,1533,1518
Oklahoma,Bryan County,4,3222,1623,1599
Oklahoma,Bryan County,5,3076,1575,1501
Oklahoma,Bryan County,6,3552,1739,1813
Oklahoma,Bryan County,7,3139,1635,1504
Oklahoma,Bryan County,8,2901,1401,1500
Oklahoma,Bryan County,9,2538,1262,1276
Oklahoma,Bryan County,10,2781,1331,1450
Oklahoma,Bryan County,11,2701,1341,1360
Oklahoma,Bryan County,12,2808,1319,1489
Oklahoma,Bryan County,13,2785,1312,1473
Oklahoma,Bryan County,14,2560,1160,1400
Oklahoma,Bryan County,15,2236,1037,1199
Oklahoma,Bryan County,16,1666,799,867
Oklahoma,Bryan County,17,1067,458,609
Oklahoma,Bryan County,18,948,356,592
Oklahoma,Caddo County,0,28977,15204,13773
Oklahoma,Caddo County,1,1993,1051,942
Oklahoma,Caddo County,2,2072,1049,1023
Oklahoma,Caddo County,3,1956,972,984
Oklahoma,Caddo County,4,1956,1033,923
Oklahoma,Caddo County,5,1693,989,704
Oklahoma,Caddo County,6,2032,1248,784
Oklahoma,Caddo County,7,1854,1087,767
Oklahoma,Caddo County,8,1834,1024,810
Oklahoma,Caddo County,9,1565,907,658
Oklahoma,Caddo County,10,1737,939,798
Oklahoma,Caddo County,11,1729,905,824
Oklahoma,Caddo County,12,1922,983,939
Oklahoma,Caddo County,13,1753,861,892
Oklahoma,Caddo County,14,1460,679,781
Oklahoma,Caddo County,15,1255,575,680
Oklahoma,Caddo County,16,940,435,505
Oklahoma,Caddo County,17,641,262,379
Oklahoma,Caddo County,18,585,205,380
Oklahoma,Canadian County,0,144447,71712,72735
Oklahoma,Canadian County,1,9889,5104,4785
Oklahoma,Canadian County,2,10653,5415,5238
Oklahoma,Canadian County,3,11033,5535,5498
Oklahoma,Canadian County,4,9360,4747,4613
Oklahoma,Canadian County,5,7822,3984,3838
Oklahoma,Canadian County,6,10011,4945,5066
Oklahoma,Canadian County,7,11269,5735,5534
Oklahoma,Canadian County,8,11319,5747,5572
Oklahoma,Canadian County,9,9673,4947,4726
Oklahoma,Canadian County,10,9336,4701,4635
Oklahoma,Canadian County,11,8293,4129,4164
Oklahoma,Canadian County,12,8980,4407,4573
Oklahoma,Canadian County,13,8039,3875,4164
Oklahoma,Canadian County,14,6441,3046,3395
Oklahoma,Canadian County,15,5018,2356,2662
Oklahoma,Canadian County,16,3319,1516,1803
Oklahoma,Canadian County,17,2109,857,1252
Oklahoma,Canadian County,18,1883,666,1217
Oklahoma,Carter County,0,48177,23451,24726
Oklahoma,Carter County,1,3285,1714,1571
Oklahoma,Carter County,2,3255,1634,1621
Oklahoma,Carter County,3,3466,1709,1757
Oklahoma,Carter County,4,3195,1600,1595
Oklahoma,Carter County,5,2778,1406,1372
Oklahoma,Carter County,6,3207,1635,1572
Oklahoma,Carter County,7,2907,1490,1417
Oklahoma,Carter County,8,3028,1478,1550
Oklahoma,Carter County,9,2858,1448,1410
Oklahoma,Carter County,10,2962,1469,1493
Oklahoma,Carter County,11,2818,1415,1403
Oklahoma,Carter County,12,3259,1580,1679
Oklahoma,Carter County,13,3056,1449,1607
Oklahoma,Carter County,14,2563,1155,1408
Oklahoma,Carter County,15,1955,890,1065
Oklahoma,Carter County,16,1575,676,899
Oklahoma,Carter County,17,992,416,576
Oklahoma,Carter County,18,1018,287,731
Oklahoma,Cherokee County,0,48675,23794,24881
Oklahoma,Cherokee County,1,2775,1421,1354
Oklahoma,Cherokee County,2,3046,1526,1520
Oklahoma,Cherokee County,3,3034,1477,1557
Oklahoma,Cherokee County,4,3721,1871,1850
Oklahoma,Cherokee County,5,5374,2714,2660
Oklahoma,Cherokee County,6,3197,1599,1598
Oklahoma,Cherokee County,7,2754,1408,1346
Oklahoma,Cherokee County,8,2961,1484,1477
Oklahoma,Cherokee County,9,2518,1246,1272
Oklahoma,Cherokee County,10,2643,1296,1347
Oklahoma,Cherokee County,11,2635,1261,1374
Oklahoma,Cherokee County,12,3035,1428,1607
Oklahoma,Cherokee County,13,2852,1361,1491
Oklahoma,Cherokee County,14,2612,1296,1316
Oklahoma,Cherokee County,15,2178,988,1190
Oklahoma,Cherokee County,16,1487,662,825
Oklahoma,Cherokee County,17,1026,430,596
Oklahoma,Cherokee County,18,827,326,501
Oklahoma,Choctaw County,0,14668,7036,7632
Oklahoma,Choctaw County,1,986,474,512
Oklahoma,Choctaw County,2,932,502,430
Oklahoma,Choctaw County,3,1017,504,513
Oklahoma,Choctaw County,4,905,439,466
Oklahoma,Choctaw County,5,762,367,395
Oklahoma,Choctaw County,6,878,440,438
Oklahoma,Choctaw County,7,717,349,368
Oklahoma,Choctaw County,8,800,352,448
Oklahoma,Choctaw County,9,778,369,409
Oklahoma,Choctaw County,10,835,411,424
Oklahoma,Choctaw County,11,882,409,473
Oklahoma,Choctaw County,12,1093,532,561
Oklahoma,Choctaw County,13,1047,497,550
Oklahoma,Choctaw County,14,928,452,476
Oklahoma,Choctaw County,15,810,384,426
Oklahoma,Choctaw County,16,597,257,340
Oklahoma,Choctaw County,17,341,166,175
Oklahoma,Choctaw County,18,360,132,228
Oklahoma,Cimarron County,0,2153,1102,1051
Oklahoma,Cimarron County,1,139,79,60
Oklahoma,Cimarron County,2,164,95,69
Oklahoma,Cimarron County,3,142,76,66
Oklahoma,Cimarron County,4,137,66,71
Oklahoma,Cimarron County,5,94,51,43
Oklahoma,Cimarron County,6,98,47,51
Oklahoma,Cimarron County,7,116,60,56
Oklahoma,Cimarron County,8,108,50,58
Oklahoma,Cimarron County,9,101,52,49
Oklahoma,Cimarron County,10,122,67,55
Oklahoma,Cimarron County,11,117,63,54
Oklahoma,Cimarron County,12,135,74,61
Oklahoma,Cimarron County,13,132,64,68
Oklahoma,Cimarron County,14,170,81,89
Oklahoma,Cimarron County,15,123,62,61
Oklahoma,Cimarron County,16,121,56,65
Oklahoma,Cimarron County,17,75,33,42
Oklahoma,Cimarron County,18,59,26,33
Oklahoma,Cleveland County,0,281669,140424,141245
Oklahoma,Cleveland County,1,15130,7672,7458
Oklahoma,Cleveland County,2,16849,8598,8251
Oklahoma,Cleveland County,3,17975,9330,8645
Oklahoma,Cleveland County,4,20965,10513,10452
Oklahoma,Cleveland County,5,30443,15777,14666
Oklahoma,Cleveland County,6,21938,11594,10344
Oklahoma,Cleveland County,7,19789,10063,9726
Oklahoma,Cleveland County,8,20298,10253,10045
Oklahoma,Cleveland County,9,16705,8552,8153
Oklahoma,Cleveland County,10,16493,8387,8106
Oklahoma,Cleveland County,11,15249,7520,7729
Oklahoma,Cleveland County,12,16932,8248,8684
Oklahoma,Cleveland County,13,15244,7263,7981
Oklahoma,Cleveland County,14,12878,5998,6880
Oklahoma,Cleveland County,15,9906,4532,5374
Oklahoma,Cleveland County,16,6686,2910,3776
Oklahoma,Cleveland County,17,4021,1686,2335
Oklahoma,Cleveland County,18,4168,1528,2640
Oklahoma,Coal County,0,5520,2751,2769
Oklahoma,Coal County,1,384,208,176
Oklahoma,Coal County,2,331,179,152
Oklahoma,Coal County,3,394,207,187
Oklahoma,Coal County,4,335,174,161
Oklahoma,Coal County,5,305,164,141
Oklahoma,Coal County,6,361,185,176
Oklahoma,Coal County,7,258,117,141
Oklahoma,Coal County,8,274,144,130
Oklahoma,Coal County,9,341,175,166
Oklahoma,Coal County,10,290,132,158
Oklahoma,Coal County,11,324,175,149
Oklahoma,Coal County,12,393,206,187
Oklahoma,Coal County,13,409,208,201
Oklahoma,Coal County,14,330,145,185
Oklahoma,Coal County,15,301,151,150
Oklahoma,Coal County,16,203,83,120
Oklahoma,Coal County,17,140,55,85
Oklahoma,Coal County,18,147,43,104
Oklahoma,Comanche County,0,120422,62410,58012
Oklahoma,Comanche County,1,8293,4236,4057
Oklahoma,Comanche County,2,8060,4050,4010
Oklahoma,Comanche County,3,7712,3964,3748
Oklahoma,Comanche County,4,8531,4735,3796
Oklahoma,Comanche County,5,10869,6536,4333
Oklahoma,Comanche County,6,10560,5879,4681
Oklahoma,Comanche County,7,9293,5044,4249
Oklahoma,Comanche County,8,8269,4326,3943
Oklahoma,Comanche County,9,6588,3405,3183
Oklahoma,Comanche County,10,6550,3254,3296
Oklahoma,Comanche County,11,6544,3326,3218
Oklahoma,Comanche County,12,7393,3640,3753
Oklahoma,Comanche County,13,6568,3137,3431
Oklahoma,Comanche County,14,4966,2387,2579
Oklahoma,Comanche County,15,3713,1725,1988
Oklahoma,Comanche County,16,2769,1216,1553
Oklahoma,Comanche County,17,1879,826,1053
Oklahoma,Comanche County,18,1865,724,1141
Oklahoma,Cotton County,0,5776,2840,2936
Oklahoma,Cotton County,1,321,158,163
Oklahoma,Cotton County,2,358,181,177
Oklahoma,Cotton County,3,396,200,196
Oklahoma,Cotton County,4,338,173,165
Oklahoma,Cotton County,5,297,155,142
Oklahoma,Cotton County,6,361,186,175
Oklahoma,Cotton County,7,294,147,147
Oklahoma,Cotton County,8,335,167,168
Oklahoma,Cotton County,9,299,149,150
Oklahoma,Cotton County,10,343,175,168
Oklahoma,Cotton County,11,412,202,210
Oklahoma,Cotton County,12,455,215,240
Oklahoma,Cotton County,13,448,212,236
Oklahoma,Cotton County,14,323,170,153
Oklahoma,Cotton County,15,311,146,165
Oklahoma,Cotton County,16,214,85,129
Oklahoma,Cotton County,17,158,79,79
Oklahoma,Cotton County,18,113,40,73
Oklahoma,Craig County,0,14306,7328,6978
Oklahoma,Craig County,1,815,387,428
Oklahoma,Craig County,2,838,443,395
Oklahoma,Craig County,3,927,473,454
Oklahoma,Craig County,4,897,472,425
Oklahoma,Craig County,5,815,471,344
Oklahoma,Craig County,6,913,514,399
Oklahoma,Craig County,7,813,462,351
Oklahoma,Craig County,8,811,442,369
Oklahoma,Craig County,9,832,435,397
Oklahoma,Craig County,10,913,492,421
Oklahoma,Craig County,11,954,496,458
Oklahoma,Craig County,12,1068,552,516
Oklahoma,Craig County,13,910,455,455
Oklahoma,Craig County,14,789,382,407
Oklahoma,Craig County,15,693,332,361
Oklahoma,Craig County,16,635,284,351
Oklahoma,Craig County,17,348,133,215
Oklahoma,Craig County,18,335,103,232
Oklahoma,Creek County,0,71604,35428,36176
Oklahoma,Creek County,1,4546,2339,2207
Oklahoma,Creek County,2,4631,2402,2229
Oklahoma,Creek County,3,4925,2516,2409
Oklahoma,Creek County,4,4670,2436,2234
Oklahoma,Creek County,5,4009,2081,1928
Oklahoma,Creek County,6,4411,2226,2185
Oklahoma,Creek County,7,4166,2157,2009
Oklahoma,Creek County,8,4518,2264,2254
Oklahoma,Creek County,9,4075,2019,2056
Oklahoma,Creek County,10,4501,2226,2275
Oklahoma,Creek County,11,4595,2255,2340
Oklahoma,Creek County,12,5178,2565,2613
Oklahoma,Creek County,13,4741,2296,2445
Oklahoma,Creek County,14,4047,1925,2122
Oklahoma,Creek County,15,3201,1454,1747
Oklahoma,Creek County,16,2377,1086,1291
Oklahoma,Creek County,17,1531,668,863
Oklahoma,Creek County,18,1482,513,969
Oklahoma,Custer County,0,29036,14446,14590
Oklahoma,Custer County,1,2075,1078,997
Oklahoma,Custer County,2,2084,1071,1013
Oklahoma,Custer County,3,1911,940,971
Oklahoma,Custer County,4,2387,1176,1211
Oklahoma,Custer County,5,3620,1876,1744
Oklahoma,Custer County,6,1941,1009,932
Oklahoma,Custer County,7,1775,923,852
Oklahoma,Custer County,8,1870,976,894
Oklahoma,Custer County,9,1368,717,651
Oklahoma,Custer County,10,1440,686,754
Oklahoma,Custer County,11,1344,678,666
Oklahoma,Custer County,12,1710,875,835
Oklahoma,Custer County,13,1493,710,783
Oklahoma,Custer County,14,1179,531,648
Oklahoma,Custer County,15,1033,451,582
Oklahoma,Custer County,16,709,319,390
Oklahoma,Custer County,17,498,204,294
Oklahoma,Custer County,18,599,226,373
Oklahoma,Delaware County,0,42733,21050,21683
Oklahoma,Delaware County,1,2153,1081,1072
Oklahoma,Delaware County,2,2230,1145,1085
Oklahoma,Delaware County,3,2592,1359,1233
Oklahoma,Delaware County,4,2479,1269,1210
Oklahoma,Delaware County,5,2191,1137,1054
Oklahoma,Delaware County,6,2286,1128,1158
Oklahoma,Delaware County,7,2080,998,1082
Oklahoma,Delaware County,8,2166,1045,1121
Oklahoma,Delaware County,9,2113,1067,1046
Oklahoma,Delaware County,10,2467,1210,1257
Oklahoma,Delaware County,11,2695,1308,1387
Oklahoma,Delaware County,12,3300,1598,1702
Oklahoma,Delaware County,13,3300,1541,1759
Oklahoma,Delaware County,14,3275,1518,1757
Oklahoma,Delaware County,15,2989,1518,1471
Oklahoma,Delaware County,16,2177,1061,1116
Oklahoma,Delaware County,17,1222,626,596
Oklahoma,Delaware County,18,1018,441,577
Oklahoma,Dewey County,0,4894,2413,2481
Oklahoma,Dewey County,1,335,169,166
Oklahoma,Dewey County,2,403,198,205
Oklahoma,Dewey County,3,370,187,183
Oklahoma,Dewey County,4,333,163,170
Oklahoma,Dewey County,5,230,129,101
Oklahoma,Dewey County,6,300,147,153
Oklahoma,Dewey County,7,275,141,134
Oklahoma,Dewey County,8,296,156,140
Oklahoma,Dewey County,9,271,139,132
Oklahoma,Dewey County,10,227,109,118
Oklahoma,Dewey County,11,294,149,145
Oklahoma,Dewey County,12,333,167,166
Oklahoma,Dewey County,13,325,160,165
Oklahoma,Dewey County,14,239,112,127
Oklahoma,Dewey County,15,239,126,113
Oklahoma,Dewey County,16,189,75,114
Oklahoma,Dewey County,17,135,59,76
Oklahoma,Dewey County,18,100,27,73
Oklahoma,Ellis County,0,3952,1940,2012
Oklahoma,Ellis County,1,227,112,115
Oklahoma,Ellis County,2,235,107,128
Oklahoma,Ellis County,3,281,141,140
Oklahoma,Ellis County,4,249,130,119
Oklahoma,Ellis County,5,186,100,86
Oklahoma,Ellis County,6,192,94,98
Oklahoma,Ellis County,7,192,104,88
Oklahoma,Ellis County,8,247,123,124
Oklahoma,Ellis County,9,243,129,114
Oklahoma,Ellis County,10,225,117,108
Oklahoma,Ellis County,11,203,103,100
Oklahoma,Ellis County,12,290,145,145
Oklahoma,Ellis County,13,296,142,154
Oklahoma,Ellis County,14,295,147,148
Oklahoma,Ellis County,15,213,94,119
Oklahoma,Ellis County,16,162,77,85
Oklahoma,Ellis County,17,108,48,60
Oklahoma,Ellis County,18,108,27,81
Oklahoma,Garfield County,0,60913,30323,30590
Oklahoma,Garfield County,1,4481,2308,2173
Oklahoma,Garfield County,2,4450,2235,2215
Oklahoma,Garfield County,3,4418,2283,2135
Oklahoma,Garfield County,4,3741,1894,1847
Oklahoma,Garfield County,5,3884,2102,1782
Oklahoma,Garfield County,6,4384,2277,2107
Oklahoma,Garfield County,7,4178,2172,2006
Oklahoma,Garfield County,8,4169,2089,2080
Oklahoma,Garfield County,9,3253,1640,1613
Oklahoma,Garfield County,10,3040,1546,1494
Oklahoma,Garfield County,11,3294,1647,1647
Oklahoma,Garfield County,12,3986,1994,1992
Oklahoma,Garfield County,13,3653,1791,1862
Oklahoma,Garfield County,14,3064,1432,1632
Oklahoma,Garfield County,15,2307,1063,1244
Oklahoma,Garfield County,16,1825,798,1027
Oklahoma,Garfield County,17,1328,520,808
Oklahoma,Garfield County,18,1458,532,926
Oklahoma,Garvin County,0,27811,13727,14084
Oklahoma,Garvin County,1,1846,924,922
Oklahoma,Garvin County,2,1936,983,953
Oklahoma,Garvin County,3,1983,990,993
Oklahoma,Garvin County,4,1825,956,869
Oklahoma,Garvin County,5,1517,796,721
Oklahoma,Garvin County,6,1677,843,834
Oklahoma,Garvin County,7,1633,817,816
Oklahoma,Garvin County,8,1839,959,880
Oklahoma,Garvin County,9,1613,820,793
Oklahoma,Garvin County,10,1715,875,840
Oklahoma,Garvin County,11,1537,752,785
Oklahoma,Garvin County,12,1816,863,953
Oklahoma,Garvin County,13,1887,908,979
Oklahoma,Garvin County,14,1538,743,795
Oklahoma,Garvin County,15,1240,584,656
Oklahoma,Garvin County,16,960,393,567
Oklahoma,Garvin County,17,648,286,362
Oklahoma,Garvin County,18,601,235,366
Oklahoma,Grady County,0,55551,27773,27778
Oklahoma,Grady County,1,3160,1611,1549
Oklahoma,Grady County,2,3717,1945,1772
Oklahoma,Grady County,3,4088,2125,1963
Oklahoma,Grady County,4,3727,2011,1716
Oklahoma,Grady County,5,3038,1575,1463
Oklahoma,Grady County,6,3344,1693,1651
Oklahoma,Grady County,7,3237,1553,1684
Oklahoma,Grady County,8,3931,1974,1957
Oklahoma,Grady County,9,3323,1696,1627
Oklahoma,Grady County,10,3594,1778,1816
Oklahoma,Grady County,11,3433,1736,1697
Oklahoma,Grady County,12,4222,2111,2111
Oklahoma,Grady County,13,3723,1843,1880
Oklahoma,Grady County,14,2936,1411,1525
Oklahoma,Grady County,15,2396,1150,1246
Oklahoma,Grady County,16,1656,762,894
Oklahoma,Grady County,17,1091,464,627
Oklahoma,Grady County,18,935,335,600
Oklahoma,Grant County,0,4326,2145,2181
Oklahoma,Grant County,1,261,135,126
Oklahoma,Grant County,2,282,137,145
Oklahoma,Grant County,3,319,139,180
Oklahoma,Grant County,4,253,137,116
Oklahoma,Grant County,5,205,96,109
Oklahoma,Grant County,6,238,124,114
Oklahoma,Grant County,7,238,131,107
Oklahoma,Grant County,8,241,114,127
Oklahoma,Grant County,9,208,116,92
Oklahoma,Grant County,10,226,111,115
Oklahoma,Grant County,11,265,129,136
Oklahoma,Grant County,12,345,192,153
Oklahoma,Grant County,13,294,154,140
Oklahoma,Grant County,14,296,146,150
Oklahoma,Grant County,15,196,91,105
Oklahoma,Grant County,16,173,67,106
Oklahoma,Grant County,17,150,73,77
Oklahoma,Grant County,18,136,53,83
Oklahoma,Greer County,0,5821,3347,2474
Oklahoma,Greer County,1,283,146,137
Oklahoma,Greer County,2,346,165,181
Oklahoma,Greer County,3,305,166,139
Oklahoma,Greer County,4,349,171,178
Oklahoma,Greer County,5,357,245,112
Oklahoma,Greer County,6,466,352,114
Oklahoma,Greer County,7,459,314,145
Oklahoma,Greer County,8,414,272,142
Oklahoma,Greer County,9,391,257,134
Oklahoma,Greer County,10,366,243,123
Oklahoma,Greer County,11,385,233,152
Oklahoma,Greer County,12,365,194,171
Oklahoma,Greer County,13,299,148,151
Oklahoma,Greer County,14,271,131,140
Oklahoma,Greer County,15,239,108,131
Oklahoma,Greer County,16,195,76,119
Oklahoma,Greer County,17,155,71,84
Oklahoma,Greer County,18,176,55,121
Oklahoma,Harmon County,0,2664,1273,1391
Oklahoma,Harmon County,1,168,85,83
Oklahoma,Harmon County,2,179,74,105
Oklahoma,Harmon County,3,210,92,118
Oklahoma,Harmon County,4,172,79,93
Oklahoma,Harmon County,5,135,74,61
Oklahoma,Harmon County,6,141,69,72
Oklahoma,Harmon County,7,152,84,68
Oklahoma,Harmon County,8,162,76,86
Oklahoma,Harmon County,9,135,68,67
Oklahoma,Harmon County,10,151,70,81
Oklahoma,Harmon County,11,186,95,91
Oklahoma,Harmon County,12,175,87,88
Oklahoma,Harmon County,13,173,88,85
Oklahoma,Harmon County,14,160,78,82
Oklahoma,Harmon County,15,126,61,65
Oklahoma,Harmon County,16,86,41,45
Oklahoma,Harmon County,17,73,29,44
Oklahoma,Harmon County,18,80,23,57
Oklahoma,Harper County,0,3797,1898,1899
Oklahoma,Harper County,1,256,138,118
Oklahoma,Harper County,2,280,137,143
Oklahoma,Harper County,3,319,143,176
Oklahoma,Harper County,4,247,129,118
Oklahoma,Harper County,5,175,88,87
Oklahoma,Harper County,6,187,95,92
Oklahoma,Harper County,7,218,105,113
Oklahoma,Harper County,8,242,118,124
Oklahoma,Harper County,9,226,141,85
Oklahoma,Harper County,10,182,96,86
Oklahoma,Harper County,11,239,117,122
Oklahoma,Harper County,12,293,159,134
Oklahoma,Harper County,13,247,132,115
Oklahoma,Harper County,14,213,109,104
Oklahoma,Harper County,15,141,63,78
Oklahoma,Harper County,16,115,44,71
Oklahoma,Harper County,17,115,48,67
Oklahoma,Harper County,18,102,36,66
Oklahoma,Haskell County,0,12668,6331,6337
Oklahoma,Haskell County,1,764,397,367
Oklahoma,Haskell County,2,820,421,399
Oklahoma,Haskell County,3,861,465,396
Oklahoma,Haskell County,4,821,454,367
Oklahoma,Haskell County,5,668,360,308
Oklahoma,Haskell County,6,764,382,382
Oklahoma,Haskell County,7,674,326,348
Oklahoma,Haskell County,8,812,418,394
Oklahoma,Haskell County,9,713,362,351
Oklahoma,Haskell County,10,730,374,356
Oklahoma,Haskell County,11,742,360,382
Oklahoma,Haskell County,12,876,398,478
Oklahoma,Haskell County,13,853,398,455
Oklahoma,Haskell County,14,760,394,366
Oklahoma,Haskell County,15,696,321,375
Oklahoma,Haskell County,16,526,267,259
Oklahoma,Haskell County,17,305,137,168
Oklahoma,Haskell County,18,283,97,186
Oklahoma,Hughes County,0,13335,7182,6153
Oklahoma,Hughes County,1,808,427,381
Oklahoma,Hughes County,2,792,405,387
Oklahoma,Hughes County,3,794,429,365
Oklahoma,Hughes County,4,788,419,369
Oklahoma,Hughes County,5,865,509,356
Oklahoma,Hughes County,6,959,596,363
Oklahoma,Hughes County,7,874,579,295
Oklahoma,Hughes County,8,902,542,360
Oklahoma,Hughes County,9,779,465,314
Oklahoma,Hughes County,10,798,470,328
Oklahoma,Hughes County,11,806,417,389
Oklahoma,Hughes County,12,849,434,415
Oklahoma,Hughes County,13,812,395,417
Oklahoma,Hughes County,14,746,350,396
Oklahoma,Hughes County,15,671,301,370
Oklahoma,Hughes County,16,462,190,272
Oklahoma,Hughes County,17,309,134,175
Oklahoma,Hughes County,18,321,120,201
Oklahoma,Jackson County,0,24949,12392,12557
Oklahoma,Jackson County,1,1903,968,935
Oklahoma,Jackson County,2,1835,926,909
Oklahoma,Jackson County,3,1602,764,838
Oklahoma,Jackson County,4,1590,836,754
Oklahoma,Jackson County,5,1962,1084,878
Oklahoma,Jackson County,6,1856,999,857
Oklahoma,Jackson County,7,1897,967,930
Oklahoma,Jackson County,8,1625,804,821
Oklahoma,Jackson County,9,1334,678,656
Oklahoma,Jackson County,10,1294,603,691
Oklahoma,Jackson County,11,1396,672,724
Oklahoma,Jackson County,12,1527,734,793
Oklahoma,Jackson County,13,1427,714,713
Oklahoma,Jackson County,14,1092,500,592
Oklahoma,Jackson County,15,946,454,492
Oklahoma,Jackson County,16,687,302,385
Oklahoma,Jackson County,17,486,212,274
Oklahoma,Jackson County,18,490,175,315
Oklahoma,Jefferson County,0,6123,3062,3061
Oklahoma,Jefferson County,1,391,207,184
Oklahoma,Jefferson County,2,432,222,210
Oklahoma,Jefferson County,3,415,206,209
Oklahoma,Jefferson County,4,372,181,191
Oklahoma,Jefferson County,5,288,168,120
Oklahoma,Jefferson County,6,355,177,178
Oklahoma,Jefferson County,7,348,180,168
Oklahoma,Jefferson County,8,321,176,145
Oklahoma,Jefferson County,9,325,157,168
Oklahoma,Jefferson County,10,313,168,145
Oklahoma,Jefferson County,11,366,185,181
Oklahoma,Jefferson County,12,447,227,220
Oklahoma,Jefferson County,13,443,211,232
Oklahoma,Jefferson County,14,407,198,209
Oklahoma,Jefferson County,15,329,145,184
Oklahoma,Jefferson County,16,268,122,146
Oklahoma,Jefferson County,17,156,78,78
Oklahoma,Jefferson County,18,147,54,93
Oklahoma,Johnston County,0,10949,5416,5533
Oklahoma,Johnston County,1,665,355,310
Oklahoma,Johnston County,2,694,347,347
Oklahoma,Johnston County,3,782,398,384
Oklahoma,Johnston County,4,771,392,379
Oklahoma,Johnston County,5,648,329,319
Oklahoma,Johnston County,6,664,337,327
Oklahoma,Johnston County,7,617,281,336
Oklahoma,Johnston County,8,608,309,299
Oklahoma,Johnston County,9,655,351,304
Oklahoma,Johnston County,10,626,313,313
Oklahoma,Johnston County,11,654,329,325
Oklahoma,Johnston County,12,740,359,381
Oklahoma,Johnston County,13,696,318,378
Oklahoma,Johnston County,14,672,327,345
Oklahoma,Johnston County,15,566,275,291
Oklahoma,Johnston County,16,384,182,202
Oklahoma,Johnston County,17,303,134,169
Oklahoma,Johnston County,18,204,80,124
Oklahoma,Kay County,0,44161,21932,22229
Oklahoma,Kay County,1,3013,1543,1470
Oklahoma,Kay County,2,3113,1607,1506
Oklahoma,Kay County,3,3173,1622,1551
Oklahoma,Kay County,4,2954,1534,1420
Oklahoma,Kay County,5,2513,1312,1201
Oklahoma,Kay County,6,2849,1410,1439
Oklahoma,Kay County,7,2500,1274,1226
Oklahoma,Kay County,8,2614,1355,1259
Oklahoma,Kay County,9,2461,1268,1193
Oklahoma,Kay County,10,2260,1161,1099
Oklahoma,Kay County,11,2478,1282,1196
Oklahoma,Kay County,12,2868,1419,1449
Oklahoma,Kay County,13,2826,1379,1447
Oklahoma,Kay County,14,2510,1152,1358
Oklahoma,Kay County,15,2122,1010,1112
Oklahoma,Kay County,16,1613,707,906
Oklahoma,Kay County,17,1111,482,629
Oklahoma,Kay County,18,1183,415,768
Oklahoma,Kingfisher County,0,15816,7878,7938
Oklahoma,Kingfisher County,1,1079,545,534
Oklahoma,Kingfisher County,2,1252,634,618
Oklahoma,Kingfisher County,3,1200,612,588
Oklahoma,Kingfisher County,4,1168,636,532
Oklahoma,Kingfisher County,5,857,427,430
Oklahoma,Kingfisher County,6,897,448,449
Oklahoma,Kingfisher County,7,964,500,464
Oklahoma,Kingfisher County,8,1040,500,540
Oklahoma,Kingfisher County,9,868,429,439
Oklahoma,Kingfisher County,10,924,484,440
Oklahoma,Kingfisher County,11,950,479,471
Oklahoma,Kingfisher County,12,1123,578,545
Oklahoma,Kingfisher County,13,971,470,501
Oklahoma,Kingfisher County,14,794,400,394
Oklahoma,Kingfisher County,15,587,260,327
Oklahoma,Kingfisher County,16,458,210,248
Oklahoma,Kingfisher County,17,352,152,200
Oklahoma,Kingfisher County,18,332,114,218
Oklahoma,Kiowa County,0,8729,4338,4391
Oklahoma,Kiowa County,1,538,272,266
Oklahoma,Kiowa County,2,576,297,279
Oklahoma,Kiowa County,3,579,278,301
Oklahoma,Kiowa County,4,558,295,263
Oklahoma,Kiowa County,5,470,250,220
Oklahoma,Kiowa County,6,503,247,256
Oklahoma,Kiowa County,7,457,231,226
Oklahoma,Kiowa County,8,494,246,248
Oklahoma,Kiowa County,9,459,248,211
Oklahoma,Kiowa County,10,450,223,227
Oklahoma,Kiowa County,11,593,292,301
Oklahoma,Kiowa County,12,653,334,319
Oklahoma,Kiowa County,13,670,319,351
Oklahoma,Kiowa County,14,530,269,261
Oklahoma,Kiowa County,15,443,199,244
Oklahoma,Kiowa County,16,356,174,182
Oklahoma,Kiowa County,17,234,106,128
Oklahoma,Kiowa County,18,166,58,108
Oklahoma,Latimer County,0,10231,5187,5044
Oklahoma,Latimer County,1,601,296,305
Oklahoma,Latimer County,2,592,302,290
Oklahoma,Latimer County,3,598,304,294
Oklahoma,Latimer County,4,752,406,346
Oklahoma,Latimer County,5,657,348,309
Oklahoma,Latimer County,6,626,299,327
Oklahoma,Latimer County,7,505,248,257
Oklahoma,Latimer County,8,586,301,285
Oklahoma,Latimer County,9,461,241,220
Oklahoma,Latimer County,10,575,280,295
Oklahoma,Latimer County,11,615,304,311
Oklahoma,Latimer County,12,714,359,355
Oklahoma,Latimer County,13,679,338,341
Oklahoma,Latimer County,14,596,301,295
Oklahoma,Latimer County,15,561,286,275
Oklahoma,Latimer County,16,454,232,222
Oklahoma,Latimer County,17,308,161,147
Oklahoma,Latimer County,18,351,181,170
Oklahoma,Le Flore County,0,49980,25125,24855
Oklahoma,Le Flore County,1,3202,1649,1553
Oklahoma,Le Flore County,2,3093,1585,1508
Oklahoma,Le Flore County,3,3533,1826,1707
Oklahoma,Le Flore County,4,3421,1815,1606
Oklahoma,Le Flore County,5,2871,1498,1373
Oklahoma,Le Flore County,6,3250,1677,1573
Oklahoma,Le Flore County,7,2870,1490,1380
Oklahoma,Le Flore County,8,3074,1542,1532
Oklahoma,Le Flore County,9,2881,1566,1315
Oklahoma,Le Flore County,10,3051,1577,1474
Oklahoma,Le Flore County,11,3114,1575,1539
Oklahoma,Le Flore County,12,3412,1653,1759
Oklahoma,Le Flore County,13,3170,1513,1657
Oklahoma,Le Flore County,14,2916,1416,1500
Oklahoma,Le Flore County,15,2367,1136,1231
Oklahoma,Le Flore County,16,1705,776,929
Oklahoma,Le Flore County,17,1074,464,610
Oklahoma,Le Flore County,18,976,367,609
Oklahoma,Lincoln County,0,34920,17388,17532
Oklahoma,Lincoln County,1,2057,1008,1049
Oklahoma,Lincoln County,2,2278,1193,1085
Oklahoma,Lincoln County,3,2484,1279,1205
Oklahoma,Lincoln County,4,2286,1160,1126
Oklahoma,Lincoln County,5,1822,965,857
Oklahoma,Lincoln County,6,2089,1055,1034
Oklahoma,Lincoln County,7,1891,909,982
Oklahoma,Lincoln County,8,2070,1042,1028
Oklahoma,Lincoln County,9,1925,944,981
Oklahoma,Lincoln County,10,2146,1096,1050
Oklahoma,Lincoln County,11,2319,1176,1143
Oklahoma,Lincoln County,12,2625,1298,1327
Oklahoma,Lincoln County,13,2528,1268,1260
Oklahoma,Lincoln County,14,1998,981,1017
Oklahoma,Lincoln County,15,1678,786,892
Oklahoma,Lincoln County,16,1230,552,678
Oklahoma,Lincoln County,17,805,385,420
Oklahoma,Lincoln County,18,689,291,398
Oklahoma,Logan County,0,47291,23438,23853
Oklahoma,Logan County,1,2749,1422,1327
Oklahoma,Logan County,2,2931,1475,1456
Oklahoma,Logan County,3,3219,1667,1552
Oklahoma,Logan County,4,3846,1932,1914
Oklahoma,Logan County,5,3074,1595,1479
Oklahoma,Logan County,6,2496,1254,1242
Oklahoma,Logan County,7,2795,1386,1409
Oklahoma,Logan County,8,3185,1550,1635
Oklahoma,Logan County,9,2925,1513,1412
Oklahoma,Logan County,10,2997,1444,1553
Oklahoma,Logan County,11,2902,1410,1492
Oklahoma,Logan County,12,3466,1676,1790
Oklahoma,Logan County,13,3245,1525,1720
Oklahoma,Logan County,14,2562,1246,1316
Oklahoma,Logan County,15,1911,969,942
Oklahoma,Logan County,16,1347,677,670
Oklahoma,Logan County,17,844,382,462
Oklahoma,Logan County,18,797,315,482
Oklahoma,Love County,0,10134,5052,5082
Oklahoma,Love County,1,648,341,307
Oklahoma,Love County,2,706,354,352
Oklahoma,Love County,3,702,333,369
Oklahoma,Love County,4,646,311,335
Oklahoma,Love County,5,599,293,306
Oklahoma,Love County,6,678,352,326
Oklahoma,Love County,7,599,313,286
Oklahoma,Love County,8,605,301,304
Oklahoma,Love County,9,534,273,261
Oklahoma,Love County,10,603,300,303
Oklahoma,Love County,11,578,285,293
Oklahoma,Love County,12,666,327,339
Oklahoma,Love County,13,635,316,319
Oklahoma,Love County,14,599,306,293
Oklahoma,Love County,15,527,269,258
Oklahoma,Love County,16,388,193,195
Oklahoma,Love County,17,227,112,115
Oklahoma,Love County,18,194,73,121
Oklahoma,McClain County,0,39985,19844,20141
Oklahoma,McClain County,1,2385,1253,1132
Oklahoma,McClain County,2,2843,1492,1351
Oklahoma,McClain County,3,3193,1592,1601
Oklahoma,McClain County,4,2715,1418,1297
Oklahoma,McClain County,5,2157,1138,1019
Oklahoma,McClain County,6,2191,1030,1161
Oklahoma,McClain County,7,2463,1199,1264
Oklahoma,McClain County,8,2825,1388,1437
Oklahoma,McClain County,9,2669,1319,1350
Oklahoma,McClain County,10,2503,1253,1250
Oklahoma,McClain County,11,2478,1244,1234
Oklahoma,McClain County,12,2857,1419,1438
Oklahoma,McClain County,13,2512,1204,1308
Oklahoma,McClain County,14,2093,1015,1078
Oklahoma,McClain County,15,1610,769,841
Oklahoma,McClain County,16,1197,548,649
Oklahoma,McClain County,17,730,340,390
Oklahoma,McClain County,18,564,223,341
Oklahoma,McCurtain County,0,32703,16071,16632
Oklahoma,McCurtain County,1,2269,1192,1077
Oklahoma,McCurtain County,2,2336,1153,1183
Oklahoma,McCurtain County,3,2293,1192,1101
Oklahoma,McCurtain County,4,2103,1067,1036
Oklahoma,McCurtain County,5,1941,1001,940
Oklahoma,McCurtain County,6,2173,1096,1077
Oklahoma,McCurtain County,7,1808,902,906
Oklahoma,McCurtain County,8,1863,914,949
Oklahoma,McCurtain County,9,1789,865,924
Oklahoma,McCurtain County,10,1968,955,1013
Oklahoma,McCurtain County,11,2020,1005,1015
Oklahoma,McCurtain County,12,2116,1057,1059
Oklahoma,McCurtain County,13,2063,945,1118
Oklahoma,McCurtain County,14,1809,857,952
Oklahoma,McCurtain County,15,1555,724,831
Oklahoma,McCurtain County,16,1175,575,600
Oklahoma,McCurtain County,17,748,325,423
Oklahoma,McCurtain County,18,674,246,428
Oklahoma,McIntosh County,0,19815,9788,10027
Oklahoma,McIntosh County,1,1111,583,528
Oklahoma,McIntosh County,2,1054,546,508
Oklahoma,McIntosh County,3,1117,589,528
Oklahoma,McIntosh County,4,1117,598,519
Oklahoma,McIntosh County,5,984,505,479
Oklahoma,McIntosh County,6,988,489,499
Oklahoma,McIntosh County,7,938,455,483
Oklahoma,McIntosh County,8,1042,513,529
Oklahoma,McIntosh County,9,986,474,512
Oklahoma,McIntosh County,10,1163,542,621
Oklahoma,McIntosh County,11,1189,604,585
Oklahoma,McIntosh County,12,1547,756,791
Oklahoma,McIntosh County,13,1575,753,822
Oklahoma,McIntosh County,14,1464,690,774
Oklahoma,McIntosh County,15,1308,649,659
Oklahoma,McIntosh County,16,1059,523,536
Oklahoma,McIntosh County,17,609,303,306
Oklahoma,McIntosh County,18,564,216,348
Oklahoma,Major County,0,7644,3744,3900
Oklahoma,Major County,1,503,235,268
Oklahoma,Major County,2,554,292,262
Oklahoma,Major County,3,559,268,291
Oklahoma,Major County,4,481,236,245
Oklahoma,Major County,5,345,175,170
Oklahoma,Major County,6,394,204,190
Oklahoma,Major County,7,405,205,200
Oklahoma,Major County,8,490,244,246
Oklahoma,Major County,9,390,209,181
Oklahoma,Major County,10,422,201,221
Oklahoma,Major County,11,422,201,221
Oklahoma,Major County,12,545,297,248
Oklahoma,Major County,13,534,265,269
Oklahoma,Major County,14,457,224,233
Oklahoma,Major County,15,379,180,199
Oklahoma,Major County,16,286,118,168
Oklahoma,Major County,17,265,115,150
Oklahoma,Major County,18,213,75,138
Oklahoma,Marshall County,0,16806,8230,8576
Oklahoma,Marshall County,1,995,477,518
Oklahoma,Marshall County,2,1072,542,530
Oklahoma,Marshall County,3,1140,564,576
Oklahoma,Marshall County,4,1050,562,488
Oklahoma,Marshall County,5,921,485,436
Oklahoma,Marshall County,6,890,453,437
Oklahoma,Marshall County,7,812,380,432
Oklahoma,Marshall County,8,930,460,470
Oklahoma,Marshall County,9,964,460,504
Oklahoma,Marshall County,10,965,456,509
Oklahoma,Marshall County,11,1026,510,516
Oklahoma,Marshall County,12,1190,564,626
Oklahoma,Marshall County,13,1201,595,606
Oklahoma,Marshall County,14,1028,487,541
Oklahoma,Marshall County,15,975,468,507
Oklahoma,Marshall County,16,748,377,371
Oklahoma,Marshall County,17,494,224,270
Oklahoma,Marshall County,18,405,166,239
Oklahoma,Mayes County,0,41107,20539,20568
Oklahoma,Mayes County,1,2442,1271,1171
Oklahoma,Mayes County,2,2636,1361,1275
Oklahoma,Mayes County,3,2810,1452,1358
Oklahoma,Mayes County,4,2692,1419,1273
Oklahoma,Mayes County,5,2358,1224,1134
Oklahoma,Mayes County,6,2613,1305,1308
Oklahoma,Mayes County,7,2292,1107,1185
Oklahoma,Mayes County,8,2504,1269,1235
Oklahoma,Mayes County,9,2412,1214,1198
Oklahoma,Mayes County,10,2510,1302,1208
Oklahoma,Mayes County,11,2575,1325,1250
Oklahoma,Mayes County,12,2848,1384,1464
Oklahoma,Mayes County,13,2839,1425,1414
Oklahoma,Mayes County,14,2402,1140,1262
Oklahoma,Mayes County,15,2066,990,1076
Oklahoma,Mayes County,16,1498,709,789
Oklahoma,Mayes County,17,907,375,532
Oklahoma,Mayes County,18,703,267,436
Oklahoma,Murray County,0,13953,7014,6939
Oklahoma,Murray County,1,775,413,362
Oklahoma,Murray County,2,892,477,415
Oklahoma,Murray County,3,975,500,475
Oklahoma,Murray County,4,899,501,398
Oklahoma,Murray County,5,718,389,329
Oklahoma,Murray County,6,788,358,430
Oklahoma,Murray County,7,793,412,381
Oklahoma,Murray County,8,876,426,450
Oklahoma,Murray County,9,725,353,372
Oklahoma,Murray County,10,925,477,448
Oklahoma,Murray County,11,831,394,437
Oklahoma,Murray County,12,1007,512,495
Oklahoma,Murray County,13,995,498,497
Oklahoma,Murray County,14,827,388,439
Oklahoma,Murray County,15,727,363,364
Oklahoma,Murray County,16,539,254,285
Oklahoma,Murray County,17,358,168,190
Oklahoma,Murray County,18,303,131,172
Oklahoma,Muskogee County,0,68362,33301,35061
Oklahoma,Muskogee County,1,4471,2288,2183
Oklahoma,Muskogee County,2,4665,2331,2334
Oklahoma,Muskogee County,3,4748,2424,2324
Oklahoma,Muskogee County,4,4612,2412,2200
Oklahoma,Muskogee County,5,4326,2243,2083
Oklahoma,Muskogee County,6,4519,2255,2264
Oklahoma,Muskogee County,7,4288,2055,2233
Oklahoma,Muskogee County,8,4393,2114,2279
Oklahoma,Muskogee County,9,3991,1976,2015
Oklahoma,Muskogee County,10,4034,1972,2062
Oklahoma,Muskogee County,11,3998,1991,2007
Oklahoma,Muskogee County,12,4502,2197,2305
Oklahoma,Muskogee County,13,4382,2056,2326
Oklahoma,Muskogee County,14,3686,1712,1974
Oklahoma,Muskogee County,15,2882,1369,1513
Oklahoma,Muskogee County,16,2082,863,1219
Oklahoma,Muskogee County,17,1398,569,829
Oklahoma,Muskogee County,18,1385,474,911
Oklahoma,Noble County,0,11289,5610,5679
Oklahoma,Noble County,1,682,351,331
Oklahoma,Noble County,2,749,384,365
Oklahoma,Noble County,3,747,373,374
Oklahoma,Noble County,4,725,403,322
Oklahoma,Noble County,5,576,294,282
Oklahoma,Noble County,6,657,327,330
Oklahoma,Noble County,7,668,327,341
Oklahoma,Noble County,8,669,345,324
Oklahoma,Noble County,9,615,303,312
Oklahoma,Noble County,10,683,336,347
Oklahoma,Noble County,11,739,383,356
Oklahoma,Noble County,12,806,405,401
Oklahoma,Noble County,13,786,390,396
Oklahoma,Noble County,14,679,349,330
Oklahoma,Noble County,15,536,237,299
Oklahoma,Noble County,16,419,187,232
Oklahoma,Noble County,17,284,125,159
Oklahoma,Noble County,18,269,91,178
Oklahoma,Nowata County,0,10218,5095,5123
Oklahoma,Nowata County,1,604,313,291
Oklahoma,Nowata County,2,652,336,316
Oklahoma,Nowata County,3,647,321,326
Oklahoma,Nowata County,4,634,335,299
Oklahoma,Nowata County,5,536,287,249
Oklahoma,Nowata County,6,631,299,332
Oklahoma,Nowata County,7,598,316,282
Oklahoma,Nowata County,8,602,310,292
Oklahoma,Nowata County,9,555,286,269
Oklahoma,Nowata County,10,630,322,308
Oklahoma,Nowata County,11,657,321,336
Oklahoma,Nowata County,12,775,388,387
Oklahoma,Nowata County,13,735,366,369
Oklahoma,Nowata County,14,578,264,314
Oklahoma,Nowata County,15,495,229,266
Oklahoma,Nowata County,16,416,194,222
Oklahoma,Nowata County,17,236,105,131
Oklahoma,Nowata County,18,237,103,134
Oklahoma,Okfuskee County,0,12098,6523,5575
Oklahoma,Okfuskee County,1,683,344,339
Oklahoma,Okfuskee County,2,808,421,387
Oklahoma,Okfuskee County,3,807,410,397
Oklahoma,Okfuskee County,4,717,387,330
Oklahoma,Okfuskee County,5,704,391,313
Oklahoma,Okfuskee County,6,807,472,335
Oklahoma,Okfuskee County,7,754,456,298
Oklahoma,Okfuskee County,8,779,459,320
Oklahoma,Okfuskee County,9,733,429,304
Oklahoma,Okfuskee County,10,809,450,359
Oklahoma,Okfuskee County,11,765,432,333
Oklahoma,Okfuskee County,12,819,451,368
Oklahoma,Okfuskee County,13,769,407,362
Oklahoma,Okfuskee County,14,645,307,338
Oklahoma,Okfuskee County,15,575,287,288
Oklahoma,Okfuskee County,16,440,222,218
Oklahoma,Okfuskee County,17,248,107,141
Oklahoma,Okfuskee County,18,236,91,145
Oklahoma,Oklahoma County,0,792582,388135,404447
Oklahoma,Oklahoma County,1,59329,30228,29101
Oklahoma,Oklahoma County,2,57972,29763,28209
Oklahoma,Oklahoma County,3,55075,28121,26954
Oklahoma,Oklahoma County,4,50152,25588,24564
Oklahoma,Oklahoma County,5,52298,26491,25807
Oklahoma,Oklahoma County,6,63770,31498,32272
Oklahoma,Oklahoma County,7,59717,29836,29881
Oklahoma,Oklahoma County,8,55544,27634,27910
Oklahoma,Oklahoma County,9,46895,23021,23874
Oklahoma,Oklahoma County,10,45685,22598,23087
Oklahoma,Oklahoma County,11,43944,21442,22502
Oklahoma,Oklahoma County,12,48594,23274,25320
Oklahoma,Oklahoma County,13,45289,21483,23806
Oklahoma,Oklahoma County,14,36737,17139,19598
Oklahoma,Oklahoma County,15,27619,12649,14970
Oklahoma,Oklahoma County,16,18397,7859,10538
Oklahoma,Oklahoma County,17,12462,5021,7441
Oklahoma,Oklahoma County,18,13103,4490,8613
Oklahoma,Okmulgee County,0,38335,18967,19368
Oklahoma,Okmulgee County,1,2295,1221,1074
Oklahoma,Okmulgee County,2,2522,1330,1192
Oklahoma,Okmulgee County,3,2596,1296,1300
Oklahoma,Okmulgee County,4,2733,1442,1291
Oklahoma,Okmulgee County,5,2472,1390,1082
Oklahoma,Okmulgee County,6,2435,1264,1171
Oklahoma,Okmulgee County,7,2150,1075,1075
Oklahoma,Okmulgee County,8,2249,1121,1128
Oklahoma,Okmulgee County,9,2018,967,1051
Oklahoma,Okmulgee County,10,2206,1136,1070
Oklahoma,Okmulgee County,11,2257,1104,1153
Oklahoma,Okmulgee County,12,2676,1288,1388
Oklahoma,Okmulgee County,13,2485,1174,1311
Oklahoma,Okmulgee County,14,2274,1054,1220
Oklahoma,Okmulgee County,15,1800,804,996
Oklahoma,Okmulgee County,16,1373,598,775
Oklahoma,Okmulgee County,17,914,390,524
Oklahoma,Okmulgee County,18,880,313,567
Oklahoma,Osage County,0,47014,23567,23447
Oklahoma,Osage County,1,2339,1208,1131
Oklahoma,Osage County,2,2882,1428,1454
Oklahoma,Osage County,3,3068,1578,1490
Oklahoma,Osage County,4,2978,1577,1401
Oklahoma,Osage County,5,2475,1328,1147
Oklahoma,Osage County,6,2761,1483,1278
Oklahoma,Osage County,7,2669,1417,1252
Oklahoma,Osage County,8,2797,1442,1355
Oklahoma,Osage County,9,2609,1315,1294
Oklahoma,Osage County,10,2823,1418,1405
Oklahoma,Osage County,11,3148,1575,1573
Oklahoma,Osage County,12,3574,1749,1825
Oklahoma,Osage County,13,3505,1706,1799
Oklahoma,Osage County,14,2983,1405,1578
Oklahoma,Osage County,15,2511,1135,1376
Oklahoma,Osage County,16,1722,853,869
Oklahoma,Osage County,17,1193,546,647
Oklahoma,Osage County,18,977,404,573
Oklahoma,Ottawa County,0,31175,15313,15862
Oklahoma,Ottawa County,1,2002,1026,976
Oklahoma,Ottawa County,2,2193,1144,1049
Oklahoma,Ottawa County,3,2151,1119,1032
Oklahoma,Ottawa County,4,2315,1205,1110
Oklahoma,Ottawa County,5,2045,1102,943
Oklahoma,Ottawa County,6,2049,984,1065
Oklahoma,Ottawa County,7,1667,804,863
Oklahoma,Ottawa County,8,1768,850,918
Oklahoma,Ottawa County,9,1686,842,844
Oklahoma,Ottawa County,10,1811,928,883
Oklahoma,Ottawa County,11,1810,868,942
Oklahoma,Ottawa County,12,1989,975,1014
Oklahoma,Ottawa County,13,1969,923,1046
Oklahoma,Ottawa County,14,1693,806,887
Oklahoma,Ottawa County,15,1536,724,812
Oklahoma,Ottawa County,16,1081,473,608
Oklahoma,Ottawa County,17,724,310,414
Oklahoma,Ottawa County,18,686,230,456
Oklahoma,Pawnee County,0,16390,8125,8265
Oklahoma,Pawnee County,1,965,473,492
Oklahoma,Pawnee County,2,1065,574,491
Oklahoma,Pawnee County,3,1158,583,575
Oklahoma,Pawnee County,4,1073,553,520
Oklahoma,Pawnee County,5,848,428,420
Oklahoma,Pawnee County,6,919,472,447
Oklahoma,Pawnee County,7,879,446,433
Oklahoma,Pawnee County,8,941,459,482
Oklahoma,Pawnee County,9,951,481,470
Oklahoma,Pawnee County,10,1028,510,518
Oklahoma,Pawnee County,11,1093,553,540
Oklahoma,Pawnee County,12,1105,563,542
Oklahoma,Pawnee County,13,1201,565,636
Oklahoma,Pawnee County,14,1002,483,519
Oklahoma,Pawnee County,15,795,371,424
Oklahoma,Pawnee County,16,672,301,371
Oklahoma,Pawnee County,17,359,174,185
Oklahoma,Pawnee County,18,336,136,200
Oklahoma,Payne County,0,82040,41905,40135
Oklahoma,Payne County,1,4324,2171,2153
Oklahoma,Payne County,2,4432,2244,2188
Oklahoma,Payne County,3,4473,2362,2111
Oklahoma,Payne County,4,7835,3907,3928
Oklahoma,Payne County,5,16610,9183,7427
Oklahoma,Payne County,6,6328,3465,2863
Oklahoma,Payne County,7,4729,2454,2275
Oklahoma,Payne County,8,4647,2359,2288
Oklahoma,Payne County,9,3818,2000,1818
Oklahoma,Payne County,10,3495,1793,1702
Oklahoma,Payne County,11,3372,1639,1733
Oklahoma,Payne County,12,3924,1888,2036
Oklahoma,Payne County,13,3745,1808,1937
Oklahoma,Payne County,14,3216,1533,1683
Oklahoma,Payne County,15,2603,1202,1401
Oklahoma,Payne County,16,1868,806,1062
Oklahoma,Payne County,17,1266,545,721
Oklahoma,Payne County,18,1355,546,809
Oklahoma,Pittsburg County,0,43877,22362,21515
Oklahoma,Pittsburg County,1,2574,1320,1254
Oklahoma,Pittsburg County,2,2730,1415,1315
Oklahoma,Pittsburg County,3,2839,1474,1365
Oklahoma,Pittsburg County,4,2480,1281,1199
Oklahoma,Pittsburg County,5,2422,1310,1112
Oklahoma,Pittsburg County,6,2982,1656,1326
Oklahoma,Pittsburg County,7,2780,1553,1227
Oklahoma,Pittsburg County,8,2805,1504,1301
Oklahoma,Pittsburg County,9,2499,1355,1144
Oklahoma,Pittsburg County,10,2495,1312,1183
Oklahoma,Pittsburg County,11,2693,1406,1287
Oklahoma,Pittsburg County,12,3019,1481,1538
Oklahoma,Pittsburg County,13,2769,1308,1461
Oklahoma,Pittsburg County,14,2637,1286,1351
Oklahoma,Pittsburg County,15,2280,1062,1218
Oklahoma,Pittsburg County,16,1706,763,943
Oklahoma,Pittsburg County,17,1118,467,651
Oklahoma,Pittsburg County,18,1049,409,640
Oklahoma,Pontotoc County,0,38247,18570,19677
Oklahoma,Pontotoc County,1,2612,1317,1295
Oklahoma,Pontotoc County,2,2663,1343,1320
Oklahoma,Pontotoc County,3,2494,1231,1263
Oklahoma,Pontotoc County,4,2753,1396,1357
Oklahoma,Pontotoc County,5,2884,1438,1446
Oklahoma,Pontotoc County,6,2852,1381,1471
Oklahoma,Pontotoc County,7,2553,1322,1231
Oklahoma,Pontotoc County,8,2302,1162,1140
Oklahoma,Pontotoc County,9,2085,1005,1080
Oklahoma,Pontotoc County,10,2053,1028,1025
Oklahoma,Pontotoc County,11,2084,1029,1055
Oklahoma,Pontotoc County,12,2467,1186,1281
Oklahoma,Pontotoc County,13,2129,983,1146
Oklahoma,Pontotoc County,14,1872,868,1004
Oklahoma,Pontotoc County,15,1613,733,880
Oklahoma,Pontotoc County,16,1179,519,660
Oklahoma,Pontotoc County,17,816,332,484
Oklahoma,Pontotoc County,18,836,297,539
Oklahoma,Pottawatomie County,0,72679,34813,37866
Oklahoma,Pottawatomie County,1,4387,2260,2127
Oklahoma,Pottawatomie County,2,4883,2437,2446
Oklahoma,Pottawatomie County,3,4906,2497,2409
Oklahoma,Pottawatomie County,4,5189,2618,2571
Oklahoma,Pottawatomie County,5,4814,2343,2471
Oklahoma,Pottawatomie County,6,4836,2314,2522
Oklahoma,Pottawatomie County,7,4504,2140,2364
Oklahoma,Pottawatomie County,8,4659,2121,2538
Oklahoma,Pottawatomie County,9,4422,2113,2309
Oklahoma,Pottawatomie County,10,4512,2121,2391
Oklahoma,Pottawatomie County,11,4399,2132,2267
Oklahoma,Pottawatomie County,12,4852,2317,2535
Oklahoma,Pottawatomie County,13,4462,2111,2351
Oklahoma,Pottawatomie County,14,3756,1743,2013
Oklahoma,Pottawatomie County,15,3127,1443,1684
Oklahoma,Pottawatomie County,16,2215,1023,1192
Oklahoma,Pottawatomie County,17,1445,608,837
Oklahoma,Pottawatomie County,18,1311,472,839
Oklahoma,Pushmataha County,0,11179,5489,5690
Oklahoma,Pushmataha County,1,676,343,333
Oklahoma,Pushmataha County,2,684,331,353
Oklahoma,Pushmataha County,3,700,372,328
Oklahoma,Pushmataha County,4,655,336,319
Oklahoma,Pushmataha County,5,549,275,274
Oklahoma,Pushmataha County,6,617,297,320
Oklahoma,Pushmataha County,7,633,319,314
Oklahoma,Pushmataha County,8,636,344,292
Oklahoma,Pushmataha County,9,548,269,279
Oklahoma,Pushmataha County,10,622,305,317
Oklahoma,Pushmataha County,11,749,351,398
Oklahoma,Pushmataha County,12,815,417,398
Oklahoma,Pushmataha County,13,723,357,366
Oklahoma,Pushmataha County,14,758,347,411
Oklahoma,Pushmataha County,15,664,305,359
Oklahoma,Pushmataha County,16,511,243,268
Oklahoma,Pushmataha County,17,333,152,181
Oklahoma,Pushmataha County,18,306,126,180
Oklahoma,Roger Mills County,0,3656,1817,1839
Oklahoma,Roger Mills County,1,242,121,121
Oklahoma,Roger Mills County,2,231,116,115
Oklahoma,Roger Mills County,3,293,140,153
Oklahoma,Roger Mills County,4,232,117,115
Oklahoma,Roger Mills County,5,177,97,80
Oklahoma,Roger Mills County,6,167,78,89
Oklahoma,Roger Mills County,7,180,90,90
Oklahoma,Roger Mills County,8,248,119,129
Oklahoma,Roger Mills County,9,196,112,84
Oklahoma,Roger Mills County,10,194,105,89
Oklahoma,Roger Mills County,11,215,111,104
Oklahoma,Roger Mills County,12,256,126,130
Oklahoma,Roger Mills County,13,265,139,126
Oklahoma,Roger Mills County,14,224,110,114
Oklahoma,Roger Mills County,15,182,86,96
Oklahoma,Roger Mills County,16,144,62,82
Oklahoma,Roger Mills County,17,112,44,68
Oklahoma,Roger Mills County,18,98,44,54
Oklahoma,Rogers County,0,91984,45861,46123
Oklahoma,Rogers County,1,5355,2776,2579
Oklahoma,Rogers County,2,5808,3000,2808
Oklahoma,Rogers County,3,6321,3241,3080
Oklahoma,Rogers County,4,6325,3264,3061
Oklahoma,Rogers County,5,5667,2915,2752
Oklahoma,Rogers County,6,5928,3041,2887
Oklahoma,Rogers County,7,5556,2721,2835
Oklahoma,Rogers County,8,5801,2905,2896
Oklahoma,Rogers County,9,5370,2671,2699
Oklahoma,Rogers County,10,6074,3042,3032
Oklahoma,Rogers County,11,6108,2993,3115
Oklahoma,Rogers County,12,6666,3307,3359
Oklahoma,Rogers County,13,5924,2940,2984
Oklahoma,Rogers County,14,4867,2342,2525
Oklahoma,Rogers County,15,3947,1858,2089
Oklahoma,Rogers County,16,2789,1327,1462
Oklahoma,Rogers County,17,1903,858,1045
Oklahoma,Rogers County,18,1575,660,915
Oklahoma,Seminole County,0,24578,12057,12521
Oklahoma,Seminole County,1,1600,813,787
Oklahoma,Seminole County,2,1677,872,805
Oklahoma,Seminole County,3,1722,894,828
Oklahoma,Seminole County,4,1844,917,927
Oklahoma,Seminole County,5,1495,776,719
Oklahoma,Seminole County,6,1423,734,689
Oklahoma,Seminole County,7,1301,666,635
Oklahoma,Seminole County,8,1471,673,798
Oklahoma,Seminole County,9,1381,661,720
Oklahoma,Seminole County,10,1389,680,709
Oklahoma,Seminole County,11,1544,760,784
Oklahoma,Seminole County,12,1695,832,863
Oklahoma,Seminole County,13,1604,785,819
Oklahoma,Seminole County,14,1355,657,698
Oklahoma,Seminole County,15,1111,516,595
Oklahoma,Seminole County,16,884,383,501
Oklahoma,Seminole County,17,589,275,314
Oklahoma,Seminole County,18,493,163,330
Oklahoma,Sequoyah County,0,41179,20267,20912
Oklahoma,Sequoyah County,1,2581,1285,1296
Oklahoma,Sequoyah County,2,2396,1244,1152
Oklahoma,Sequoyah County,3,2734,1410,1324
Oklahoma,Sequoyah County,4,2689,1391,1298
Oklahoma,Sequoyah County,5,2418,1289,1129
Oklahoma,Sequoyah County,6,2559,1266,1293
Oklahoma,Sequoyah County,7,2282,1128,1154
Oklahoma,Sequoyah County,8,2349,1159,1190
Oklahoma,Sequoyah County,9,2453,1211,1242
Oklahoma,Sequoyah County,10,2656,1262,1394
Oklahoma,Sequoyah County,11,2754,1373,1381
Oklahoma,Sequoyah County,12,2959,1469,1490
Oklahoma,Sequoyah County,13,2547,1205,1342
Oklahoma,Sequoyah County,14,2456,1145,1311
Oklahoma,Sequoyah County,15,2066,996,1070
Oklahoma,Sequoyah County,16,1526,666,860
Oklahoma,Sequoyah County,17,984,444,540
Oklahoma,Sequoyah County,18,770,324,446
Oklahoma,Stephens County,0,43265,20912,22353
Oklahoma,Stephens County,1,2567,1303,1264
Oklahoma,Stephens County,2,2697,1334,1363
Oklahoma,Stephens County,3,2930,1456,1474
Oklahoma,Stephens County,4,2770,1440,1330
Oklahoma,Stephens County,5,2300,1102,1198
Oklahoma,Stephens County,6,2555,1261,1294
Oklahoma,Stephens County,7,2479,1248,1231
Oklahoma,Stephens County,8,2641,1287,1354
Oklahoma,Stephens County,9,2441,1220,1221
Oklahoma,Stephens County,10,2404,1195,1209
Oklahoma,Stephens County,11,2630,1249,1381
Oklahoma,Stephens County,12,3116,1511,1605
Oklahoma,Stephens County,13,3103,1489,1614
Oklahoma,Stephens County,14,2678,1255,1423
Oklahoma,Stephens County,15,2092,960,1132
Oklahoma,Stephens County,16,1597,696,901
Oklahoma,Stephens County,17,1144,499,645
Oklahoma,Stephens County,18,1121,407,714
Oklahoma,Texas County,0,20455,10943,9512
Oklahoma,Texas County,1,1726,918,808
Oklahoma,Texas County,2,1513,778,735
Oklahoma,Texas County,3,1526,753,773
Oklahoma,Texas County,4,1641,911,730
Oklahoma,Texas County,5,1563,877,686
Oklahoma,Texas County,6,1458,865,593
Oklahoma,Texas County,7,1426,799,627
Oklahoma,Texas County,8,1366,770,596
Oklahoma,Texas County,9,1252,687,565
Oklahoma,Texas County,10,1244,649,595
Oklahoma,Texas County,11,1145,610,535
Oklahoma,Texas County,12,1129,615,514
Oklahoma,Texas County,13,1069,558,511
Oklahoma,Texas County,14,793,397,396
Oklahoma,Texas County,15,596,308,288
Oklahoma,Texas County,16,418,200,218
Oklahoma,Texas County,17,307,141,166
Oklahoma,Texas County,18,283,107,176
Oklahoma,Tillman County,0,7348,3706,3642
Oklahoma,Tillman County,1,427,206,221
Oklahoma,Tillman County,2,472,201,271
Oklahoma,Tillman County,3,519,276,243
Oklahoma,Tillman County,4,462,247,215
Oklahoma,Tillman County,5,398,222,176
Oklahoma,Tillman County,6,414,232,182
Oklahoma,Tillman County,7,402,196,206
Oklahoma,Tillman County,8,430,241,189
Oklahoma,Tillman County,9,385,200,185
Oklahoma,Tillman County,10,461,239,222
Oklahoma,Tillman County,11,460,237,223
Oklahoma,Tillman County,12,556,277,279
Oklahoma,Tillman County,13,493,246,247
Oklahoma,Tillman County,14,431,216,215
Oklahoma,Tillman County,15,395,196,199
Oklahoma,Tillman County,16,278,122,156
Oklahoma,Tillman County,17,204,89,115
Oklahoma,Tillman County,18,161,63,98
Oklahoma,Tulsa County,0,648360,316369,331991
Oklahoma,Tulsa County,1,46314,23911,22403
Oklahoma,Tulsa County,2,45924,23394,22530
Oklahoma,Tulsa County,3,45417,23178,22239
Oklahoma,Tulsa County,4,42259,21637,20622
Oklahoma,Tulsa County,5,41251,20606,20645
Oklahoma,Tulsa County,6,49156,24468,24688
Oklahoma,Tulsa County,7,45847,22643,23204
Oklahoma,Tulsa County,8,44331,22037,22294
Oklahoma,Tulsa County,9,39278,19182,20096
Oklahoma,Tulsa County,10,39640,19609,20031
Oklahoma,Tulsa County,11,37331,18252,19079
Oklahoma,Tulsa County,12,40268,19421,20847
Oklahoma,Tulsa County,13,38026,17906,20120
Oklahoma,Tulsa County,14,30920,14354,16566
Oklahoma,Tulsa County,15,23872,10542,13330
Oklahoma,Tulsa County,16,15916,6817,9099
Oklahoma,Tulsa County,17,10704,4321,6383
Oklahoma,Tulsa County,18,11906,4091,7815
Oklahoma,Wagoner County,0,80110,39674,40436
Oklahoma,Wagoner County,1,4756,2420,2336
Oklahoma,Wagoner County,2,5563,2892,2671
Oklahoma,Wagoner County,3,5731,2918,2813
Oklahoma,Wagoner County,4,5192,2707,2485
Oklahoma,Wagoner County,5,4259,2218,2041
Oklahoma,Wagoner County,6,5034,2467,2567
Oklahoma,Wagoner County,7,5324,2636,2688
Oklahoma,Wagoner County,8,5483,2638,2845
Oklahoma,Wagoner County,9,4957,2445,2512
Oklahoma,Wagoner County,10,5201,2660,2541
Oklahoma,Wagoner County,11,5007,2455,2552
Oklahoma,Wagoner County,12,5455,2698,2757
Oklahoma,Wagoner County,13,5091,2424,2667
Oklahoma,Wagoner County,14,4298,2035,2263
Oklahoma,Wagoner County,15,3701,1764,1937
Oklahoma,Wagoner County,16,2420,1136,1284
Oklahoma,Wagoner County,17,1476,706,770
Oklahoma,Wagoner County,18,1162,455,707
Oklahoma,Washington County,0,51843,25268,26575
Oklahoma,Washington County,1,3259,1624,1635
Oklahoma,Washington County,2,3568,1866,1702
Oklahoma,Washington County,3,3515,1790,1725
Oklahoma,Washington County,4,3226,1707,1519
Oklahoma,Washington County,5,2812,1452,1360
Oklahoma,Washington County,6,3237,1632,1605
Oklahoma,Washington County,7,3240,1645,1595
Oklahoma,Washington County,8,3283,1679,1604
Oklahoma,Washington County,9,2722,1321,1401
Oklahoma,Washington County,10,2922,1404,1518
Oklahoma,Washington County,11,2910,1389,1521
Oklahoma,Washington County,12,3485,1614,1871
Oklahoma,Washington County,13,3565,1714,1851
Oklahoma,Washington County,14,2844,1356,1488
Oklahoma,Washington County,15,2452,1074,1378
Oklahoma,Washington County,16,1886,826,1060
Oklahoma,Washington County,17,1422,626,796
Oklahoma,Washington County,18,1495,549,946
Oklahoma,Washita County,0,11127,5522,5605
Oklahoma,Washita County,1,765,417,348
Oklahoma,Washita County,2,757,397,360
Oklahoma,Washita County,3,817,409,408
Oklahoma,Washita County,4,743,386,357
Oklahoma,Washita County,5,502,238,264
Oklahoma,Washita County,6,663,344,319
Oklahoma,Washita County,7,666,340,326
Oklahoma,Washita County,8,730,377,353
Oklahoma,Washita County,9,587,293,294
Oklahoma,Washita County,10,576,272,304
Oklahoma,Washita County,11,628,316,312
Oklahoma,Washita County,12,855,430,425
Oklahoma,Washita County,13,831,421,410
Oklahoma,Washita County,14,608,291,317
Oklahoma,Washita County,15,474,219,255
Oklahoma,Washita County,16,370,165,205
Oklahoma,Washita County,17,257,117,140
Oklahoma,Washita County,18,298,90,208
Oklahoma,Woods County,0,8897,4746,4151
Oklahoma,Woods County,1,557,283,274
Oklahoma,Woods County,2,514,265,249
Oklahoma,Woods County,3,469,243,226
Oklahoma,Woods County,4,699,409,290
Oklahoma,Woods County,5,1040,635,405
Oklahoma,Woods County,6,724,435,289
Oklahoma,Woods County,7,596,350,246
Oklahoma,Woods County,8,518,284,234
Oklahoma,Woods County,9,401,203,198
Oklahoma,Woods County,10,389,198,191
Oklahoma,Woods County,11,457,231,226
Oklahoma,Woods County,12,527,265,262
Oklahoma,Woods County,13,484,238,246
Oklahoma,Woods County,14,440,219,221
Oklahoma,Woods County,15,338,163,175
Oklahoma,Woods County,16,264,137,127
Oklahoma,Woods County,17,221,92,129
Oklahoma,Woods County,18,259,96,163
Oklahoma,Woodward County,0,20222,10634,9588
Oklahoma,Woodward County,1,1329,655,674
Oklahoma,Woodward County,2,1432,763,669
Oklahoma,Woodward County,3,1362,698,664
Oklahoma,Woodward County,4,1299,657,642
Oklahoma,Woodward County,5,1228,687,541
Oklahoma,Woodward County,6,1454,841,613
Oklahoma,Woodward County,7,1354,787,567
Oklahoma,Woodward County,8,1481,810,671
Oklahoma,Woodward County,9,1282,707,575
Oklahoma,Woodward County,10,1179,674,505
Oklahoma,Woodward County,11,1131,612,519
Oklahoma,Woodward County,12,1309,655,654
Oklahoma,Woodward County,13,1204,635,569
Oklahoma,Woodward County,14,954,454,500
Oklahoma,Woodward County,15,771,362,409
Oklahoma,Woodward County,16,665,317,348
Oklahoma,Woodward County,17,457,196,261
Oklahoma,Woodward County,18,331,124,207
Oregon,Baker County,0,16006,8146,7860
Oregon,Baker County,1,837,430,407
Oregon,Baker County,2,895,467,428
Oregon,Baker County,3,882,451,431
Oregon,Baker County,4,786,415,371
Oregon,Baker County,5,716,397,319
Oregon,Baker County,6,800,439,361
Oregon,Baker County,7,917,463,454
Oregon,Baker County,8,906,483,423
Oregon,Baker County,9,744,395,349
Oregon,Baker County,10,871,456,415
Oregon,Baker County,11,921,456,465
Oregon,Baker County,12,1206,583,623
Oregon,Baker County,13,1298,615,683
Oregon,Baker County,14,1349,668,681
Oregon,Baker County,15,1050,537,513
Oregon,Baker County,16,842,423,419
Oregon,Baker County,17,495,236,259
Oregon,Baker County,18,491,232,259
Oregon,Benton County,0,92101,46216,45885
Oregon,Benton County,1,3799,1900,1899
Oregon,Benton County,2,3976,2043,1933
Oregon,Benton County,3,4416,2227,2189
Oregon,Benton County,4,8415,4247,4168
Oregon,Benton County,5,15408,8363,7045
Oregon,Benton County,6,7072,3834,3238
Oregon,Benton County,7,5076,2587,2489
Oregon,Benton County,8,4935,2453,2482
Oregon,Benton County,9,4414,2212,2202
Oregon,Benton County,10,4610,2248,2362
Oregon,Benton County,11,4380,2145,2235
Oregon,Benton County,12,5102,2409,2693
Oregon,Benton County,13,5553,2558,2995
Oregon,Benton County,14,5303,2616,2687
Oregon,Benton County,15,3876,1883,1993
Oregon,Benton County,16,2454,1129,1325
Oregon,Benton County,17,1536,695,841
Oregon,Benton County,18,1776,667,1109
Oregon,Clackamas County,0,416075,205076,210999
Oregon,Clackamas County,1,22309,11313,10996
Oregon,Clackamas County,2,24862,12823,12039
Oregon,Clackamas County,3,26275,13464,12811
Oregon,Clackamas County,4,24725,12771,11954
Oregon,Clackamas County,5,22671,11723,10948
Oregon,Clackamas County,6,25475,13028,12447
Oregon,Clackamas County,7,25657,12729,12928
Oregon,Clackamas County,8,28352,13954,14398
Oregon,Clackamas County,9,26814,13354,13460
Oregon,Clackamas County,10,27992,13963,14029
Oregon,Clackamas County,11,27288,13528,13760
Oregon,Clackamas County,12,29431,14311,15120
Oregon,Clackamas County,13,28906,13964,14942
Oregon,Clackamas County,14,26067,12271,13796
Oregon,Clackamas County,15,20027,9428,10599
Oregon,Clackamas County,16,12857,6030,6827
Oregon,Clackamas County,17,7594,3340,4254
Oregon,Clackamas County,18,8773,3082,5691
Oregon,Clatsop County,0,39764,19655,20109
Oregon,Clatsop County,1,2056,1038,1018
Oregon,Clatsop County,2,2104,1044,1060
Oregon,Clatsop County,3,2131,1056,1075
Oregon,Clatsop County,4,2187,1124,1063
Oregon,Clatsop County,5,2094,1122,972
Oregon,Clatsop County,6,2454,1266,1188
Oregon,Clatsop County,7,2376,1207,1169
Oregon,Clatsop County,8,2592,1278,1314
Oregon,Clatsop County,9,2149,1092,1057
Oregon,Clatsop County,10,2224,1137,1087
Oregon,Clatsop County,11,2260,1087,1173
Oregon,Clatsop County,12,2887,1419,1468
Oregon,Clatsop County,13,3332,1556,1776
Oregon,Clatsop County,14,3282,1602,1680
Oregon,Clatsop County,15,2466,1214,1252
Oregon,Clatsop County,16,1481,726,755
Oregon,Clatsop County,17,921,427,494
Oregon,Clatsop County,18,768,260,508
Oregon,Columbia County,0,52377,26190,26187
Oregon,Columbia County,1,2826,1491,1335
Oregon,Columbia County,2,3006,1493,1513
Oregon,Columbia County,3,3176,1611,1565
Oregon,Columbia County,4,3203,1667,1536
Oregon,Columbia County,5,2714,1436,1278
Oregon,Columbia County,6,3080,1584,1496
Oregon,Columbia County,7,2975,1441,1534
Oregon,Columbia County,8,3311,1666,1645
Oregon,Columbia County,9,3115,1574,1541
Oregon,Columbia County,10,3538,1759,1779
Oregon,Columbia County,11,3562,1830,1732
Oregon,Columbia County,12,4124,2005,2119
Oregon,Columbia County,13,3938,1960,1978
Oregon,Columbia County,14,3397,1686,1711
Oregon,Columbia County,15,2655,1296,1359
Oregon,Columbia County,16,1792,880,912
Oregon,Columbia County,17,1025,478,547
Oregon,Columbia County,18,940,333,607
Oregon,Coos County,0,64389,31756,32633
Oregon,Coos County,1,3194,1648,1546
Oregon,Coos County,2,3288,1672,1616
Oregon,Coos County,3,3328,1682,1646
Oregon,Coos County,4,3187,1616,1571
Oregon,Coos County,5,3096,1576,1520
Oregon,Coos County,6,3656,1871,1785
Oregon,Coos County,7,3457,1742,1715
Oregon,Coos County,8,3654,1902,1752
Oregon,Coos County,9,3233,1600,1633
Oregon,Coos County,10,3407,1710,1697
Oregon,Coos County,11,3760,1827,1933
Oregon,Coos County,12,4960,2320,2640
Oregon,Coos County,13,5543,2636,2907
Oregon,Coos County,14,5384,2553,2831
Oregon,Coos County,15,4345,2137,2208
Oregon,Coos County,16,3123,1526,1597
Oregon,Coos County,17,2031,954,1077
Oregon,Coos County,18,1743,784,959
Oregon,Crook County,0,23867,11858,12009
Oregon,Crook County,1,1315,665,650
Oregon,Crook County,2,1263,620,643
Oregon,Crook County,3,1345,689,656
Oregon,Crook County,4,1221,651,570
Oregon,Crook County,5,1099,553,546
Oregon,Crook County,6,1209,606,603
Oregon,Crook County,7,1270,641,629
Oregon,Crook County,8,1308,648,660
Oregon,Crook County,9,1374,681,693
Oregon,Crook County,10,1284,639,645
Oregon,Crook County,11,1414,664,750
Oregon,Crook County,12,1821,892,929
Oregon,Crook County,13,2000,948,1052
Oregon,Crook County,14,2032,974,1058
Oregon,Crook County,15,1643,844,799
Oregon,Crook County,16,1096,596,500
Oregon,Crook County,17,620,309,311
Oregon,Crook County,18,553,238,315
Oregon,Curry County,0,22813,11227,11586
Oregon,Curry County,1,906,472,434
Oregon,Curry County,2,909,448,461
Oregon,Curry County,3,914,501,413
Oregon,Curry County,4,886,469,417
Oregon,Curry County,5,816,453,363
Oregon,Curry County,6,1020,548,472
Oregon,Curry County,7,988,482,506
Oregon,Curry County,8,977,481,496
Oregon,Curry County,9,942,466,476
Oregon,Curry County,10,1112,540,572
Oregon,Curry County,11,1354,632,722
Oregon,Curry County,12,1891,905,986
Oregon,Curry County,13,2298,1060,1238
Oregon,Curry County,14,2514,1218,1296
Oregon,Curry County,15,2132,1077,1055
Oregon,Curry County,16,1500,738,762
Oregon,Curry County,17,876,394,482
Oregon,Curry County,18,778,343,435
Oregon,Deschutes County,0,191996,95002,96994
Oregon,Deschutes County,1,9834,5050,4784
Oregon,Deschutes County,2,10582,5408,5174
Oregon,Deschutes County,3,11541,5968,5573
Oregon,Deschutes County,4,10369,5334,5035
Oregon,Deschutes County,5,9523,4893,4630
Oregon,Deschutes County,6,12239,6324,5915
Oregon,Deschutes County,7,12769,6297,6472
Oregon,Deschutes County,8,13144,6668,6476
Oregon,Deschutes County,9,12119,6041,6078
Oregon,Deschutes County,10,12872,6466,6406
Oregon,Deschutes County,11,11468,5596,5872
Oregon,Deschutes County,12,12942,6080,6862
Oregon,Deschutes County,13,14186,6582,7604
Oregon,Deschutes County,14,13713,6580,7133
Oregon,Deschutes County,15,10724,5282,5442
Oregon,Deschutes County,16,6610,3196,3414
Oregon,Deschutes County,17,3723,1837,1886
Oregon,Deschutes County,18,3638,1400,2238
Oregon,Douglas County,0,110283,54364,55919
Oregon,Douglas County,1,5701,2921,2780
Oregon,Douglas County,2,5902,3020,2882
Oregon,Douglas County,3,6050,3092,2958
Oregon,Douglas County,4,5731,2986,2745
Oregon,Douglas County,5,5168,2706,2462
Oregon,Douglas County,6,6217,3078,3139
Oregon,Douglas County,7,6067,2979,3088
Oregon,Douglas County,8,6067,3029,3038
Oregon,Douglas County,9,5587,2798,2789
Oregon,Douglas County,10,5888,2931,2957
Oregon,Douglas County,11,6547,3177,3370
Oregon,Douglas County,12,8148,3839,4309
Oregon,Douglas County,13,8836,4292,4544
Oregon,Douglas County,14,8767,4190,4577
Oregon,Douglas County,15,7512,3761,3751
Oregon,Douglas County,16,5282,2635,2647
Oregon,Douglas County,17,3380,1566,1814
Oregon,Douglas County,18,3433,1364,2069
Oregon,Gilliam County,0,1894,968,926
Oregon,Gilliam County,1,86,47,39
Oregon,Gilliam County,2,121,62,59
Oregon,Gilliam County,3,100,53,47
Oregon,Gilliam County,4,96,55,41
Oregon,Gilliam County,5,85,59,26
Oregon,Gilliam County,6,62,27,35
Oregon,Gilliam County,7,84,49,35
Oregon,Gilliam County,8,118,58,60
Oregon,Gilliam County,9,81,38,43
Oregon,Gilliam County,10,92,41,51
Oregon,Gilliam County,11,102,53,49
Oregon,Gilliam County,12,149,82,67
Oregon,Gilliam County,13,191,99,92
Oregon,Gilliam County,14,155,80,75
Oregon,Gilliam County,15,133,65,68
Oregon,Gilliam County,16,85,36,49
Oregon,Gilliam County,17,65,33,32
Oregon,Gilliam County,18,89,31,58
Oregon,Grant County,0,7176,3587,3589
Oregon,Grant County,1,314,170,144
Oregon,Grant County,2,356,184,172
Oregon,Grant County,3,375,191,184
Oregon,Grant County,4,339,164,175
Oregon,Grant County,5,290,148,142
Oregon,Grant County,6,314,165,149
Oregon,Grant County,7,381,185,196
Oregon,Grant County,8,359,185,174
Oregon,Grant County,9,347,182,165
Oregon,Grant County,10,358,171,187
Oregon,Grant County,11,363,160,203
Oregon,Grant County,12,578,281,297
Oregon,Grant County,13,622,301,321
Oregon,Grant County,14,656,340,316
Oregon,Grant County,15,544,271,273
Oregon,Grant County,16,426,224,202
Oregon,Grant County,17,273,135,138
Oregon,Grant County,18,281,130,151
Oregon,Harney County,0,7329,3738,3591
Oregon,Harney County,1,437,228,209
Oregon,Harney County,2,401,211,190
Oregon,Harney County,3,422,237,185
Oregon,Harney County,4,393,234,159
Oregon,Harney County,5,376,223,153
Oregon,Harney County,6,385,191,194
Oregon,Harney County,7,415,207,208
Oregon,Harney County,8,414,199,215
Oregon,Harney County,9,402,205,197
Oregon,Harney County,10,383,184,199
Oregon,Harney County,11,416,189,227
Oregon,Harney County,12,528,254,274
Oregon,Harney County,13,564,285,279
Oregon,Harney County,14,591,302,289
Oregon,Harney County,15,428,223,205
Oregon,Harney County,16,352,182,170
Oregon,Harney County,17,223,107,116
Oregon,Harney County,18,199,77,122
Oregon,Hood River County,0,23428,11711,11717
Oregon,Hood River County,1,1464,726,738
Oregon,Hood River County,2,1510,759,751
Oregon,Hood River County,3,1618,813,805
Oregon,Hood River County,4,1637,865,772
Oregon,Hood River County,5,1342,736,606
Oregon,Hood River County,6,1404,716,688
Oregon,Hood River County,7,1525,789,736
Oregon,Hood River County,8,1558,742,816
Oregon,Hood River County,9,1576,793,783
Oregon,Hood River County,10,1463,724,739
Oregon,Hood River County,11,1522,760,762
Oregon,Hood River County,12,1580,788,792
Oregon,Hood River County,13,1563,776,787
Oregon,Hood River County,14,1263,679,584
Oregon,Hood River County,15,907,435,472
Oregon,Hood River County,16,581,260,321
Oregon,Hood River County,17,417,196,221
Oregon,Hood River County,18,498,154,344
Oregon,Jackson County,0,219564,107102,112462
Oregon,Jackson County,1,12186,6272,5914
Oregon,Jackson County,2,12889,6564,6325
Oregon,Jackson County,3,12736,6481,6255
Oregon,Jackson County,4,12155,6194,5961
Oregon,Jackson County,5,11883,5949,5934
Oregon,Jackson County,6,14326,7242,7084
Oregon,Jackson County,7,13472,6673,6799
Oregon,Jackson County,8,13588,6669,6919
Oregon,Jackson County,9,12237,6100,6137
Oregon,Jackson County,10,12543,6213,6330
Oregon,Jackson County,11,12599,6197,6402
Oregon,Jackson County,12,14761,7003,7758
Oregon,Jackson County,13,15953,7453,8500
Oregon,Jackson County,14,15803,7437,8366
Oregon,Jackson County,15,12805,6092,6713
Oregon,Jackson County,16,8565,4004,4561
Oregon,Jackson County,17,5349,2384,2965
Oregon,Jackson County,18,5714,2175,3539
Oregon,Jefferson County,0,24192,12478,11714
Oregon,Jefferson County,1,1543,780,763
Oregon,Jefferson County,2,1685,892,793
Oregon,Jefferson County,3,1575,801,774
Oregon,Jefferson County,4,1385,683,702
Oregon,Jefferson County,5,1324,743,581
Oregon,Jefferson County,6,1608,903,705
Oregon,Jefferson County,7,1456,750,706
Oregon,Jefferson County,8,1386,770,616
Oregon,Jefferson County,9,1292,685,607
Oregon,Jefferson County,10,1447,758,689
Oregon,Jefferson County,11,1468,770,698
Oregon,Jefferson County,12,1636,804,832
Oregon,Jefferson County,13,1673,830,843
Oregon,Jefferson County,14,1584,772,812
Oregon,Jefferson County,15,1329,691,638
Oregon,Jefferson County,16,912,425,487
Oregon,Jefferson County,17,534,269,265
Oregon,Jefferson County,18,355,152,203
Oregon,Josephine County,0,87393,42681,44712
Oregon,Josephine County,1,4523,2300,2223
Oregon,Josephine County,2,4656,2395,2261
Oregon,Josephine County,3,4995,2566,2429
Oregon,Josephine County,4,4605,2477,2128
Oregon,Josephine County,5,4020,2123,1897
Oregon,Josephine County,6,4858,2440,2418
Oregon,Josephine County,7,4621,2372,2249
Oregon,Josephine County,8,4638,2340,2298
Oregon,Josephine County,9,4396,2163,2233
Oregon,Josephine County,10,4774,2330,2444
Oregon,Josephine County,11,5069,2436,2633
Oregon,Josephine County,12,6487,3023,3464
Oregon,Josephine County,13,7042,3245,3797
Oregon,Josephine County,14,7100,3333,3767
Oregon,Josephine County,15,6109,2895,3214
Oregon,Josephine County,16,4159,1962,2197
Oregon,Josephine County,17,2699,1252,1447
Oregon,Josephine County,18,2642,1029,1613
Oregon,Klamath County,0,67653,33817,33836
Oregon,Klamath County,1,4196,2150,2046
Oregon,Klamath County,2,4167,2106,2061
Oregon,Klamath County,3,4061,2090,1971
Oregon,Klamath County,4,3889,2073,1816
Oregon,Klamath County,5,3916,2027,1889
Oregon,Klamath County,6,4571,2352,2219
Oregon,Klamath County,7,4028,2031,1997
Oregon,Klamath County,8,3764,1896,1868
Oregon,Klamath County,9,3457,1736,1721
Oregon,Klamath County,10,3775,1925,1850
Oregon,Klamath County,11,3915,1923,1992
Oregon,Klamath County,12,4583,2201,2382
Oregon,Klamath County,13,4991,2377,2614
Oregon,Klamath County,14,5003,2436,2567
Oregon,Klamath County,15,3730,1915,1815
Oregon,Klamath County,16,2618,1299,1319
Oregon,Klamath County,17,1574,740,834
Oregon,Klamath County,18,1415,540,875
Oregon,Lake County,0,7879,4201,3678
Oregon,Lake County,1,402,222,180
Oregon,Lake County,2,428,207,221
Oregon,Lake County,3,422,193,229
Oregon,Lake County,4,410,221,189
Oregon,Lake County,5,334,189,145
Oregon,Lake County,6,392,214,178
Oregon,Lake County,7,397,224,173
Oregon,Lake County,8,427,248,179
Oregon,Lake County,9,470,262,208
Oregon,Lake County,10,492,303,189
Oregon,Lake County,11,442,238,204
Oregon,Lake County,12,605,310,295
Oregon,Lake County,13,671,320,351
Oregon,Lake County,14,644,353,291
Oregon,Lake County,15,503,270,233
Oregon,Lake County,16,402,209,193
Oregon,Lake County,17,225,127,98
Oregon,Lake County,18,213,91,122
Oregon,Lane County,0,379611,186873,192738
Oregon,Lane County,1,18701,9702,8999
Oregon,Lane County,2,19034,9774,9260
Oregon,Lane County,3,19960,10221,9739
Oregon,Lane County,4,24409,12276,12133
Oregon,Lane County,5,35685,17880,17805
Oregon,Lane County,6,27003,14058,12945
Oregon,Lane County,7,22731,11589,11142
Oregon,Lane County,8,24115,12011,12104
Oregon,Lane County,9,21940,11082,10858
Oregon,Lane County,10,21317,10686,10631
Oregon,Lane County,11,21013,10417,10596
Oregon,Lane County,12,24427,11518,12909
Oregon,Lane County,13,25884,12036,13848
Oregon,Lane County,14,25369,12045,13324
Oregon,Lane County,15,19122,9080,10042
Oregon,Lane County,16,12895,5953,6942
Oregon,Lane County,17,7663,3404,4259
Oregon,Lane County,18,8343,3141,5202
Oregon,Lincoln County,0,49388,23815,25573
Oregon,Lincoln County,1,2227,1168,1059
Oregon,Lincoln County,2,2358,1227,1131
Oregon,Lincoln County,3,2389,1161,1228
Oregon,Lincoln County,4,2273,1210,1063
Oregon,Lincoln County,5,1986,1024,962
Oregon,Lincoln County,6,2313,1163,1150
Oregon,Lincoln County,7,2402,1181,1221
Oregon,Lincoln County,8,2737,1307,1430
Oregon,Lincoln County,9,2407,1195,1212
Oregon,Lincoln County,10,2615,1299,1316
Oregon,Lincoln County,11,2783,1262,1521
Oregon,Lincoln County,12,3953,1823,2130
Oregon,Lincoln County,13,4903,2252,2651
Oregon,Lincoln County,14,5143,2398,2745
Oregon,Lincoln County,15,3786,1802,1984
Oregon,Lincoln County,16,2434,1149,1285
Oregon,Lincoln County,17,1422,708,714
Oregon,Lincoln County,18,1257,486,771
Oregon,Linn County,0,127335,62960,64375
Oregon,Linn County,1,7811,4026,3785
Oregon,Linn County,2,7817,4009,3808
Oregon,Linn County,3,8151,4239,3912
Oregon,Linn County,4,7586,3868,3718
Oregon,Linn County,5,7267,3684,3583
Oregon,Linn County,6,8925,4507,4418
Oregon,Linn County,7,8315,4136,4179
Oregon,Linn County,8,7897,3837,4060
Oregon,Linn County,9,7302,3633,3669
Oregon,Linn County,10,7642,3877,3765
Oregon,Linn County,11,7434,3613,3821
Oregon,Linn County,12,8747,4300,4447
Oregon,Linn County,13,8770,4202,4568
Oregon,Linn County,14,7916,3847,4069
Oregon,Linn County,15,6234,3051,3183
Oregon,Linn County,16,4331,1997,2334
Oregon,Linn County,17,2653,1140,1513
Oregon,Linn County,18,2537,994,1543
Oregon,Malheur County,0,30725,16677,14048
Oregon,Malheur County,1,2205,1111,1094
Oregon,Malheur County,2,2341,1200,1141
Oregon,Malheur County,3,2189,1102,1087
Oregon,Malheur County,4,2128,1086,1042
Oregon,Malheur County,5,2097,1273,824
Oregon,Malheur County,6,2185,1332,853
Oregon,Malheur County,7,1927,1171,756
Oregon,Malheur County,8,1884,1106,778
Oregon,Malheur County,9,1757,1045,712
Oregon,Malheur County,10,1771,1063,708
Oregon,Malheur County,11,1668,934,734
Oregon,Malheur County,12,1775,942,833
Oregon,Malheur County,13,1742,909,833
Oregon,Malheur County,14,1523,781,742
Oregon,Malheur County,15,1291,629,662
Oregon,Malheur County,16,907,436,471
Oregon,Malheur County,17,658,287,371
Oregon,Malheur County,18,677,270,407
Oregon,Marion County,0,346868,172899,173969
Oregon,Marion County,1,23378,11992,11386
Oregon,Marion County,2,23756,12215,11541
Oregon,Marion County,3,24357,12515,11842
Oregon,Marion County,4,23007,11903,11104
Oregon,Marion County,5,22545,11694,10851
Oregon,Marion County,6,25571,13103,12468
Oregon,Marion County,7,23381,12017,11364
Oregon,Marion County,8,23246,11868,11378
Oregon,Marion County,9,21087,10787,10300
Oregon,Marion County,10,20738,10550,10188
Oregon,Marion County,11,19711,9945,9766
Oregon,Marion County,12,21090,10309,10781
Oregon,Marion County,13,20652,9833,10819
Oregon,Marion County,14,18023,8304,9719
Oregon,Marion County,15,14091,6539,7552
Oregon,Marion County,16,9559,4259,5300
Oregon,Marion County,17,6115,2696,3419
Oregon,Marion County,18,6561,2370,4191
Oregon,Morrow County,0,11372,5842,5530
Oregon,Morrow County,1,841,426,415
Oregon,Morrow County,2,858,468,390
Oregon,Morrow County,3,898,477,421
Oregon,Morrow County,4,863,469,394
Oregon,Morrow County,5,676,362,314
Oregon,Morrow County,6,620,338,282
Oregon,Morrow County,7,588,275,313
Oregon,Morrow County,8,681,322,359
Oregon,Morrow County,9,633,351,282
Oregon,Morrow County,10,649,317,332
Oregon,Morrow County,11,646,331,315
Oregon,Morrow County,12,728,367,361
Oregon,Morrow County,13,810,403,407
Oregon,Morrow County,14,680,336,344
Oregon,Morrow County,15,472,234,238
Oregon,Morrow County,16,322,153,169
Oregon,Morrow County,17,235,121,114
Oregon,Morrow County,18,172,92,80
Oregon,Multnomah County,0,811880,402182,409698
Oregon,Multnomah County,1,43965,22658,21307
Oregon,Multnomah County,2,42877,21843,21034
Oregon,Multnomah County,3,41833,21445,20388
Oregon,Multnomah County,4,40476,20663,19813
Oregon,Multnomah County,5,47447,23351,24096
Oregon,Multnomah County,6,75089,36939,38150
Oregon,Multnomah County,7,76916,38457,38459
Oregon,Multnomah County,8,72682,36707,35975
Oregon,Multnomah County,9,61896,31676,30220
Oregon,Multnomah County,10,57709,29478,28231
Oregon,Multnomah County,11,48996,25104,23892
Oregon,Multnomah County,12,47252,23445,23807
Oregon,Multnomah County,13,45662,22107,23555
Oregon,Multnomah County,14,40465,19184,21281
Oregon,Multnomah County,15,28542,13136,15406
Oregon,Multnomah County,16,17107,7603,9504
Oregon,Multnomah County,17,10477,4223,6254
Oregon,Multnomah County,18,12489,4163,8326
Oregon,Polk County,0,85234,41658,43576
Oregon,Polk County,1,4901,2444,2457
Oregon,Polk County,2,5441,2765,2676
Oregon,Polk County,3,5724,2924,2800
Oregon,Polk County,4,6299,3155,3144
Oregon,Polk County,5,7702,3737,3965
Oregon,Polk County,6,5470,2808,2662
Oregon,Polk County,7,4957,2506,2451
Oregon,Polk County,8,5060,2445,2615
Oregon,Polk County,9,4887,2410,2477
Oregon,Polk County,10,4786,2380,2406
Oregon,Polk County,11,4620,2239,2381
Oregon,Polk County,12,4942,2424,2518
Oregon,Polk County,13,5170,2352,2818
Oregon,Polk County,14,4873,2314,2559
Oregon,Polk County,15,4070,1912,2158
Oregon,Polk County,16,2788,1329,1459
Oregon,Polk County,17,1760,791,969
Oregon,Polk County,18,1784,723,1061
Oregon,Sherman County,0,1708,880,828
Oregon,Sherman County,1,91,46,45
Oregon,Sherman County,2,77,37,40
Oregon,Sherman County,3,86,44,42
Oregon,Sherman County,4,93,55,38
Oregon,Sherman County,5,56,31,25
Oregon,Sherman County,6,78,37,41
Oregon,Sherman County,7,97,44,53
Oregon,Sherman County,8,93,40,53
Oregon,Sherman County,9,99,62,37
Oregon,Sherman County,10,98,59,39
Oregon,Sherman County,11,102,49,53
Oregon,Sherman County,12,147,70,77
Oregon,Sherman County,13,138,72,66
Oregon,Sherman County,14,128,74,54
Oregon,Sherman County,15,105,51,54
Oregon,Sherman County,16,85,43,42
Oregon,Sherman County,17,69,27,42
Oregon,Sherman County,18,66,39,27
Oregon,Tillamook County,0,26787,13561,13226
Oregon,Tillamook County,1,1305,693,612
Oregon,Tillamook County,2,1455,768,687
Oregon,Tillamook County,3,1470,754,716
Oregon,Tillamook County,4,1295,717,578
Oregon,Tillamook County,5,1234,711,523
Oregon,Tillamook County,6,1406,730,676
Oregon,Tillamook County,7,1470,764,706
Oregon,Tillamook County,8,1488,745,743
Oregon,Tillamook County,9,1324,697,627
Oregon,Tillamook County,10,1490,746,744
Oregon,Tillamook County,11,1573,782,791
Oregon,Tillamook County,12,1976,984,992
Oregon,Tillamook County,13,2392,1132,1260
Oregon,Tillamook County,14,2462,1216,1246
Oregon,Tillamook County,15,1888,886,1002
Oregon,Tillamook County,16,1232,621,611
Oregon,Tillamook County,17,686,356,330
Oregon,Tillamook County,18,641,259,382
Oregon,Umatilla County,0,77516,40461,37055
Oregon,Umatilla County,1,5090,2537,2553
Oregon,Umatilla County,2,5471,2832,2639
Oregon,Umatilla County,3,5717,2911,2806
Oregon,Umatilla County,4,5206,2680,2526
Oregon,Umatilla County,5,4991,2832,2159
Oregon,Umatilla County,6,5813,3333,2480
Oregon,Umatilla County,7,5006,2730,2276
Oregon,Umatilla County,8,4978,2722,2256
Oregon,Umatilla County,9,4793,2612,2181
Oregon,Umatilla County,10,4677,2475,2202
Oregon,Umatilla County,11,4480,2367,2113
Oregon,Umatilla County,12,4597,2371,2226
Oregon,Umatilla County,13,4577,2313,2264
Oregon,Umatilla County,14,3993,2002,1991
Oregon,Umatilla County,15,3119,1511,1608
Oregon,Umatilla County,16,2141,1034,1107
Oregon,Umatilla County,17,1424,650,774
Oregon,Umatilla County,18,1443,549,894
Oregon,Union County,0,26461,13158,13303
Oregon,Union County,1,1582,822,760
Oregon,Union County,2,1678,845,833
Oregon,Union County,3,1680,890,790
Oregon,Union County,4,1875,968,907
Oregon,Union County,5,2096,1053,1043
Oregon,Union County,6,1559,790,769
Oregon,Union County,7,1545,782,763
Oregon,Union County,8,1623,836,787
Oregon,Union County,9,1350,692,658
Oregon,Union County,10,1289,643,646
Oregon,Union County,11,1300,635,665
Oregon,Union County,12,1616,742,874
Oregon,Union County,13,1930,921,1009
Oregon,Union County,14,1691,846,845
Oregon,Union County,15,1350,681,669
Oregon,Union County,16,979,461,518
Oregon,Union County,17,611,293,318
Oregon,Union County,18,707,258,449
Oregon,Wallowa County,0,7081,3498,3583
Oregon,Wallowa County,1,341,157,184
Oregon,Wallowa County,2,363,191,172
Oregon,Wallowa County,3,392,223,169
Oregon,Wallowa County,4,331,162,169
Oregon,Wallowa County,5,210,94,116
Oregon,Wallowa County,6,293,144,149
Oregon,Wallowa County,7,404,193,211
Oregon,Wallowa County,8,393,201,192
Oregon,Wallowa County,9,337,182,155
Oregon,Wallowa County,10,316,156,160
Oregon,Wallowa County,11,393,172,221
Oregon,Wallowa County,12,577,266,311
Oregon,Wallowa County,13,665,315,350
Oregon,Wallowa County,14,690,348,342
Oregon,Wallowa County,15,518,271,247
Oregon,Wallowa County,16,367,191,176
Oregon,Wallowa County,17,242,130,112
Oregon,Wallowa County,18,249,102,147
Oregon,Wasco County,0,26505,13322,13183
Oregon,Wasco County,1,1704,937,767
Oregon,Wasco County,2,1634,833,801
Oregon,Wasco County,3,1612,824,788
Oregon,Wasco County,4,1449,774,675
Oregon,Wasco County,5,1459,751,708
Oregon,Wasco County,6,1856,964,892
Oregon,Wasco County,7,1711,892,819
Oregon,Wasco County,8,1612,819,793
Oregon,Wasco County,9,1442,725,717
Oregon,Wasco County,10,1426,725,701
Oregon,Wasco County,11,1436,706,730
Oregon,Wasco County,12,1780,842,938
Oregon,Wasco County,13,1926,931,995
Oregon,Wasco County,14,1841,940,901
Oregon,Wasco County,15,1385,708,677
Oregon,Wasco County,16,964,465,499
Oregon,Wasco County,17,573,251,322
Oregon,Wasco County,18,695,235,460
Oregon,Washington County,0,597695,295687,302008
Oregon,Washington County,1,35956,18303,17653
Oregon,Washington County,2,37971,19582,18389
Oregon,Washington County,3,39401,20024,19377
Oregon,Washington County,4,36107,18553,17554
Oregon,Washington County,5,36009,17993,18016
Oregon,Washington County,6,46552,23750,22802
Oregon,Washington County,7,47549,24471,23078
Oregon,Washington County,8,47226,23853,23373
Oregon,Washington County,9,42636,21370,21266
Oregon,Washington County,10,42034,21034,21000
Oregon,Washington County,11,36904,18488,18416
Oregon,Washington County,12,36099,17665,18434
Oregon,Washington County,13,32983,15796,17187
Oregon,Washington County,14,27689,12778,14911
Oregon,Washington County,15,21165,9368,11797
Oregon,Washington County,16,13324,5840,7484
Oregon,Washington County,17,8373,3454,4919
Oregon,Washington County,18,9717,3365,6352
Oregon,Wheeler County,0,1366,677,689
Oregon,Wheeler County,1,67,31,36
Oregon,Wheeler County,2,50,23,27
Oregon,Wheeler County,3,54,28,26
Oregon,Wheeler County,4,64,38,26
Oregon,Wheeler County,5,43,31,12
Oregon,Wheeler County,6,54,29,25
Oregon,Wheeler County,7,60,27,33
Oregon,Wheeler County,8,56,27,29
Oregon,Wheeler County,9,55,31,24
Oregon,Wheeler County,10,65,33,32
Oregon,Wheeler County,11,81,40,41
Oregon,Wheeler County,12,100,45,55
Oregon,Wheeler County,13,142,69,73
Oregon,Wheeler County,14,135,65,70
Oregon,Wheeler County,15,108,57,51
Oregon,Wheeler County,16,113,57,56
Oregon,Wheeler County,17,60,25,35
Oregon,Wheeler County,18,59,21,38
Oregon,Yamhill County,0,107002,53571,53431
Oregon,Yamhill County,1,6121,3098,3023
Oregon,Yamhill County,2,6394,3218,3176
Oregon,Yamhill County,3,6939,3619,3320
Oregon,Yamhill County,4,7755,3868,3887
Oregon,Yamhill County,5,7395,3755,3640
Oregon,Yamhill County,6,6815,3644,3171
Oregon,Yamhill County,7,6751,3521,3230
Oregon,Yamhill County,8,7079,3687,3392
Oregon,Yamhill County,9,6725,3468,3257
Oregon,Yamhill County,10,6561,3414,3147
Oregon,Yamhill County,11,6376,3302,3074
Oregon,Yamhill County,12,6804,3273,3531
Oregon,Yamhill County,13,6950,3381,3569
Oregon,Yamhill County,14,6040,2841,3199
Oregon,Yamhill County,15,4760,2306,2454
Oregon,Yamhill County,16,3141,1428,1713
Oregon,Yamhill County,17,2067,885,1182
Oregon,Yamhill County,18,2329,863,1466
Pennsylvania,Adams County,0,102811,50589,52222
Pennsylvania,Adams County,1,5121,2583,2538
Pennsylvania,Adams County,2,5544,2863,2681
Pennsylvania,Adams County,3,6139,3128,3011
Pennsylvania,Adams County,4,6707,3329,3378
Pennsylvania,Adams County,5,6596,3338,3258
Pennsylvania,Adams County,6,5697,2928,2769
Pennsylvania,Adams County,7,5506,2807,2699
Pennsylvania,Adams County,8,5449,2748,2701
Pennsylvania,Adams County,9,5363,2694,2669
Pennsylvania,Adams County,10,6669,3282,3387
Pennsylvania,Adams County,11,7570,3750,3820
Pennsylvania,Adams County,12,7829,3875,3954
Pennsylvania,Adams County,13,7667,3706,3961
Pennsylvania,Adams County,14,6705,3295,3410
Pennsylvania,Adams County,15,5353,2453,2900
Pennsylvania,Adams County,16,3755,1762,1993
Pennsylvania,Adams County,17,2460,1071,1389
Pennsylvania,Adams County,18,2681,977,1704
Pennsylvania,Allegheny County,0,1218452,588896,629556
Pennsylvania,Allegheny County,1,63965,32609,31356
Pennsylvania,Allegheny County,2,62136,31666,30470
Pennsylvania,Allegheny County,3,62783,32264,30519
Pennsylvania,Allegheny County,4,70765,35787,34978
Pennsylvania,Allegheny County,5,75217,37283,37934
Pennsylvania,Allegheny County,6,94658,47689,46969
Pennsylvania,Allegheny County,7,92982,47360,45622
Pennsylvania,Allegheny County,8,78363,39752,38611
Pennsylvania,Allegheny County,9,65203,32397,32806
Pennsylvania,Allegheny County,10,70659,34863,35796
Pennsylvania,Allegheny County,11,75787,36467,39320
Pennsylvania,Allegheny County,12,87021,41370,45651
Pennsylvania,Allegheny County,13,88536,42018,46518
Pennsylvania,Allegheny County,14,73823,34372,39451
Pennsylvania,Allegheny County,15,53520,24046,29474
Pennsylvania,Allegheny County,16,39079,16233,22846
Pennsylvania,Allegheny County,17,27942,10891,17051
Pennsylvania,Allegheny County,18,36013,11829,24184
Pennsylvania,Armstrong County,0,65263,32502,32761
Pennsylvania,Armstrong County,1,3180,1662,1518
Pennsylvania,Armstrong County,2,3510,1764,1746
Pennsylvania,Armstrong County,3,3667,1904,1763
Pennsylvania,Armstrong County,4,3365,1704,1661
Pennsylvania,Armstrong County,5,3276,1698,1578
Pennsylvania,Armstrong County,6,3598,1883,1715
Pennsylvania,Armstrong County,7,3399,1756,1643
Pennsylvania,Armstrong County,8,3605,1799,1806
Pennsylvania,Armstrong County,9,3651,1856,1795
Pennsylvania,Armstrong County,10,4272,2186,2086
Pennsylvania,Armstrong County,11,4583,2300,2283
Pennsylvania,Armstrong County,12,5411,2731,2680
Pennsylvania,Armstrong County,13,5408,2752,2656
Pennsylvania,Armstrong County,14,4543,2275,2268
Pennsylvania,Armstrong County,15,3464,1678,1786
Pennsylvania,Armstrong County,16,2579,1144,1435
Pennsylvania,Armstrong County,17,1807,711,1096
Pennsylvania,Armstrong County,18,1945,699,1246
Pennsylvania,Beaver County,0,164742,80005,84737
Pennsylvania,Beaver County,1,8362,4216,4146
Pennsylvania,Beaver County,2,8858,4532,4326
Pennsylvania,Beaver County,3,9205,4710,4495
Pennsylvania,Beaver County,4,8827,4582,4245
Pennsylvania,Beaver County,5,8785,4494,4291
Pennsylvania,Beaver County,6,9716,4951,4765
Pennsylvania,Beaver County,7,9526,4810,4716
Pennsylvania,Beaver County,8,9834,4982,4852
Pennsylvania,Beaver County,9,8764,4377,4387
Pennsylvania,Beaver County,10,9734,4790,4944
Pennsylvania,Beaver County,11,11276,5457,5819
Pennsylvania,Beaver County,12,13353,6459,6894
Pennsylvania,Beaver County,13,13090,6332,6758
Pennsylvania,Beaver County,14,11067,5234,5833
Pennsylvania,Beaver County,15,8423,3896,4527
Pennsylvania,Beaver County,16,6157,2649,3508
Pennsylvania,Beaver County,17,4611,1834,2777
Pennsylvania,Beaver County,18,5154,1700,3454
Pennsylvania,Bedford County,0,48176,24000,24176
Pennsylvania,Bedford County,1,2425,1277,1148
Pennsylvania,Bedford County,2,2463,1226,1237
Pennsylvania,Bedford County,3,2691,1387,1304
Pennsylvania,Bedford County,4,2773,1444,1329
Pennsylvania,Bedford County,5,2428,1278,1150
Pennsylvania,Bedford County,6,2679,1443,1236
Pennsylvania,Bedford County,7,2309,1162,1147
Pennsylvania,Bedford County,8,2498,1264,1234
Pennsylvania,Bedford County,9,2621,1300,1321
Pennsylvania,Bedford County,10,3234,1615,1619
Pennsylvania,Bedford County,11,3444,1759,1685
Pennsylvania,Bedford County,12,3864,1937,1927
Pennsylvania,Bedford County,13,3729,1851,1878
Pennsylvania,Bedford County,14,3174,1574,1600
Pennsylvania,Bedford County,15,2703,1299,1404
Pennsylvania,Bedford County,16,2197,1015,1182
Pennsylvania,Bedford County,17,1437,611,826
Pennsylvania,Bedford County,18,1507,558,949
Pennsylvania,Berks County,0,420152,206740,213412
Pennsylvania,Berks County,1,24151,12292,11859
Pennsylvania,Berks County,2,25642,13076,12566
Pennsylvania,Berks County,3,27166,13935,13231
Pennsylvania,Berks County,4,29488,14943,14545
Pennsylvania,Berks County,5,27708,14133,13575
Pennsylvania,Berks County,6,26950,13882,13068
Pennsylvania,Berks County,7,25194,12663,12531
Pennsylvania,Berks County,8,24753,12135,12618
Pennsylvania,Berks County,9,23592,11701,11891
Pennsylvania,Berks County,10,26626,13043,13583
Pennsylvania,Berks County,11,29187,14261,14926
Pennsylvania,Berks County,12,30290,15096,15194
Pennsylvania,Berks County,13,27053,13307,13746
Pennsylvania,Berks County,14,22520,10974,11546
Pennsylvania,Berks County,15,18066,8372,9694
Pennsylvania,Berks County,16,12392,5529,6863
Pennsylvania,Berks County,17,8747,3706,5041
Pennsylvania,Berks County,18,10627,3692,6935
Pennsylvania,Blair County,0,122492,59979,62513
Pennsylvania,Blair County,1,6464,3369,3095
Pennsylvania,Blair County,2,6903,3547,3356
Pennsylvania,Blair County,3,7309,3791,3518
Pennsylvania,Blair County,4,7461,3886,3575
Pennsylvania,Blair County,5,6295,3232,3063
Pennsylvania,Blair County,6,8050,4139,3911
Pennsylvania,Blair County,7,6962,3539,3423
Pennsylvania,Blair County,8,7072,3562,3510
Pennsylvania,Blair County,9,6953,3443,3510
Pennsylvania,Blair County,10,7616,3789,3827
Pennsylvania,Blair County,11,8017,3996,4021
Pennsylvania,Blair County,12,8827,4353,4474
Pennsylvania,Blair County,13,9118,4345,4773
Pennsylvania,Blair County,14,7930,3784,4146
Pennsylvania,Blair County,15,6112,2831,3281
Pennsylvania,Blair County,16,4517,1936,2581
Pennsylvania,Blair County,17,3220,1292,1928
Pennsylvania,Blair County,18,3666,1145,2521
Pennsylvania,Bradford County,0,60833,30157,30676
Pennsylvania,Bradford County,1,3560,1822,1738
Pennsylvania,Bradford County,2,3710,1845,1865
Pennsylvania,Bradford County,3,3881,1992,1889
Pennsylvania,Bradford County,4,3450,1767,1683
Pennsylvania,Bradford County,5,3154,1583,1571
Pennsylvania,Bradford County,6,3461,1786,1675
Pennsylvania,Bradford County,7,3186,1600,1586
Pennsylvania,Bradford County,8,3187,1583,1604
Pennsylvania,Bradford County,9,3062,1493,1569
Pennsylvania,Bradford County,10,3632,1825,1807
Pennsylvania,Bradford County,11,4169,2061,2108
Pennsylvania,Bradford County,12,4816,2403,2413
Pennsylvania,Bradford County,13,4610,2295,2315
Pennsylvania,Bradford County,14,3912,1902,2010
Pennsylvania,Bradford County,15,3379,1669,1710
Pennsylvania,Bradford County,16,2458,1177,1281
Pennsylvania,Bradford County,17,1609,717,892
Pennsylvania,Bradford County,18,1597,637,960
Pennsylvania,Bucks County,0,628195,308395,319800
Pennsylvania,Bucks County,1,30738,15790,14948
Pennsylvania,Bucks County,2,33896,17186,16710
Pennsylvania,Bucks County,3,38750,19904,18846
Pennsylvania,Bucks County,4,38653,20167,18486
Pennsylvania,Bucks County,5,35760,18110,17650
Pennsylvania,Bucks County,6,34678,17769,16909
Pennsylvania,Bucks County,7,35539,17903,17636
Pennsylvania,Bucks County,8,37739,18675,19064
Pennsylvania,Bucks County,9,35825,17758,18067
Pennsylvania,Bucks County,10,42251,20654,21597
Pennsylvania,Bucks County,11,47613,23214,24399
Pennsylvania,Bucks County,12,52248,25619,26629
Pennsylvania,Bucks County,13,47445,23336,24109
Pennsylvania,Bucks County,14,37504,18208,19296
Pennsylvania,Bucks County,15,28967,13466,15501
Pennsylvania,Bucks County,16,20107,9046,11061
Pennsylvania,Bucks County,17,14027,5833,8194
Pennsylvania,Bucks County,18,16455,5757,10698
Pennsylvania,Butler County,0,187888,93117,94771
Pennsylvania,Butler County,1,9684,4990,4694
Pennsylvania,Butler County,2,10164,5219,4945
Pennsylvania,Butler County,3,10805,5535,5270
Pennsylvania,Butler County,4,12397,6318,6079
Pennsylvania,Butler County,5,10677,5450,5227
Pennsylvania,Butler County,6,10293,5396,4897
Pennsylvania,Butler County,7,10901,5595,5306
Pennsylvania,Butler County,8,11342,5695,5647
Pennsylvania,Butler County,9,10770,5443,5327
Pennsylvania,Butler County,10,12513,6279,6234
Pennsylvania,Butler County,11,14043,6968,7075
Pennsylvania,Butler County,12,14770,7292,7478
Pennsylvania,Butler County,13,14188,7095,7093
Pennsylvania,Butler County,14,11520,5589,5931
Pennsylvania,Butler County,15,8493,4044,4449
Pennsylvania,Butler County,16,6137,2753,3384
Pennsylvania,Butler County,17,4237,1811,2426
Pennsylvania,Butler County,18,4954,1645,3309
Pennsylvania,Cambria County,0,131730,64770,66960
Pennsylvania,Cambria County,1,6625,3436,3189
Pennsylvania,Cambria County,2,6699,3411,3288
Pennsylvania,Cambria County,3,7387,3755,3632
Pennsylvania,Cambria County,4,8348,4229,4119
Pennsylvania,Cambria County,5,8232,4289,3943
Pennsylvania,Cambria County,6,7124,3708,3416
Pennsylvania,Cambria County,7,6604,3363,3241
Pennsylvania,Cambria County,8,6852,3464,3388
Pennsylvania,Cambria County,9,7185,3605,3580
Pennsylvania,Cambria County,10,7947,4034,3913
Pennsylvania,Cambria County,11,8677,4359,4318
Pennsylvania,Cambria County,12,9695,4862,4833
Pennsylvania,Cambria County,13,10619,5205,5414
Pennsylvania,Cambria County,14,9478,4634,4844
Pennsylvania,Cambria County,15,6993,3284,3709
Pennsylvania,Cambria County,16,5034,2233,2801
Pennsylvania,Cambria County,17,3721,1465,2256
Pennsylvania,Cambria County,18,4510,1434,3076
Pennsylvania,Cameron County,0,4492,2246,2246
Pennsylvania,Cameron County,1,211,104,107
Pennsylvania,Cameron County,2,219,119,100
Pennsylvania,Cameron County,3,198,101,97
Pennsylvania,Cameron County,4,228,122,106
Pennsylvania,Cameron County,5,205,99,106
Pennsylvania,Cameron County,6,214,118,96
Pennsylvania,Cameron County,7,185,103,82
Pennsylvania,Cameron County,8,212,102,110
Pennsylvania,Cameron County,9,204,112,92
Pennsylvania,Cameron County,10,258,135,123
Pennsylvania,Cameron County,11,317,159,158
Pennsylvania,Cameron County,12,395,199,196
Pennsylvania,Cameron County,13,423,196,227
Pennsylvania,Cameron County,14,370,197,173
Pennsylvania,Cameron County,15,315,171,144
Pennsylvania,Cameron County,16,220,105,115
Pennsylvania,Cameron County,17,132,45,87
Pennsylvania,Cameron County,18,186,59,127
Pennsylvania,Carbon County,0,64227,32037,32190
Pennsylvania,Carbon County,1,3084,1590,1494
Pennsylvania,Carbon County,2,3249,1633,1616
Pennsylvania,Carbon County,3,3745,1844,1901
Pennsylvania,Carbon County,4,3495,1843,1652
Pennsylvania,Carbon County,5,3135,1625,1510
Pennsylvania,Carbon County,6,3581,1877,1704
Pennsylvania,Carbon County,7,3564,1823,1741
Pennsylvania,Carbon County,8,3580,1821,1759
Pennsylvania,Carbon County,9,3623,1894,1729
Pennsylvania,Carbon County,10,4380,2217,2163
Pennsylvania,Carbon County,11,4840,2381,2459
Pennsylvania,Carbon County,12,5172,2592,2580
Pennsylvania,Carbon County,13,5154,2585,2569
Pennsylvania,Carbon County,14,4434,2192,2242
Pennsylvania,Carbon County,15,3488,1720,1768
Pennsylvania,Carbon County,16,2443,1148,1295
Pennsylvania,Carbon County,17,1623,704,919
Pennsylvania,Carbon County,18,1637,548,1089
Pennsylvania,Centre County,0,162805,85643,77162
Pennsylvania,Centre County,1,6301,3301,3000
Pennsylvania,Centre County,2,6758,3509,3249
Pennsylvania,Centre County,3,7002,3549,3453
Pennsylvania,Centre County,4,15843,7959,7884
Pennsylvania,Centre County,5,27192,15387,11805
Pennsylvania,Centre County,6,12614,7206,5408
Pennsylvania,Centre County,7,9943,5582,4361
Pennsylvania,Centre County,8,9141,5137,4004
Pennsylvania,Centre County,9,8276,4538,3738
Pennsylvania,Centre County,10,8805,4698,4107
Pennsylvania,Centre County,11,9197,4761,4436
Pennsylvania,Centre County,12,9394,4763,4631
Pennsylvania,Centre County,13,9144,4677,4467
Pennsylvania,Centre County,14,7522,3677,3845
Pennsylvania,Centre County,15,5621,2678,2943
Pennsylvania,Centre County,16,4076,1831,2245
Pennsylvania,Centre County,17,2888,1249,1639
Pennsylvania,Centre County,18,3088,1141,1947
Pennsylvania,Chester County,0,522046,257214,264832
Pennsylvania,Chester County,1,28748,14492,14256
Pennsylvania,Chester County,2,32248,16461,15787
Pennsylvania,Chester County,3,35411,18098,17313
Pennsylvania,Chester County,4,36654,18393,18261
Pennsylvania,Chester County,5,32341,16273,16068
Pennsylvania,Chester County,6,29753,15397,14356
Pennsylvania,Chester County,7,30771,15632,15139
Pennsylvania,Chester County,8,32473,16255,16218
Pennsylvania,Chester County,9,31899,15952,15947
Pennsylvania,Chester County,10,35383,17528,17855
Pennsylvania,Chester County,11,37542,18484,19058
Pennsylvania,Chester County,12,38799,18928,19871
Pennsylvania,Chester County,13,34689,17065,17624
Pennsylvania,Chester County,14,27920,13287,14633
Pennsylvania,Chester County,15,21639,10140,11499
Pennsylvania,Chester County,16,14855,6663,8192
Pennsylvania,Chester County,17,9583,4074,5509
Pennsylvania,Chester County,18,11338,4092,7246
Pennsylvania,Clarion County,0,38779,18984,19795
Pennsylvania,Clarion County,1,2009,1068,941
Pennsylvania,Clarion County,2,1961,994,967
Pennsylvania,Clarion County,3,2014,1011,1003
Pennsylvania,Clarion County,4,2984,1398,1586
Pennsylvania,Clarion County,5,3461,1672,1789
Pennsylvania,Clarion County,6,2463,1249,1214
Pennsylvania,Clarion County,7,2041,1075,966
Pennsylvania,Clarion County,8,2012,991,1021
Pennsylvania,Clarion County,9,1868,909,959
Pennsylvania,Clarion County,10,2336,1146,1190
Pennsylvania,Clarion County,11,2505,1261,1244
Pennsylvania,Clarion County,12,2731,1394,1337
Pennsylvania,Clarion County,13,2791,1349,1442
Pennsylvania,Clarion County,14,2428,1198,1230
Pennsylvania,Clarion County,15,1768,839,929
Pennsylvania,Clarion County,16,1424,635,789
Pennsylvania,Clarion County,17,1019,437,582
Pennsylvania,Clarion County,18,964,358,606
Pennsylvania,Clearfield County,0,79388,41694,37694
Pennsylvania,Clearfield County,1,3685,1938,1747
Pennsylvania,Clearfield County,2,3819,1950,1869
Pennsylvania,Clearfield County,3,4327,2188,2139
Pennsylvania,Clearfield County,4,4095,2189,1906
Pennsylvania,Clearfield County,5,4724,2803,1921
Pennsylvania,Clearfield County,6,5082,2974,2108
Pennsylvania,Clearfield County,7,4529,2676,1853
Pennsylvania,Clearfield County,8,4708,2672,2036
Pennsylvania,Clearfield County,9,4742,2605,2137
Pennsylvania,Clearfield County,10,5614,3092,2522
Pennsylvania,Clearfield County,11,5778,3091,2687
Pennsylvania,Clearfield County,12,6127,3188,2939
Pennsylvania,Clearfield County,13,5867,2965,2902
Pennsylvania,Clearfield County,14,4974,2447,2527
Pennsylvania,Clearfield County,15,3989,1944,2045
Pennsylvania,Clearfield County,16,3002,1340,1662
Pennsylvania,Clearfield County,17,2070,880,1190
Pennsylvania,Clearfield County,18,2256,752,1504
Pennsylvania,Clinton County,0,38684,19036,19648
Pennsylvania,Clinton County,1,2054,1072,982
Pennsylvania,Clinton County,2,2138,1087,1051
Pennsylvania,Clinton County,3,2266,1158,1108
Pennsylvania,Clinton County,4,2924,1396,1528
Pennsylvania,Clinton County,5,3997,1826,2171
Pennsylvania,Clinton County,6,2352,1343,1009
Pennsylvania,Clinton County,7,1965,1034,931
Pennsylvania,Clinton County,8,2017,1006,1011
Pennsylvania,Clinton County,9,1953,972,981
Pennsylvania,Clinton County,10,2251,1134,1117
Pennsylvania,Clinton County,11,2277,1150,1127
Pennsylvania,Clinton County,12,2647,1315,1332
Pennsylvania,Clinton County,13,2611,1248,1363
Pennsylvania,Clinton County,14,2178,1058,1120
Pennsylvania,Clinton County,15,1778,849,929
Pennsylvania,Clinton County,16,1363,624,739
Pennsylvania,Clinton County,17,982,414,568
Pennsylvania,Clinton County,18,931,350,581
Pennsylvania,Columbia County,0,65456,31534,33922
Pennsylvania,Columbia County,1,2971,1504,1467
Pennsylvania,Columbia County,2,3114,1564,1550
Pennsylvania,Columbia County,3,3454,1716,1738
Pennsylvania,Columbia County,4,5221,2424,2797
Pennsylvania,Columbia County,5,6820,3160,3660
Pennsylvania,Columbia County,6,3702,1992,1710
Pennsylvania,Columbia County,7,3336,1681,1655
Pennsylvania,Columbia County,8,3449,1725,1724
Pennsylvania,Columbia County,9,3322,1661,1661
Pennsylvania,Columbia County,10,3906,1986,1920
Pennsylvania,Columbia County,11,4165,2086,2079
Pennsylvania,Columbia County,12,4572,2226,2346
Pennsylvania,Columbia County,13,4644,2206,2438
Pennsylvania,Columbia County,14,3975,1947,2028
Pennsylvania,Columbia County,15,3257,1455,1802
Pennsylvania,Columbia County,16,2230,975,1255
Pennsylvania,Columbia County,17,1562,615,947
Pennsylvania,Columbia County,18,1756,611,1145
Pennsylvania,Crawford County,0,85063,41672,43391
Pennsylvania,Crawford County,1,4575,2289,2286
Pennsylvania,Crawford County,2,4654,2447,2207
Pennsylvania,Crawford County,3,5070,2646,2424
Pennsylvania,Crawford County,4,5757,2883,2874
Pennsylvania,Crawford County,5,5227,2643,2584
Pennsylvania,Crawford County,6,4872,2386,2486
Pennsylvania,Crawford County,7,4512,2242,2270
Pennsylvania,Crawford County,8,4657,2261,2396
Pennsylvania,Crawford County,9,4411,2130,2281
Pennsylvania,Crawford County,10,5325,2516,2809
Pennsylvania,Crawford County,11,5738,2850,2888
Pennsylvania,Crawford County,12,6340,3030,3310
Pennsylvania,Crawford County,13,6422,3169,3253
Pennsylvania,Crawford County,14,5718,2813,2905
Pennsylvania,Crawford County,15,4627,2202,2425
Pennsylvania,Crawford County,16,3236,1545,1691
Pennsylvania,Crawford County,17,1981,902,1079
Pennsylvania,Crawford County,18,1941,718,1223
Pennsylvania,Cumberland County,0,251423,124444,126979
Pennsylvania,Cumberland County,1,13614,7016,6598
Pennsylvania,Cumberland County,2,14026,7178,6848
Pennsylvania,Cumberland County,3,14608,7430,7178
Pennsylvania,Cumberland County,4,16502,8185,8317
Pennsylvania,Cumberland County,5,16242,8239,8003
Pennsylvania,Cumberland County,6,16233,8543,7690
Pennsylvania,Cumberland County,7,16810,8863,7947
Pennsylvania,Cumberland County,8,16012,8304,7708
Pennsylvania,Cumberland County,9,14751,7553,7198
Pennsylvania,Cumberland County,10,16131,8258,7873
Pennsylvania,Cumberland County,11,16283,8159,8124
Pennsylvania,Cumberland County,12,17253,8505,8748
Pennsylvania,Cumberland County,13,16413,7826,8587
Pennsylvania,Cumberland County,14,14413,6875,7538
Pennsylvania,Cumberland County,15,11685,5343,6342
Pennsylvania,Cumberland County,16,8247,3657,4590
Pennsylvania,Cumberland County,17,5640,2256,3384
Pennsylvania,Cumberland County,18,6560,2254,4306
Pennsylvania,Dauphin County,0,277097,134218,142879
Pennsylvania,Dauphin County,1,17190,8751,8439
Pennsylvania,Dauphin County,2,17173,8792,8381
Pennsylvania,Dauphin County,3,17389,8731,8658
Pennsylvania,Dauphin County,4,16326,8446,7880
Pennsylvania,Dauphin County,5,16432,8254,8178
Pennsylvania,Dauphin County,6,20003,9839,10164
Pennsylvania,Dauphin County,7,18557,9290,9267
Pennsylvania,Dauphin County,8,17520,8502,9018
Pennsylvania,Dauphin County,9,15592,7573,8019
Pennsylvania,Dauphin County,10,17296,8585,8711
Pennsylvania,Dauphin County,11,17917,8695,9222
Pennsylvania,Dauphin County,12,19645,9360,10285
Pennsylvania,Dauphin County,13,19055,9054,10001
Pennsylvania,Dauphin County,14,15706,7332,8374
Pennsylvania,Dauphin County,15,11928,5434,6494
Pennsylvania,Dauphin County,16,7795,3402,4393
Pennsylvania,Dauphin County,17,5414,2139,3275
Pennsylvania,Dauphin County,18,6159,2039,4120
Pennsylvania,Delaware County,0,564751,271816,292935
Pennsylvania,Delaware County,1,33310,17026,16284
Pennsylvania,Delaware County,2,34439,17444,16995
Pennsylvania,Delaware County,3,34465,17619,16846
Pennsylvania,Delaware County,4,39199,20245,18954
Pennsylvania,Delaware County,5,38018,18921,19097
Pennsylvania,Delaware County,6,36867,18261,18606
Pennsylvania,Delaware County,7,37216,18205,19011
Pennsylvania,Delaware County,8,35856,17400,18456
Pennsylvania,Delaware County,9,32288,15751,16537
Pennsylvania,Delaware County,10,34511,16635,17876
Pennsylvania,Delaware County,11,37222,17869,19353
Pennsylvania,Delaware County,12,40322,19164,21158
Pennsylvania,Delaware County,13,38431,18035,20396
Pennsylvania,Delaware County,14,29771,13811,15960
Pennsylvania,Delaware County,15,21861,9800,12061
Pennsylvania,Delaware County,16,15370,6537,8833
Pennsylvania,Delaware County,17,10966,4283,6683
Pennsylvania,Delaware County,18,14639,4810,9829
Pennsylvania,Elk County,0,30169,15145,15024
Pennsylvania,Elk County,1,1522,785,737
Pennsylvania,Elk County,2,1582,812,770
Pennsylvania,Elk County,3,1664,875,789
Pennsylvania,Elk County,4,1669,839,830
Pennsylvania,Elk County,5,1581,824,757
Pennsylvania,Elk County,6,1449,762,687
Pennsylvania,Elk County,7,1510,821,689
Pennsylvania,Elk County,8,1530,792,738
Pennsylvania,Elk County,9,1512,712,800
Pennsylvania,Elk County,10,2078,1068,1010
Pennsylvania,Elk County,11,2349,1185,1164
Pennsylvania,Elk County,12,2590,1357,1233
Pennsylvania,Elk County,13,2493,1289,1204
Pennsylvania,Elk County,14,2027,1016,1011
Pennsylvania,Elk County,15,1530,741,789
Pennsylvania,Elk County,16,1242,568,674
Pennsylvania,Elk County,17,895,387,508
Pennsylvania,Elk County,18,946,312,634
Pennsylvania,Erie County,0,272061,134373,137688
Pennsylvania,Erie County,1,15343,7833,7510
Pennsylvania,Erie County,2,15759,8033,7726
Pennsylvania,Erie County,3,16722,8593,8129
Pennsylvania,Erie County,4,19021,9795,9226
Pennsylvania,Erie County,5,17825,9182,8643
Pennsylvania,Erie County,6,18512,9464,9048
Pennsylvania,Erie County,7,17062,8694,8368
Pennsylvania,Erie County,8,16077,8133,7944
Pennsylvania,Erie County,9,14532,7224,7308
Pennsylvania,Erie County,10,16483,8195,8288
Pennsylvania,Erie County,11,17219,8521,8698
Pennsylvania,Erie County,12,19176,9453,9723
Pennsylvania,Erie County,13,19430,9486,9944
Pennsylvania,Erie County,14,16254,7799,8455
Pennsylvania,Erie County,15,11703,5538,6165
Pennsylvania,Erie County,16,8378,3733,4645
Pennsylvania,Erie County,17,5627,2351,3276
Pennsylvania,Erie County,18,6938,2346,4592
Pennsylvania,Fayette County,0,130441,64616,65825
Pennsylvania,Fayette County,1,6654,3361,3293
Pennsylvania,Fayette County,2,6696,3399,3297
Pennsylvania,Fayette County,3,7072,3644,3428
Pennsylvania,Fayette County,4,7011,3565,3446
Pennsylvania,Fayette County,5,7117,3712,3405
Pennsylvania,Fayette County,6,8229,4507,3722
Pennsylvania,Fayette County,7,7387,3990,3397
Pennsylvania,Fayette County,8,7187,3644,3543
Pennsylvania,Fayette County,9,7489,3793,3696
Pennsylvania,Fayette County,10,8750,4412,4338
Pennsylvania,Fayette County,11,9110,4548,4562
Pennsylvania,Fayette County,12,9828,4786,5042
Pennsylvania,Fayette County,13,10308,5030,5278
Pennsylvania,Fayette County,14,8944,4396,4548
Pennsylvania,Fayette County,15,6647,3084,3563
Pennsylvania,Fayette County,16,4892,2179,2713
Pennsylvania,Fayette County,17,3369,1363,2006
Pennsylvania,Fayette County,18,3751,1203,2548
Pennsylvania,Forest County,0,7279,4985,2294
Pennsylvania,Forest County,1,152,82,70
Pennsylvania,Forest County,2,147,75,72
Pennsylvania,Forest County,3,182,99,83
Pennsylvania,Forest County,4,445,339,106
Pennsylvania,Forest County,5,659,578,81
Pennsylvania,Forest County,6,728,649,79
Pennsylvania,Forest County,7,563,475,88
Pennsylvania,Forest County,8,459,368,91
Pennsylvania,Forest County,9,381,298,83
Pennsylvania,Forest County,10,468,330,138
Pennsylvania,Forest County,11,452,281,171
Pennsylvania,Forest County,12,499,287,212
Pennsylvania,Forest County,13,499,274,225
Pennsylvania,Forest County,14,463,245,218
Pennsylvania,Forest County,15,481,248,233
Pennsylvania,Forest County,16,340,170,170
Pennsylvania,Forest County,17,219,108,111
Pennsylvania,Forest County,18,142,79,63
Pennsylvania,Franklin County,0,154835,76005,78830
Pennsylvania,Franklin County,1,9328,4647,4681
Pennsylvania,Franklin County,2,9294,4789,4505
Pennsylvania,Franklin County,3,9785,5037,4748
Pennsylvania,Franklin County,4,9529,4950,4579
Pennsylvania,Franklin County,5,8198,4062,4136
Pennsylvania,Franklin County,6,9591,4863,4728
Pennsylvania,Franklin County,7,9064,4562,4502
Pennsylvania,Franklin County,8,9046,4486,4560
Pennsylvania,Franklin County,9,8871,4378,4493
Pennsylvania,Franklin County,10,10184,5148,5036
Pennsylvania,Franklin County,11,10418,5241,5177
Pennsylvania,Franklin County,12,10739,5268,5471
Pennsylvania,Franklin County,13,10363,5040,5323
Pennsylvania,Franklin County,14,8976,4151,4825
Pennsylvania,Franklin County,15,7789,3681,4108
Pennsylvania,Franklin County,16,5551,2512,3039
Pennsylvania,Franklin County,17,3903,1719,2184
Pennsylvania,Franklin County,18,4206,1471,2735
Pennsylvania,Fulton County,0,14523,7355,7168
Pennsylvania,Fulton County,1,753,400,353
Pennsylvania,Fulton County,2,764,398,366
Pennsylvania,Fulton County,3,861,453,408
Pennsylvania,Fulton County,4,843,415,428
Pennsylvania,Fulton County,5,773,418,355
Pennsylvania,Fulton County,6,778,405,373
Pennsylvania,Fulton County,7,740,349,391
Pennsylvania,Fulton County,8,770,399,371
Pennsylvania,Fulton County,9,874,451,423
Pennsylvania,Fulton County,10,998,518,480
Pennsylvania,Fulton County,11,1090,570,520
Pennsylvania,Fulton County,12,1078,561,517
Pennsylvania,Fulton County,13,1071,535,536
Pennsylvania,Fulton County,14,918,444,474
Pennsylvania,Fulton County,15,856,418,438
Pennsylvania,Fulton County,16,650,308,342
Pennsylvania,Fulton County,17,402,176,226
Pennsylvania,Fulton County,18,304,137,167
Pennsylvania,Greene County,0,36506,18903,17603
Pennsylvania,Greene County,1,1906,975,931
Pennsylvania,Greene County,2,1946,978,968
Pennsylvania,Greene County,3,2022,1066,956
Pennsylvania,Greene County,4,2275,1135,1140
Pennsylvania,Greene County,5,2360,1282,1078
Pennsylvania,Greene County,6,2388,1395,993
Pennsylvania,Greene County,7,2109,1218,891
Pennsylvania,Greene County,8,2085,1127,958
Pennsylvania,Greene County,9,2274,1258,1016
Pennsylvania,Greene County,10,2512,1340,1172
Pennsylvania,Greene County,11,2411,1297,1114
Pennsylvania,Greene County,12,2622,1342,1280
Pennsylvania,Greene County,13,2700,1304,1396
Pennsylvania,Greene County,14,2399,1213,1186
Pennsylvania,Greene County,15,1752,838,914
Pennsylvania,Greene County,16,1152,534,618
Pennsylvania,Greene County,17,750,315,435
Pennsylvania,Greene County,18,843,286,557
Pennsylvania,Huntingdon County,0,45168,24007,21161
Pennsylvania,Huntingdon County,1,1978,965,1013
Pennsylvania,Huntingdon County,2,2198,1142,1056
Pennsylvania,Huntingdon County,3,2414,1195,1219
Pennsylvania,Huntingdon County,4,2909,1455,1454
Pennsylvania,Huntingdon County,5,2937,1605,1332
Pennsylvania,Huntingdon County,6,2797,1743,1054
Pennsylvania,Huntingdon County,7,2833,1748,1085
Pennsylvania,Huntingdon County,8,2642,1546,1096
Pennsylvania,Huntingdon County,9,2628,1535,1093
Pennsylvania,Huntingdon County,10,2949,1713,1236
Pennsylvania,Huntingdon County,11,3083,1654,1429
Pennsylvania,Huntingdon County,12,3248,1737,1511
Pennsylvania,Huntingdon County,13,3186,1580,1606
Pennsylvania,Huntingdon County,14,2848,1405,1443
Pennsylvania,Huntingdon County,15,2469,1254,1215
Pennsylvania,Huntingdon County,16,1737,796,941
Pennsylvania,Huntingdon County,17,1151,512,639
Pennsylvania,Huntingdon County,18,1161,422,739
Pennsylvania,Indiana County,0,84501,42325,42176
Pennsylvania,Indiana County,1,4052,2119,1933
Pennsylvania,Indiana County,2,4149,2163,1986
Pennsylvania,Indiana County,3,4363,2228,2135
Pennsylvania,Indiana County,4,6779,3321,3458
Pennsylvania,Indiana County,5,9395,4780,4615
Pennsylvania,Indiana County,6,4833,2732,2101
Pennsylvania,Indiana County,7,4251,2219,2032
Pennsylvania,Indiana County,8,4352,2264,2088
Pennsylvania,Indiana County,9,3983,2025,1958
Pennsylvania,Indiana County,10,4683,2380,2303
Pennsylvania,Indiana County,11,5209,2615,2594
Pennsylvania,Indiana County,12,5907,2923,2984
Pennsylvania,Indiana County,13,6065,3052,3013
Pennsylvania,Indiana County,14,5273,2626,2647
Pennsylvania,Indiana County,15,3949,1909,2040
Pennsylvania,Indiana County,16,3037,1389,1648
Pennsylvania,Indiana County,17,2069,917,1152
Pennsylvania,Indiana County,18,2152,663,1489
Pennsylvania,Jefferson County,0,43641,21732,21909
Pennsylvania,Jefferson County,1,2389,1239,1150
Pennsylvania,Jefferson County,2,2607,1336,1271
Pennsylvania,Jefferson County,3,2574,1299,1275
Pennsylvania,Jefferson County,4,2549,1305,1244
Pennsylvania,Jefferson County,5,2245,1150,1095
Pennsylvania,Jefferson County,6,2590,1338,1252
Pennsylvania,Jefferson County,7,2420,1257,1163
Pennsylvania,Jefferson County,8,2427,1222,1205
Pennsylvania,Jefferson County,9,2315,1177,1138
Pennsylvania,Jefferson County,10,2681,1356,1325
Pennsylvania,Jefferson County,11,2917,1479,1438
Pennsylvania,Jefferson County,12,3320,1682,1638
Pennsylvania,Jefferson County,13,3410,1698,1712
Pennsylvania,Jefferson County,14,2835,1377,1458
Pennsylvania,Jefferson County,15,2168,1079,1089
Pennsylvania,Jefferson County,16,1698,767,931
Pennsylvania,Jefferson County,17,1220,531,689
Pennsylvania,Jefferson County,18,1276,440,836
Pennsylvania,Juniata County,0,24704,12385,12319
Pennsylvania,Juniata County,1,1398,708,690
Pennsylvania,Juniata County,2,1498,769,729
Pennsylvania,Juniata County,3,1584,815,769
Pennsylvania,Juniata County,4,1585,813,772
Pennsylvania,Juniata County,5,1330,683,647
Pennsylvania,Juniata County,6,1398,721,677
Pennsylvania,Juniata County,7,1354,685,669
Pennsylvania,Juniata County,8,1425,724,701
Pennsylvania,Juniata County,9,1312,656,656
Pennsylvania,Juniata County,10,1576,813,763
Pennsylvania,Juniata County,11,1697,865,832
Pennsylvania,Juniata County,12,1803,919,884
Pennsylvania,Juniata County,13,1782,876,906
Pennsylvania,Juniata County,14,1476,756,720
Pennsylvania,Juniata County,15,1291,657,634
Pennsylvania,Juniata County,16,873,407,466
Pennsylvania,Juniata County,17,656,276,380
Pennsylvania,Juniata County,18,666,242,424
Pennsylvania,Lackawanna County,0,210793,102330,108463
Pennsylvania,Lackawanna County,1,11321,5821,5500
Pennsylvania,Lackawanna County,2,11841,6078,5763
Pennsylvania,Lackawanna County,3,12545,6593,5952
Pennsylvania,Lackawanna County,4,13220,6614,6606
Pennsylvania,Lackawanna County,5,12619,6120,6499
Pennsylvania,Lackawanna County,6,13481,6879,6602
Pennsylvania,Lackawanna County,7,12911,6515,6396
Pennsylvania,Lackawanna County,8,12308,6153,6155
Pennsylvania,Lackawanna County,9,11481,5660,5821
Pennsylvania,Lackawanna County,10,13134,6517,6617
Pennsylvania,Lackawanna County,11,13980,6834,7146
Pennsylvania,Lackawanna County,12,15286,7441,7845
Pennsylvania,Lackawanna County,13,14605,7003,7602
Pennsylvania,Lackawanna County,14,12913,6224,6689
Pennsylvania,Lackawanna County,15,10201,4716,5485
Pennsylvania,Lackawanna County,16,7398,3287,4111
Pennsylvania,Lackawanna County,17,5141,1989,3152
Pennsylvania,Lackawanna County,18,6408,1886,4522
Pennsylvania,Lancaster County,0,543557,266316,277241
Pennsylvania,Lancaster County,1,35196,18157,17039
Pennsylvania,Lancaster County,2,35304,18200,17104
Pennsylvania,Lancaster County,3,35908,18278,17630
Pennsylvania,Lancaster County,4,36021,18221,17800
Pennsylvania,Lancaster County,5,34044,16962,17082
Pennsylvania,Lancaster County,6,37012,18564,18448
Pennsylvania,Lancaster County,7,34645,17301,17344
Pennsylvania,Lancaster County,8,32353,16062,16291
Pennsylvania,Lancaster County,9,29540,14634,14906
Pennsylvania,Lancaster County,10,31240,15500,15740
Pennsylvania,Lancaster County,11,33598,16562,17036
Pennsylvania,Lancaster County,12,36424,17608,18816
Pennsylvania,Lancaster County,13,34712,16786,17926
Pennsylvania,Lancaster County,14,29138,13810,15328
Pennsylvania,Lancaster County,15,23654,11087,12567
Pennsylvania,Lancaster County,16,17158,7747,9411
Pennsylvania,Lancaster County,17,12258,5209,7049
Pennsylvania,Lancaster County,18,15352,5628,9724
Pennsylvania,Lawrence County,0,86184,41712,44472
Pennsylvania,Lawrence County,1,4494,2268,2226
Pennsylvania,Lawrence County,2,4552,2297,2255
Pennsylvania,Lawrence County,3,4954,2452,2502
Pennsylvania,Lawrence County,4,5120,2594,2526
Pennsylvania,Lawrence County,5,5014,2602,2412
Pennsylvania,Lawrence County,6,4920,2539,2381
Pennsylvania,Lawrence County,7,4502,2332,2170
Pennsylvania,Lawrence County,8,4703,2274,2429
Pennsylvania,Lawrence County,9,4539,2249,2290
Pennsylvania,Lawrence County,10,5390,2682,2708
Pennsylvania,Lawrence County,11,5629,2780,2849
Pennsylvania,Lawrence County,12,6501,3084,3417
Pennsylvania,Lawrence County,13,6915,3381,3534
Pennsylvania,Lawrence County,14,5860,2795,3065
Pennsylvania,Lawrence County,15,4375,1967,2408
Pennsylvania,Lawrence County,16,3294,1462,1832
Pennsylvania,Lawrence County,17,2501,981,1520
Pennsylvania,Lawrence County,18,2921,973,1948
Pennsylvania,Lebanon County,0,141314,69449,71865
Pennsylvania,Lebanon County,1,8274,4207,4067
Pennsylvania,Lebanon County,2,9118,4605,4513
Pennsylvania,Lebanon County,3,9187,4773,4414
Pennsylvania,Lebanon County,4,9011,4662,4349
Pennsylvania,Lebanon County,5,8547,4344,4203
Pennsylvania,Lebanon County,6,8355,4229,4126
Pennsylvania,Lebanon County,7,8226,4109,4117
Pennsylvania,Lebanon County,8,8499,4234,4265
Pennsylvania,Lebanon County,9,8026,4011,4015
Pennsylvania,Lebanon County,10,8589,4305,4284
Pennsylvania,Lebanon County,11,9002,4458,4544
Pennsylvania,Lebanon County,12,9714,4782,4932
Pennsylvania,Lebanon County,13,9369,4534,4835
Pennsylvania,Lebanon County,14,8249,3977,4272
Pennsylvania,Lebanon County,15,6688,3170,3518
Pennsylvania,Lebanon County,16,5010,2210,2800
Pennsylvania,Lebanon County,17,3394,1428,1966
Pennsylvania,Lebanon County,18,4056,1411,2645
Pennsylvania,Lehigh County,0,368100,180188,187912
Pennsylvania,Lehigh County,1,21831,11295,10536
Pennsylvania,Lehigh County,2,22603,11603,11000
Pennsylvania,Lehigh County,3,24125,12561,11564
Pennsylvania,Lehigh County,4,24325,12366,11959
Pennsylvania,Lehigh County,5,23887,11833,12054
Pennsylvania,Lehigh County,6,24658,12478,12180
Pennsylvania,Lehigh County,7,24097,12101,11996
Pennsylvania,Lehigh County,8,23760,11818,11942
Pennsylvania,Lehigh County,9,21981,10981,11000
Pennsylvania,Lehigh County,10,22936,11301,11635
Pennsylvania,Lehigh County,11,24221,11840,12381
Pennsylvania,Lehigh County,12,25007,12202,12805
Pennsylvania,Lehigh County,13,23162,10973,12189
Pennsylvania,Lehigh County,14,18915,8947,9968
Pennsylvania,Lehigh County,15,15183,7018,8165
Pennsylvania,Lehigh County,16,10913,4829,6084
Pennsylvania,Lehigh County,17,7463,3030,4433
Pennsylvania,Lehigh County,18,9033,3012,6021
Pennsylvania,Luzerne County,0,317646,157145,160501
Pennsylvania,Luzerne County,1,16393,8261,8132
Pennsylvania,Luzerne County,2,16912,8568,8344
Pennsylvania,Luzerne County,3,17835,9142,8693
Pennsylvania,Luzerne County,4,19618,10202,9416
Pennsylvania,Luzerne County,5,19401,10120,9281
Pennsylvania,Luzerne County,6,21120,11280,9840
Pennsylvania,Luzerne County,7,19241,10125,9116
Pennsylvania,Luzerne County,8,18558,9601,8957
Pennsylvania,Luzerne County,9,17771,8964,8807
Pennsylvania,Luzerne County,10,20788,10471,10317
Pennsylvania,Luzerne County,11,22041,11166,10875
Pennsylvania,Luzerne County,12,22947,11366,11581
Pennsylvania,Luzerne County,13,21837,10622,11215
Pennsylvania,Luzerne County,14,19085,9090,9995
Pennsylvania,Luzerne County,15,15596,7328,8268
Pennsylvania,Luzerne County,16,11092,4869,6223
Pennsylvania,Luzerne County,17,7755,3050,4705
Pennsylvania,Luzerne County,18,9656,2920,6736
Pennsylvania,Lycoming County,0,113664,55665,57999
Pennsylvania,Lycoming County,1,6061,3114,2947
Pennsylvania,Lycoming County,2,6501,3280,3221
Pennsylvania,Lycoming County,3,6737,3395,3342
Pennsylvania,Lycoming County,4,7136,3755,3381
Pennsylvania,Lycoming County,5,6895,3544,3351
Pennsylvania,Lycoming County,6,7725,4030,3695
Pennsylvania,Lycoming County,7,7176,3620,3556
Pennsylvania,Lycoming County,8,6666,3271,3395
Pennsylvania,Lycoming County,9,5931,2835,3096
Pennsylvania,Lycoming County,10,6846,3277,3569
Pennsylvania,Lycoming County,11,7443,3660,3783
Pennsylvania,Lycoming County,12,8306,4065,4241
Pennsylvania,Lycoming County,13,8306,4115,4191
Pennsylvania,Lycoming County,14,6901,3379,3522
Pennsylvania,Lycoming County,15,5351,2487,2864
Pennsylvania,Lycoming County,16,3754,1597,2157
Pennsylvania,Lycoming County,17,2754,1163,1591
Pennsylvania,Lycoming County,18,3175,1078,2097
Pennsylvania,McKean County,0,40968,21054,19914
Pennsylvania,McKean County,1,1942,1030,912
Pennsylvania,McKean County,2,2225,1185,1040
Pennsylvania,McKean County,3,2423,1237,1186
Pennsylvania,McKean County,4,2649,1401,1248
Pennsylvania,McKean County,5,2542,1355,1187
Pennsylvania,McKean County,6,2438,1360,1078
Pennsylvania,McKean County,7,2451,1417,1034
Pennsylvania,McKean County,8,2307,1296,1011
Pennsylvania,McKean County,9,2343,1235,1108
Pennsylvania,McKean County,10,2712,1434,1278
Pennsylvania,McKean County,11,2747,1414,1333
Pennsylvania,McKean County,12,3057,1514,1543
Pennsylvania,McKean County,13,3172,1577,1595
Pennsylvania,McKean County,14,2474,1233,1241
Pennsylvania,McKean County,15,1928,906,1022
Pennsylvania,McKean County,16,1418,652,766
Pennsylvania,McKean County,17,1015,409,606
Pennsylvania,McKean County,18,1125,399,726
Pennsylvania,Mercer County,0,110683,54732,55951
Pennsylvania,Mercer County,1,5502,2885,2617
Pennsylvania,Mercer County,2,5509,2841,2668
Pennsylvania,Mercer County,3,6225,3118,3107
Pennsylvania,Mercer County,4,7470,4028,3442
Pennsylvania,Mercer County,5,7492,3868,3624
Pennsylvania,Mercer County,6,5902,3122,2780
Pennsylvania,Mercer County,7,5727,2926,2801
Pennsylvania,Mercer County,8,5841,2963,2878
Pennsylvania,Mercer County,9,5836,2964,2872
Pennsylvania,Mercer County,10,6842,3446,3396
Pennsylvania,Mercer County,11,7591,3822,3769
Pennsylvania,Mercer County,12,8298,4095,4203
Pennsylvania,Mercer County,13,8457,4123,4334
Pennsylvania,Mercer County,14,7301,3581,3720
Pennsylvania,Mercer County,15,5649,2584,3065
Pennsylvania,Mercer County,16,4253,1857,2396
Pennsylvania,Mercer County,17,3046,1264,1782
Pennsylvania,Mercer County,18,3742,1245,2497
Pennsylvania,Mifflin County,0,46222,22636,23586
Pennsylvania,Mifflin County,1,2805,1398,1407
Pennsylvania,Mifflin County,2,2816,1415,1401
Pennsylvania,Mifflin County,3,2854,1460,1394
Pennsylvania,Mifflin County,4,2699,1412,1287
Pennsylvania,Mifflin County,5,2438,1252,1186
Pennsylvania,Mifflin County,6,2732,1411,1321
Pennsylvania,Mifflin County,7,2478,1278,1200
Pennsylvania,Mifflin County,8,2483,1211,1272
Pennsylvania,Mifflin County,9,2334,1157,1177
Pennsylvania,Mifflin County,10,2928,1415,1513
Pennsylvania,Mifflin County,11,3183,1606,1577
Pennsylvania,Mifflin County,12,3288,1639,1649
Pennsylvania,Mifflin County,13,3150,1546,1604
Pennsylvania,Mifflin County,14,2887,1344,1543
Pennsylvania,Mifflin County,15,2444,1111,1333
Pennsylvania,Mifflin County,16,1975,937,1038
Pennsylvania,Mifflin County,17,1348,595,753
Pennsylvania,Mifflin County,18,1380,449,931
Pennsylvania,Monroe County,0,169507,83972,85535
Pennsylvania,Monroe County,1,7645,3911,3734
Pennsylvania,Monroe County,2,8579,4404,4175
Pennsylvania,Monroe County,3,10159,5214,4945
Pennsylvania,Monroe County,4,12628,6362,6266
Pennsylvania,Monroe County,5,12361,6289,6072
Pennsylvania,Monroe County,6,10151,5386,4765
Pennsylvania,Monroe County,7,9083,4705,4378
Pennsylvania,Monroe County,8,8775,4277,4498
Pennsylvania,Monroe County,9,9385,4382,5003
Pennsylvania,Monroe County,10,11092,5248,5844
Pennsylvania,Monroe County,11,13412,6613,6799
Pennsylvania,Monroe County,12,14292,7146,7146
Pennsylvania,Monroe County,13,12764,6330,6434
Pennsylvania,Monroe County,14,10046,5000,5046
Pennsylvania,Monroe County,15,7800,3811,3989
Pennsylvania,Monroe County,16,5095,2378,2717
Pennsylvania,Monroe County,17,3297,1430,1867
Pennsylvania,Monroe County,18,2943,1086,1857
Pennsylvania,Montgomery County,0,828604,403268,425336
Pennsylvania,Montgomery County,1,45445,23241,22204
Pennsylvania,Montgomery County,2,49084,25180,23904
Pennsylvania,Montgomery County,3,51916,26399,25517
Pennsylvania,Montgomery County,4,50911,25661,25250
Pennsylvania,Montgomery County,5,47071,23368,23703
Pennsylvania,Montgomery County,6,49799,25577,24222
Pennsylvania,Montgomery County,7,54095,27210,26885
Pennsylvania,Montgomery County,8,54058,27232,26826
Pennsylvania,Montgomery County,9,49750,24573,25177
Pennsylvania,Montgomery County,10,54402,26907,27495
Pennsylvania,Montgomery County,11,58005,28259,29746
Pennsylvania,Montgomery County,12,60632,29218,31414
Pennsylvania,Montgomery County,13,56312,27000,29312
Pennsylvania,Montgomery County,14,45240,21319,23921
Pennsylvania,Montgomery County,15,35487,16061,19426
Pennsylvania,Montgomery County,16,25180,11014,14166
Pennsylvania,Montgomery County,17,17889,7158,10731
Pennsylvania,Montgomery County,18,23328,7891,15437
Pennsylvania,Montour County,0,18240,8814,9426
Pennsylvania,Montour County,1,1048,549,499
Pennsylvania,Montour County,2,1009,509,500
Pennsylvania,Montour County,3,1021,560,461
Pennsylvania,Montour County,4,985,542,443
Pennsylvania,Montour County,5,832,403,429
Pennsylvania,Montour County,6,1180,587,593
Pennsylvania,Montour County,7,1300,708,592
Pennsylvania,Montour County,8,1093,562,531
Pennsylvania,Montour County,9,974,441,533
Pennsylvania,Montour County,10,1026,494,532
Pennsylvania,Montour County,11,1151,561,590
Pennsylvania,Montour County,12,1440,696,744
Pennsylvania,Montour County,13,1343,644,699
Pennsylvania,Montour County,14,1095,512,583
Pennsylvania,Montour County,15,868,390,478
Pennsylvania,Montour County,16,645,279,366
Pennsylvania,Montour County,17,581,205,376
Pennsylvania,Montour County,18,649,172,477
Pennsylvania,Northampton County,0,304807,149954,154853
Pennsylvania,Northampton County,1,14777,7627,7150
Pennsylvania,Northampton County,2,16338,8425,7913
Pennsylvania,Northampton County,3,18204,9347,8857
Pennsylvania,Northampton County,4,21221,11072,10149
Pennsylvania,Northampton County,5,20293,10765,9528
Pennsylvania,Northampton County,6,18681,9720,8961
Pennsylvania,Northampton County,7,18095,9187,8908
Pennsylvania,Northampton County,8,17930,8815,9115
Pennsylvania,Northampton County,9,17126,8378,8748
Pennsylvania,Northampton County,10,19445,9583,9862
Pennsylvania,Northampton County,11,21179,10430,10749
Pennsylvania,Northampton County,12,22337,10947,11390
Pennsylvania,Northampton County,13,21226,10263,10963
Pennsylvania,Northampton County,14,17537,8326,9211
Pennsylvania,Northampton County,15,14454,6704,7750
Pennsylvania,Northampton County,16,10031,4490,5541
Pennsylvania,Northampton County,17,6806,2809,3997
Pennsylvania,Northampton County,18,9127,3066,6061
Pennsylvania,Northumberland County,0,91083,45782,45301
Pennsylvania,Northumberland County,1,4687,2418,2269
Pennsylvania,Northumberland County,2,4808,2475,2333
Pennsylvania,Northumberland County,3,5080,2595,2485
Pennsylvania,Northumberland County,4,4862,2544,2318
Pennsylvania,Northumberland County,5,4903,2702,2201
Pennsylvania,Northumberland County,6,5647,3054,2593
Pennsylvania,Northumberland County,7,5429,2920,2509
Pennsylvania,Northumberland County,8,5381,2818,2563
Pennsylvania,Northumberland County,9,5051,2682,2369
Pennsylvania,Northumberland County,10,5755,2988,2767
Pennsylvania,Northumberland County,11,6342,3259,3083
Pennsylvania,Northumberland County,12,6813,3368,3445
Pennsylvania,Northumberland County,13,6867,3380,3487
Pennsylvania,Northumberland County,14,5911,2880,3031
Pennsylvania,Northumberland County,15,4809,2238,2571
Pennsylvania,Northumberland County,16,3395,1495,1900
Pennsylvania,Northumberland County,17,2519,1047,1472
Pennsylvania,Northumberland County,18,2824,919,1905
Pennsylvania,Perry County,0,46139,23328,22811
Pennsylvania,Perry County,1,2629,1340,1289
Pennsylvania,Perry County,2,2756,1434,1322
Pennsylvania,Perry County,3,2735,1460,1275
Pennsylvania,Perry County,4,2665,1484,1181
Pennsylvania,Perry County,5,2342,1193,1149
Pennsylvania,Perry County,6,2854,1481,1373
Pennsylvania,Perry County,7,2657,1351,1306
Pennsylvania,Perry County,8,2784,1428,1356
Pennsylvania,Perry County,9,2585,1259,1326
Pennsylvania,Perry County,10,3120,1591,1529
Pennsylvania,Perry County,11,3469,1776,1693
Pennsylvania,Perry County,12,3523,1777,1746
Pennsylvania,Perry County,13,3489,1704,1785
Pennsylvania,Perry County,14,3083,1603,1480
Pennsylvania,Perry County,15,2210,1101,1109
Pennsylvania,Perry County,16,1476,697,779
Pennsylvania,Perry County,17,924,385,539
Pennsylvania,Perry County,18,838,264,574
Pennsylvania,Philadelphia County,0,1584138,749572,834566
Pennsylvania,Philadelphia County,1,104152,53298,50854
Pennsylvania,Philadelphia County,2,98333,50013,48320
Pennsylvania,Philadelphia County,3,89747,45377,44370
Pennsylvania,Philadelphia County,4,96506,48344,48162
Pennsylvania,Philadelphia County,5,111995,54825,57170
Pennsylvania,Philadelphia County,6,161335,77848,83487
Pennsylvania,Philadelphia County,7,141434,68680,72754
Pennsylvania,Philadelphia County,8,110080,52600,57480
Pennsylvania,Philadelphia County,9,88432,42053,46379
Pennsylvania,Philadelphia County,10,89427,42341,47086
Pennsylvania,Philadelphia County,11,92065,43425,48640
Pennsylvania,Philadelphia County,12,94614,43644,50970
Pennsylvania,Philadelphia County,13,89742,40368,49374
Pennsylvania,Philadelphia County,14,71042,31055,39987
Pennsylvania,Philadelphia County,15,53089,22367,30722
Pennsylvania,Philadelphia County,16,36463,14504,21959
Pennsylvania,Philadelphia County,17,25626,9483,16143
Pennsylvania,Philadelphia County,18,30056,9347,20709
Pennsylvania,Pike County,0,55933,28368,27565
Pennsylvania,Pike County,1,2166,1101,1065
Pennsylvania,Pike County,2,2477,1307,1170
Pennsylvania,Pike County,3,3200,1695,1505
Pennsylvania,Pike County,4,3433,1781,1652
Pennsylvania,Pike County,5,3132,1663,1469
Pennsylvania,Pike County,6,2762,1524,1238
Pennsylvania,Pike County,7,2513,1348,1165
Pennsylvania,Pike County,8,2855,1454,1401
Pennsylvania,Pike County,9,2956,1500,1456
Pennsylvania,Pike County,10,3684,1784,1900
Pennsylvania,Pike County,11,4573,2271,2302
Pennsylvania,Pike County,12,4969,2505,2464
Pennsylvania,Pike County,13,4472,2251,2221
Pennsylvania,Pike County,14,4024,2009,2015
Pennsylvania,Pike County,15,3428,1672,1756
Pennsylvania,Pike County,16,2585,1275,1310
Pennsylvania,Pike County,17,1446,706,740
Pennsylvania,Pike County,18,1258,522,736
Pennsylvania,Potter County,0,16622,8285,8337
Pennsylvania,Potter County,1,862,422,440
Pennsylvania,Potter County,2,926,459,467
Pennsylvania,Potter County,3,957,502,455
Pennsylvania,Potter County,4,965,509,456
Pennsylvania,Potter County,5,814,450,364
Pennsylvania,Potter County,6,874,443,431
Pennsylvania,Potter County,7,779,393,386
Pennsylvania,Potter County,8,847,425,422
Pennsylvania,Potter County,9,813,396,417
Pennsylvania,Potter County,10,979,501,478
Pennsylvania,Potter County,11,1160,601,559
Pennsylvania,Potter County,12,1296,625,671
Pennsylvania,Potter County,13,1350,681,669
Pennsylvania,Potter County,14,1266,635,631
Pennsylvania,Potter County,15,980,474,506
Pennsylvania,Potter County,16,735,374,361
Pennsylvania,Potter County,17,495,228,267
Pennsylvania,Potter County,18,524,167,357
Pennsylvania,Schuylkill County,0,142067,72796,69271
Pennsylvania,Schuylkill County,1,6957,3580,3377
Pennsylvania,Schuylkill County,2,7530,3895,3635
Pennsylvania,Schuylkill County,3,8427,4360,4067
Pennsylvania,Schuylkill County,4,7686,4058,3628
Pennsylvania,Schuylkill County,5,7418,4011,3407
Pennsylvania,Schuylkill County,6,8731,4995,3736
Pennsylvania,Schuylkill County,7,8292,4609,3683
Pennsylvania,Schuylkill County,8,8562,4637,3925
Pennsylvania,Schuylkill County,9,8214,4449,3765
Pennsylvania,Schuylkill County,10,9870,5267,4603
Pennsylvania,Schuylkill County,11,10400,5469,4931
Pennsylvania,Schuylkill County,12,10586,5374,5212
Pennsylvania,Schuylkill County,13,10388,5173,5215
Pennsylvania,Schuylkill County,14,8980,4399,4581
Pennsylvania,Schuylkill County,15,7277,3496,3781
Pennsylvania,Schuylkill County,16,5002,2253,2749
Pennsylvania,Schuylkill County,17,3604,1460,2144
Pennsylvania,Schuylkill County,18,4143,1311,2832
Pennsylvania,Snyder County,0,40540,20092,20448
Pennsylvania,Snyder County,1,2182,1124,1058
Pennsylvania,Snyder County,2,2185,1148,1037
Pennsylvania,Snyder County,3,2585,1375,1210
Pennsylvania,Snyder County,4,3296,1644,1652
Pennsylvania,Snyder County,5,2939,1483,1456
Pennsylvania,Snyder County,6,2340,1178,1162
Pennsylvania,Snyder County,7,2194,1111,1083
Pennsylvania,Snyder County,8,2201,1133,1068
Pennsylvania,Snyder County,9,2181,1045,1136
Pennsylvania,Snyder County,10,2490,1271,1219
Pennsylvania,Snyder County,11,2716,1370,1346
Pennsylvania,Snyder County,12,2809,1406,1403
Pennsylvania,Snyder County,13,2728,1349,1379
Pennsylvania,Snyder County,14,2223,1101,1122
Pennsylvania,Snyder County,15,1998,917,1081
Pennsylvania,Snyder County,16,1445,654,791
Pennsylvania,Snyder County,17,993,438,555
Pennsylvania,Snyder County,18,1035,345,690
Pennsylvania,Somerset County,0,73952,38648,35304
Pennsylvania,Somerset County,1,3367,1720,1647
Pennsylvania,Somerset County,2,3506,1748,1758
Pennsylvania,Somerset County,3,3882,2003,1879
Pennsylvania,Somerset County,4,3802,1930,1872
Pennsylvania,Somerset County,5,3952,2337,1615
Pennsylvania,Somerset County,6,4385,2597,1788
Pennsylvania,Somerset County,7,4192,2460,1732
Pennsylvania,Somerset County,8,4276,2450,1826
Pennsylvania,Somerset County,9,4313,2410,1903
Pennsylvania,Somerset County,10,4956,2706,2250
Pennsylvania,Somerset County,11,5226,2795,2431
Pennsylvania,Somerset County,12,5708,2923,2785
Pennsylvania,Somerset County,13,5852,3003,2849
Pennsylvania,Somerset County,14,5158,2607,2551
Pennsylvania,Somerset County,15,3967,1938,2029
Pennsylvania,Somerset County,16,2888,1301,1587
Pennsylvania,Somerset County,17,2080,865,1215
Pennsylvania,Somerset County,18,2442,855,1587
Pennsylvania,Sullivan County,0,6071,3176,2895
Pennsylvania,Sullivan County,1,175,87,88
Pennsylvania,Sullivan County,2,165,87,78
Pennsylvania,Sullivan County,3,154,76,78
Pennsylvania,Sullivan County,4,322,223,99
Pennsylvania,Sullivan County,5,335,212,123
Pennsylvania,Sullivan County,6,294,165,129
Pennsylvania,Sullivan County,7,286,156,130
Pennsylvania,Sullivan County,8,316,156,160
Pennsylvania,Sullivan County,9,290,154,136
Pennsylvania,Sullivan County,10,346,197,149
Pennsylvania,Sullivan County,11,437,219,218
Pennsylvania,Sullivan County,12,584,291,293
Pennsylvania,Sullivan County,13,649,321,328
Pennsylvania,Sullivan County,14,522,277,245
Pennsylvania,Sullivan County,15,438,208,230
Pennsylvania,Sullivan County,16,324,169,155
Pennsylvania,Sullivan County,17,229,109,120
Pennsylvania,Sullivan County,18,205,69,136
Pennsylvania,Susquehanna County,0,40589,20465,20124
Pennsylvania,Susquehanna County,1,1857,954,903
Pennsylvania,Susquehanna County,2,2015,988,1027
Pennsylvania,Susquehanna County,3,2251,1151,1100
Pennsylvania,Susquehanna County,4,2174,1151,1023
Pennsylvania,Susquehanna County,5,1945,1065,880
Pennsylvania,Susquehanna County,6,2148,1154,994
Pennsylvania,Susquehanna County,7,1975,1004,971
Pennsylvania,Susquehanna County,8,2119,1066,1053
Pennsylvania,Susquehanna County,9,1929,986,943
Pennsylvania,Susquehanna County,10,2537,1290,1247
Pennsylvania,Susquehanna County,11,2914,1479,1435
Pennsylvania,Susquehanna County,12,3603,1812,1791
Pennsylvania,Susquehanna County,13,3518,1814,1704
Pennsylvania,Susquehanna County,14,2977,1442,1535
Pennsylvania,Susquehanna County,15,2490,1284,1206
Pennsylvania,Susquehanna County,16,1832,853,979
Pennsylvania,Susquehanna County,17,1199,586,613
Pennsylvania,Susquehanna County,18,1106,386,720
Pennsylvania,Tioga County,0,40763,20229,20534
Pennsylvania,Tioga County,1,2149,1152,997
Pennsylvania,Tioga County,2,2227,1196,1031
Pennsylvania,Tioga County,3,2275,1153,1122
Pennsylvania,Tioga County,4,2598,1273,1325
Pennsylvania,Tioga County,5,2387,1135,1252
Pennsylvania,Tioga County,6,2306,1159,1147
Pennsylvania,Tioga County,7,2233,1148,1085
Pennsylvania,Tioga County,8,2233,1106,1127
Pennsylvania,Tioga County,9,1990,989,1001
Pennsylvania,Tioga County,10,2463,1238,1225
Pennsylvania,Tioga County,11,2702,1315,1387
Pennsylvania,Tioga County,12,3147,1532,1615
Pennsylvania,Tioga County,13,3070,1511,1559
Pennsylvania,Tioga County,14,2693,1382,1311
Pennsylvania,Tioga County,15,2289,1116,1173
Pennsylvania,Tioga County,16,1785,848,937
Pennsylvania,Tioga County,17,1126,516,610
Pennsylvania,Tioga County,18,1090,460,630
Pennsylvania,Union County,0,44785,24342,20443
Pennsylvania,Union County,1,2084,1073,1011
Pennsylvania,Union County,2,2121,1090,1031
Pennsylvania,Union County,3,2358,1221,1137
Pennsylvania,Union County,4,3775,1866,1909
Pennsylvania,Union County,5,3840,2169,1671
Pennsylvania,Union County,6,2720,1720,1000
Pennsylvania,Union County,7,3196,2075,1121
Pennsylvania,Union County,8,2923,1855,1068
Pennsylvania,Union County,9,2732,1704,1028
Pennsylvania,Union County,10,2782,1652,1130
Pennsylvania,Union County,11,2737,1513,1224
Pennsylvania,Union County,12,2786,1473,1313
Pennsylvania,Union County,13,2641,1340,1301
Pennsylvania,Union County,14,2270,1120,1150
Pennsylvania,Union County,15,1942,895,1047
Pennsylvania,Union County,16,1489,697,792
Pennsylvania,Union County,17,1096,457,639
Pennsylvania,Union County,18,1293,422,871
Pennsylvania,Venango County,0,51266,25342,25924
Pennsylvania,Venango County,1,2517,1306,1211
Pennsylvania,Venango County,2,2755,1399,1356
Pennsylvania,Venango County,3,2847,1472,1375
Pennsylvania,Venango County,4,2904,1535,1369
Pennsylvania,Venango County,5,2404,1273,1131
Pennsylvania,Venango County,6,2733,1408,1325
Pennsylvania,Venango County,7,2634,1302,1332
Pennsylvania,Venango County,8,2707,1315,1392
Pennsylvania,Venango County,9,2784,1458,1326
Pennsylvania,Venango County,10,3096,1527,1569
Pennsylvania,Venango County,11,3560,1791,1769
Pennsylvania,Venango County,12,4325,2145,2180
Pennsylvania,Venango County,13,4505,2206,2299
Pennsylvania,Venango County,14,3766,1882,1884
Pennsylvania,Venango County,15,2830,1361,1469
Pennsylvania,Venango County,16,1971,870,1101
Pennsylvania,Venango County,17,1365,580,785
Pennsylvania,Venango County,18,1563,512,1051
Pennsylvania,Warren County,0,39498,19770,19728
Pennsylvania,Warren County,1,1976,1003,973
Pennsylvania,Warren County,2,2096,1057,1039
Pennsylvania,Warren County,3,2132,1093,1039
Pennsylvania,Warren County,4,2196,1165,1031
Pennsylvania,Warren County,5,1945,1014,931
Pennsylvania,Warren County,6,2133,1150,983
Pennsylvania,Warren County,7,2014,1004,1010
Pennsylvania,Warren County,8,2125,1087,1038
Pennsylvania,Warren County,9,1958,992,966
Pennsylvania,Warren County,10,2434,1213,1221
Pennsylvania,Warren County,11,2851,1462,1389
Pennsylvania,Warren County,12,3251,1645,1606
Pennsylvania,Warren County,13,3339,1663,1676
Pennsylvania,Warren County,14,2793,1396,1397
Pennsylvania,Warren County,15,2198,1023,1175
Pennsylvania,Warren County,16,1709,820,889
Pennsylvania,Warren County,17,1143,518,625
Pennsylvania,Warren County,18,1205,465,740
Pennsylvania,Washington County,0,207346,101855,105491
Pennsylvania,Washington County,1,10426,5319,5107
Pennsylvania,Washington County,2,11140,5707,5433
Pennsylvania,Washington County,3,11638,5958,5680
Pennsylvania,Washington County,4,12368,6338,6030
Pennsylvania,Washington County,5,12202,6213,5989
Pennsylvania,Washington County,6,11722,6038,5684
Pennsylvania,Washington County,7,11610,5964,5646
Pennsylvania,Washington County,8,12089,6096,5993
Pennsylvania,Washington County,9,11631,5832,5799
Pennsylvania,Washington County,10,13348,6675,6673
Pennsylvania,Washington County,11,14509,7145,7364
Pennsylvania,Washington County,12,16037,7809,8228
Pennsylvania,Washington County,13,16009,7803,8206
Pennsylvania,Washington County,14,13641,6532,7109
Pennsylvania,Washington County,15,10634,5111,5523
Pennsylvania,Washington County,16,7460,3297,4163
Pennsylvania,Washington County,17,5119,2123,2996
Pennsylvania,Washington County,18,5763,1895,3868
Pennsylvania,Wayne County,0,51276,27158,24118
Pennsylvania,Wayne County,1,2182,1138,1044
Pennsylvania,Wayne County,2,2235,1171,1064
Pennsylvania,Wayne County,3,2391,1240,1151
Pennsylvania,Wayne County,4,2637,1367,1270
Pennsylvania,Wayne County,5,2628,1478,1150
Pennsylvania,Wayne County,6,2849,1692,1157
Pennsylvania,Wayne County,7,2874,1719,1155
Pennsylvania,Wayne County,8,2884,1652,1232
Pennsylvania,Wayne County,9,2751,1589,1162
Pennsylvania,Wayne County,10,3370,1900,1470
Pennsylvania,Wayne County,11,3639,1892,1747
Pennsylvania,Wayne County,12,4273,2224,2049
Pennsylvania,Wayne County,13,4176,2125,2051
Pennsylvania,Wayne County,14,4040,2008,2032
Pennsylvania,Wayne County,15,3333,1685,1648
Pennsylvania,Wayne County,16,2272,1145,1127
Pennsylvania,Wayne County,17,1449,652,797
Pennsylvania,Wayne County,18,1293,481,812
Pennsylvania,Westmoreland County,0,350611,171509,179102
Pennsylvania,Westmoreland County,1,15636,7948,7688
Pennsylvania,Westmoreland County,2,17473,8922,8551
Pennsylvania,Westmoreland County,3,18958,9614,9344
Pennsylvania,Westmoreland County,4,19439,10144,9295
Pennsylvania,Westmoreland County,5,18830,9721,9109
Pennsylvania,Westmoreland County,6,19083,9939,9144
Pennsylvania,Westmoreland County,7,18133,9196,8937
Pennsylvania,Westmoreland County,8,19383,9848,9535
Pennsylvania,Westmoreland County,9,18548,9184,9364
Pennsylvania,Westmoreland County,10,22841,11328,11513
Pennsylvania,Westmoreland County,11,25485,12559,12926
Pennsylvania,Westmoreland County,12,28469,13905,14564
Pennsylvania,Westmoreland County,13,28681,14135,14546
Pennsylvania,Westmoreland County,14,24907,11905,13002
Pennsylvania,Westmoreland County,15,19581,9093,10488
Pennsylvania,Westmoreland County,16,14118,6295,7823
Pennsylvania,Westmoreland County,17,9796,4000,5796
Pennsylvania,Westmoreland County,18,11250,3773,7477
Pennsylvania,Wyoming County,0,27046,13571,13475
Pennsylvania,Wyoming County,1,1270,641,629
Pennsylvania,Wyoming County,2,1359,722,637
Pennsylvania,Wyoming County,3,1612,852,760
Pennsylvania,Wyoming County,4,1651,855,796
Pennsylvania,Wyoming County,5,1601,829,772
Pennsylvania,Wyoming County,6,1524,812,712
Pennsylvania,Wyoming County,7,1479,759,720
Pennsylvania,Wyoming County,8,1455,734,721
Pennsylvania,Wyoming County,9,1438,723,715
Pennsylvania,Wyoming County,10,1805,882,923
Pennsylvania,Wyoming County,11,1822,887,935
Pennsylvania,Wyoming County,12,2169,1091,1078
Pennsylvania,Wyoming County,13,2133,1060,1073
Pennsylvania,Wyoming County,14,1847,909,938
Pennsylvania,Wyoming County,15,1571,795,776
Pennsylvania,Wyoming County,16,1115,557,558
Pennsylvania,Wyoming County,17,597,261,336
Pennsylvania,Wyoming County,18,598,202,396
Pennsylvania,York County,0,448273,221618,226655
Pennsylvania,York County,1,25487,13164,12323
Pennsylvania,York County,2,27153,13983,13170
Pennsylvania,York County,3,28936,14873,14063
Pennsylvania,York County,4,27930,14488,13442
Pennsylvania,York County,5,25659,13084,12575
Pennsylvania,York County,6,28221,14395,13826
Pennsylvania,York County,7,27577,13910,13667
Pennsylvania,York County,8,27881,13813,14068
Pennsylvania,York County,9,26077,12960,13117
Pennsylvania,York County,10,30209,14955,15254
Pennsylvania,York County,11,31297,15580,15717
Pennsylvania,York County,12,32973,16236,16737
Pennsylvania,York County,13,30657,14955,15702
Pennsylvania,York County,14,25116,12023,13093
Pennsylvania,York County,15,20046,9442,10604
Pennsylvania,York County,16,13835,6317,7518
Pennsylvania,York County,17,9306,4002,5304
Pennsylvania,York County,18,9913,3438,6475
Rhode Island,Bristol County,0,48649,23502,25147
Rhode Island,Bristol County,1,1951,997,954
Rhode Island,Bristol County,2,2431,1229,1202
Rhode Island,Bristol County,3,2874,1479,1395
Rhode Island,Bristol County,4,3735,1833,1902
Rhode Island,Bristol County,5,3424,1738,1686
Rhode Island,Bristol County,6,2514,1340,1174
Rhode Island,Bristol County,7,2366,1173,1193
Rhode Island,Bristol County,8,2691,1289,1402
Rhode Island,Bristol County,9,2608,1236,1372
Rhode Island,Bristol County,10,3265,1588,1677
Rhode Island,Bristol County,11,3586,1698,1888
Rhode Island,Bristol County,12,3908,1863,2045
Rhode Island,Bristol County,13,3700,1783,1917
Rhode Island,Bristol County,14,2887,1364,1523
Rhode Island,Bristol County,15,2273,1027,1246
Rhode Island,Bristol County,16,1608,761,847
Rhode Island,Bristol County,17,1228,513,715
Rhode Island,Bristol County,18,1600,591,1009
Rhode Island,Kent County,0,163861,79191,84670
Rhode Island,Kent County,1,8061,4077,3984
Rhode Island,Kent County,2,8201,4165,4036
Rhode Island,Kent County,3,8768,4516,4252
Rhode Island,Kent County,4,8583,4501,4082
Rhode Island,Kent County,5,8625,4387,4238
Rhode Island,Kent County,6,10935,5627,5308
Rhode Island,Kent County,7,10839,5442,5397
Rhode Island,Kent County,8,10486,5219,5267
Rhode Island,Kent County,9,9450,4666,4784
Rhode Island,Kent County,10,10896,5277,5619
Rhode Island,Kent County,11,12407,6028,6379
Rhode Island,Kent County,12,13152,6144,7008
Rhode Island,Kent County,13,12496,5907,6589
Rhode Island,Kent County,14,9992,4680,5312
Rhode Island,Kent County,15,7772,3524,4248
Rhode Island,Kent County,16,5170,2213,2957
Rhode Island,Kent County,17,3544,1376,2168
Rhode Island,Kent County,18,4484,1442,3042
Rhode Island,Newport County,0,82542,40769,41773
Rhode Island,Newport County,1,3430,1793,1637
Rhode Island,Newport County,2,3813,1903,1910
Rhode Island,Newport County,3,4144,2133,2011
Rhode Island,Newport County,4,5050,2534,2516
Rhode Island,Newport County,5,5287,2867,2420
Rhode Island,Newport County,6,5233,2818,2415
Rhode Island,Newport County,7,4749,2456,2293
Rhode Island,Newport County,8,4778,2490,2288
Rhode Island,Newport County,9,4422,2242,2180
Rhode Island,Newport County,10,4946,2422,2524
Rhode Island,Newport County,11,5760,2787,2973
Rhode Island,Newport County,12,6313,3057,3256
Rhode Island,Newport County,13,6302,2989,3313
Rhode Island,Newport County,14,5584,2671,2913
Rhode Island,Newport County,15,4754,2271,2483
Rhode Island,Newport County,16,3235,1496,1739
Rhode Island,Newport County,17,2079,919,1160
Rhode Island,Newport County,18,2663,921,1742
Rhode Island,Providence County,0,636084,309744,326340
Rhode Island,Providence County,1,36224,18626,17598
Rhode Island,Providence County,2,35044,18029,17015
Rhode Island,Providence County,3,36607,18662,17945
Rhode Island,Providence County,4,43341,21551,21790
Rhode Island,Providence County,5,47230,23531,23699
Rhode Island,Providence County,6,51377,26121,25256
Rhode Island,Providence County,7,46271,23532,22739
Rhode Island,Providence County,8,41409,20730,20679
Rhode Island,Providence County,9,36423,17965,18458
Rhode Island,Providence County,10,39668,19293,20375
Rhode Island,Providence County,11,42409,20619,21790
Rhode Island,Providence County,12,43212,20825,22387
Rhode Island,Providence County,13,39652,18827,20825
Rhode Island,Providence County,14,30606,14460,16146
Rhode Island,Providence County,15,23311,10693,12618
Rhode Island,Providence County,16,16279,6969,9310
Rhode Island,Providence County,17,11416,4508,6908
Rhode Island,Providence County,18,15605,4803,10802
Rhode Island,Washington County,0,126179,61126,65053
Rhode Island,Washington County,1,4747,2466,2281
Rhode Island,Washington County,2,5351,2732,2619
Rhode Island,Washington County,3,6428,3217,3211
Rhode Island,Washington County,4,10717,5120,5597
Rhode Island,Washington County,5,12050,6093,5957
Rhode Island,Washington County,6,6310,3263,3047
Rhode Island,Washington County,7,5637,2878,2759
Rhode Island,Washington County,8,6041,3014,3027
Rhode Island,Washington County,9,5878,2892,2986
Rhode Island,Washington County,10,7368,3502,3866
Rhode Island,Washington County,11,9065,4322,4743
Rhode Island,Washington County,12,10389,4963,5426
Rhode Island,Washington County,13,10034,4815,5219
Rhode Island,Washington County,14,8656,4203,4453
Rhode Island,Washington County,15,6760,3230,3530
Rhode Island,Washington County,16,4449,2037,2412
Rhode Island,Washington County,17,2799,1199,1600
Rhode Island,Washington County,18,3500,1180,2320
South Carolina,Abbeville County,0,24541,11868,12673
South Carolina,Abbeville County,1,1151,570,581
South Carolina,Abbeville County,2,1335,683,652
South Carolina,Abbeville County,3,1515,781,734
South Carolina,Abbeville County,4,1656,842,814
South Carolina,Abbeville County,5,1550,783,767
South Carolina,Abbeville County,6,1478,729,749
South Carolina,Abbeville County,7,1180,603,577
South Carolina,Abbeville County,8,1270,586,684
South Carolina,Abbeville County,9,1274,617,657
South Carolina,Abbeville County,10,1566,762,804
South Carolina,Abbeville County,11,1639,790,849
South Carolina,Abbeville County,12,1747,834,913
South Carolina,Abbeville County,13,1837,882,955
South Carolina,Abbeville County,14,1713,804,909
South Carolina,Abbeville County,15,1437,696,741
South Carolina,Abbeville County,16,956,433,523
South Carolina,Abbeville County,17,646,265,381
South Carolina,Abbeville County,18,591,208,383
South Carolina,Aiken County,0,169401,81847,87554
South Carolina,Aiken County,1,9800,4894,4906
South Carolina,Aiken County,2,9956,5106,4850
South Carolina,Aiken County,3,10672,5467,5205
South Carolina,Aiken County,4,10285,5251,5034
South Carolina,Aiken County,5,9313,4619,4694
South Carolina,Aiken County,6,10962,5471,5491
South Carolina,Aiken County,7,10554,5109,5445
South Carolina,Aiken County,8,10196,4922,5274
South Carolina,Aiken County,9,9271,4501,4770
South Carolina,Aiken County,10,10191,4911,5280
South Carolina,Aiken County,11,11039,5259,5780
South Carolina,Aiken County,12,12197,5916,6281
South Carolina,Aiken County,13,12064,5673,6391
South Carolina,Aiken County,14,10607,4858,5749
South Carolina,Aiken County,15,8981,4234,4747
South Carolina,Aiken County,16,6158,2911,3247
South Carolina,Aiken County,17,3653,1555,2098
South Carolina,Aiken County,18,3502,1190,2312
South Carolina,Allendale County,0,8903,4691,4212
South Carolina,Allendale County,1,416,211,205
South Carolina,Allendale County,2,455,248,207
South Carolina,Allendale County,3,482,226,256
South Carolina,Allendale County,4,515,276,239
South Carolina,Allendale County,5,576,347,229
South Carolina,Allendale County,6,691,446,245
South Carolina,Allendale County,7,573,381,192
South Carolina,Allendale County,8,516,302,214
South Carolina,Allendale County,9,475,282,193
South Carolina,Allendale County,10,623,330,293
South Carolina,Allendale County,11,618,320,298
South Carolina,Allendale County,12,562,266,296
South Carolina,Allendale County,13,611,272,339
South Carolina,Allendale County,14,615,291,324
South Carolina,Allendale County,15,529,228,301
South Carolina,Allendale County,16,277,141,136
South Carolina,Allendale County,17,182,61,121
South Carolina,Allendale County,18,187,63,124
South Carolina,Anderson County,0,200482,96527,103955
South Carolina,Anderson County,1,11892,6082,5810
South Carolina,Anderson County,2,12650,6342,6308
South Carolina,Anderson County,3,13318,6779,6539
South Carolina,Anderson County,4,12870,6513,6357
South Carolina,Anderson County,5,11617,5824,5793
South Carolina,Anderson County,6,12834,6179,6655
South Carolina,Anderson County,7,11721,5623,6098
South Carolina,Anderson County,8,11971,5678,6293
South Carolina,Anderson County,9,11783,5732,6051
South Carolina,Anderson County,10,13332,6487,6845
South Carolina,Anderson County,11,13353,6488,6865
South Carolina,Anderson County,12,14028,6807,7221
South Carolina,Anderson County,13,12928,6037,6891
South Carolina,Anderson County,14,11464,5351,6113
South Carolina,Anderson County,15,9769,4474,5295
South Carolina,Anderson County,16,6764,3036,3728
South Carolina,Anderson County,17,4406,1847,2559
South Carolina,Anderson County,18,3782,1248,2534
South Carolina,Bamberg County,0,14275,6866,7409
South Carolina,Bamberg County,1,654,343,311
South Carolina,Bamberg County,2,749,381,368
South Carolina,Bamberg County,3,776,393,383
South Carolina,Bamberg County,4,1198,624,574
South Carolina,Bamberg County,5,1137,616,521
South Carolina,Bamberg County,6,803,381,422
South Carolina,Bamberg County,7,661,329,332
South Carolina,Bamberg County,8,651,310,341
South Carolina,Bamberg County,9,736,353,383
South Carolina,Bamberg County,10,801,378,423
South Carolina,Bamberg County,11,942,440,502
South Carolina,Bamberg County,12,996,495,501
South Carolina,Bamberg County,13,1074,507,567
South Carolina,Bamberg County,14,1025,475,550
South Carolina,Bamberg County,15,772,340,432
South Carolina,Bamberg County,16,536,243,293
South Carolina,Bamberg County,17,345,131,214
South Carolina,Bamberg County,18,419,127,292
South Carolina,Barnwell County,0,21112,10069,11043
South Carolina,Barnwell County,1,1278,679,599
South Carolina,Barnwell County,2,1416,678,738
South Carolina,Barnwell County,3,1470,756,714
South Carolina,Barnwell County,4,1370,691,679
South Carolina,Barnwell County,5,1237,617,620
South Carolina,Barnwell County,6,1378,717,661
South Carolina,Barnwell County,7,1061,502,559
South Carolina,Barnwell County,8,1178,554,624
South Carolina,Barnwell County,9,1124,514,610
South Carolina,Barnwell County,10,1266,610,656
South Carolina,Barnwell County,11,1410,670,740
South Carolina,Barnwell County,12,1546,700,846
South Carolina,Barnwell County,13,1505,687,818
South Carolina,Barnwell County,14,1283,588,695
South Carolina,Barnwell County,15,1085,507,578
South Carolina,Barnwell County,16,684,280,404
South Carolina,Barnwell County,17,378,166,212
South Carolina,Barnwell County,18,443,153,290
South Carolina,Beaufort County,0,188715,92476,96239
South Carolina,Beaufort County,1,9662,4926,4736
South Carolina,Beaufort County,2,9658,4954,4704
South Carolina,Beaufort County,3,10015,5084,4931
South Carolina,Beaufort County,4,10776,5904,4872
South Carolina,Beaufort County,5,11967,7005,4962
South Carolina,Beaufort County,6,11039,5674,5365
South Carolina,Beaufort County,7,9775,4829,4946
South Carolina,Beaufort County,8,9656,4797,4859
South Carolina,Beaufort County,9,9188,4436,4752
South Carolina,Beaufort County,10,9650,4613,5037
South Carolina,Beaufort County,11,10085,4690,5395
South Carolina,Beaufort County,12,12050,5451,6599
South Carolina,Beaufort County,13,13752,6035,7717
South Carolina,Beaufort County,14,15611,6938,8673
South Carolina,Beaufort County,15,15012,7175,7837
South Carolina,Beaufort County,16,10282,4996,5286
South Carolina,Beaufort County,17,5693,2812,2881
South Carolina,Beaufort County,18,4844,2157,2687
South Carolina,Berkeley County,0,221091,109817,111274
South Carolina,Berkeley County,1,14285,7412,6873
South Carolina,Berkeley County,2,14775,7449,7326
South Carolina,Berkeley County,3,15165,7790,7375
South Carolina,Berkeley County,4,14350,7642,6708
South Carolina,Berkeley County,5,14778,8409,6369
South Carolina,Berkeley County,6,16697,8474,8223
South Carolina,Berkeley County,7,15944,7882,8062
South Carolina,Berkeley County,8,15449,7556,7893
South Carolina,Berkeley County,9,13678,6668,7010
South Carolina,Berkeley County,10,14189,6898,7291
South Carolina,Berkeley County,11,14123,6833,7290
South Carolina,Berkeley County,12,14356,6886,7470
South Carolina,Berkeley County,13,12892,6069,6823
South Carolina,Berkeley County,14,10695,4888,5807
South Carolina,Berkeley County,15,8841,4113,4728
South Carolina,Berkeley County,16,5479,2571,2908
South Carolina,Berkeley County,17,3076,1386,1690
South Carolina,Berkeley County,18,2319,891,1428
South Carolina,Calhoun County,0,14520,6943,7577
South Carolina,Calhoun County,1,650,355,295
South Carolina,Calhoun County,2,780,432,348
South Carolina,Calhoun County,3,829,418,411
South Carolina,Calhoun County,4,760,363,397
South Carolina,Calhoun County,5,741,369,372
South Carolina,Calhoun County,6,824,423,401
South Carolina,Calhoun County,7,692,334,358
South Carolina,Calhoun County,8,791,369,422
South Carolina,Calhoun County,9,820,396,424
South Carolina,Calhoun County,10,856,392,464
South Carolina,Calhoun County,11,1034,490,544
South Carolina,Calhoun County,12,1203,575,628
South Carolina,Calhoun County,13,1162,552,610
South Carolina,Calhoun County,14,1129,512,617
South Carolina,Calhoun County,15,897,414,483
South Carolina,Calhoun County,16,628,280,348
South Carolina,Calhoun County,17,373,158,215
South Carolina,Calhoun County,18,351,111,240
South Carolina,Charleston County,0,405905,196403,209502
South Carolina,Charleston County,1,23970,12316,11654
South Carolina,Charleston County,2,22246,11336,10910
South Carolina,Charleston County,3,21618,10850,10768
South Carolina,Charleston County,4,22459,11344,11115
South Carolina,Charleston County,5,24891,13094,11797
South Carolina,Charleston County,6,34849,16846,18003
South Carolina,Charleston County,7,33857,16619,17238
South Carolina,Charleston County,8,29703,14799,14904
South Carolina,Charleston County,9,23587,11678,11909
South Carolina,Charleston County,10,24143,11901,12242
South Carolina,Charleston County,11,24560,11698,12862
South Carolina,Charleston County,12,27096,12631,14465
South Carolina,Charleston County,13,26305,11954,14351
South Carolina,Charleston County,14,23083,10416,12667
South Carolina,Charleston County,15,18254,8490,9764
South Carolina,Charleston County,16,11429,5027,6402
South Carolina,Charleston County,17,6682,2882,3800
South Carolina,Charleston County,18,7173,2522,4651
South Carolina,Cherokee County,0,57078,27789,29289
South Carolina,Cherokee County,1,3311,1697,1614
South Carolina,Cherokee County,2,3749,1938,1811
South Carolina,Cherokee County,3,3823,1988,1835
South Carolina,Cherokee County,4,3881,1975,1906
South Carolina,Cherokee County,5,3576,1822,1754
South Carolina,Cherokee County,6,4066,1978,2088
South Carolina,Cherokee County,7,3190,1493,1697
South Carolina,Cherokee County,8,3272,1601,1671
South Carolina,Cherokee County,9,3360,1571,1789
South Carolina,Cherokee County,10,3889,1907,1982
South Carolina,Cherokee County,11,3927,1936,1991
South Carolina,Cherokee County,12,3835,1901,1934
South Carolina,Cherokee County,13,3601,1723,1878
South Carolina,Cherokee County,14,3180,1522,1658
South Carolina,Cherokee County,15,2647,1236,1411
South Carolina,Cherokee County,16,1712,768,944
South Carolina,Cherokee County,17,1049,413,636
South Carolina,Cherokee County,18,1010,320,690
South Carolina,Chester County,0,32251,15529,16722
South Carolina,Chester County,1,1826,929,897
South Carolina,Chester County,2,2027,1001,1026
South Carolina,Chester County,3,2136,1128,1008
South Carolina,Chester County,4,1940,1010,930
South Carolina,Chester County,5,1765,884,881
South Carolina,Chester County,6,2166,1063,1103
South Carolina,Chester County,7,1726,803,923
South Carolina,Chester County,8,1810,848,962
South Carolina,Chester County,9,1710,816,894
South Carolina,Chester County,10,2118,1016,1102
South Carolina,Chester County,11,2295,1138,1157
South Carolina,Chester County,12,2347,1150,1197
South Carolina,Chester County,13,2330,1087,1243
South Carolina,Chester County,14,2006,930,1076
South Carolina,Chester County,15,1587,750,837
South Carolina,Chester County,16,1128,518,610
South Carolina,Chester County,17,654,239,415
South Carolina,Chester County,18,680,219,461
South Carolina,Chesterfield County,0,45754,22259,23495
South Carolina,Chesterfield County,1,2558,1307,1251
South Carolina,Chesterfield County,2,2767,1387,1380
South Carolina,Chesterfield County,3,2949,1446,1503
South Carolina,Chesterfield County,4,2775,1444,1331
South Carolina,Chesterfield County,5,2728,1393,1335
South Carolina,Chesterfield County,6,2984,1463,1521
South Carolina,Chesterfield County,7,2388,1174,1214
South Carolina,Chesterfield County,8,2518,1259,1259
South Carolina,Chesterfield County,9,2671,1317,1354
South Carolina,Chesterfield County,10,3147,1567,1580
South Carolina,Chesterfield County,11,3353,1633,1720
South Carolina,Chesterfield County,12,3340,1629,1711
South Carolina,Chesterfield County,13,3181,1533,1648
South Carolina,Chesterfield County,14,2892,1352,1540
South Carolina,Chesterfield County,15,2307,1052,1255
South Carolina,Chesterfield County,16,1523,676,847
South Carolina,Chesterfield County,17,899,355,544
South Carolina,Chesterfield County,18,774,272,502
South Carolina,Clarendon County,0,33700,16548,17152
South Carolina,Clarendon County,1,1555,787,768
South Carolina,Clarendon County,2,1700,882,818
South Carolina,Clarendon County,3,1967,966,1001
South Carolina,Clarendon County,4,2070,1157,913
South Carolina,Clarendon County,5,2168,1335,833
South Carolina,Clarendon County,6,2054,1098,956
South Carolina,Clarendon County,7,1719,827,892
South Carolina,Clarendon County,8,1769,860,909
South Carolina,Clarendon County,9,1630,813,817
South Carolina,Clarendon County,10,1924,935,989
South Carolina,Clarendon County,11,2180,1004,1176
South Carolina,Clarendon County,12,2457,1152,1305
South Carolina,Clarendon County,13,2593,1142,1451
South Carolina,Clarendon County,14,2568,1177,1391
South Carolina,Clarendon County,15,2145,979,1166
South Carolina,Clarendon County,16,1515,731,784
South Carolina,Clarendon County,17,993,429,564
South Carolina,Clarendon County,18,693,274,419
South Carolina,Colleton County,0,37660,18131,19529
South Carolina,Colleton County,1,2252,1190,1062
South Carolina,Colleton County,2,2289,1179,1110
South Carolina,Colleton County,3,2436,1206,1230
South Carolina,Colleton County,4,2226,1150,1076
South Carolina,Colleton County,5,2109,1038,1071
South Carolina,Colleton County,6,2393,1170,1223
South Carolina,Colleton County,7,2062,958,1104
South Carolina,Colleton County,8,2014,974,1040
South Carolina,Colleton County,9,2006,950,1056
South Carolina,Colleton County,10,2205,1022,1183
South Carolina,Colleton County,11,2577,1207,1370
South Carolina,Colleton County,12,2761,1326,1435
South Carolina,Colleton County,13,2735,1294,1441
South Carolina,Colleton County,14,2606,1227,1379
South Carolina,Colleton County,15,2061,985,1076
South Carolina,Colleton County,16,1338,623,715
South Carolina,Colleton County,17,870,359,511
South Carolina,Colleton County,18,720,273,447
South Carolina,Darlington County,0,66802,31517,35285
South Carolina,Darlington County,1,3891,2012,1879
South Carolina,Darlington County,2,3929,2007,1922
South Carolina,Darlington County,3,4314,2174,2140
South Carolina,Darlington County,4,4396,2174,2222
South Carolina,Darlington County,5,4044,1980,2064
South Carolina,Darlington County,6,4391,2124,2267
South Carolina,Darlington County,7,3450,1612,1838
South Carolina,Darlington County,8,3649,1721,1928
South Carolina,Darlington County,9,3889,1794,2095
South Carolina,Darlington County,10,4264,1988,2276
South Carolina,Darlington County,11,4419,2135,2284
South Carolina,Darlington County,12,4611,2141,2470
South Carolina,Darlington County,13,4877,2221,2656
South Carolina,Darlington County,14,4227,1926,2301
South Carolina,Darlington County,15,3421,1542,1879
South Carolina,Darlington County,16,2306,1012,1294
South Carolina,Darlington County,17,1439,566,873
South Carolina,Darlington County,18,1285,388,897
South Carolina,Dillon County,0,30599,14515,16084
South Carolina,Dillon County,1,1998,1074,924
South Carolina,Dillon County,2,2117,1089,1028
South Carolina,Dillon County,3,2248,1162,1086
South Carolina,Dillon County,4,2073,1057,1016
South Carolina,Dillon County,5,1832,864,968
South Carolina,Dillon County,6,2084,1009,1075
South Carolina,Dillon County,7,1729,795,934
South Carolina,Dillon County,8,1787,833,954
South Carolina,Dillon County,9,1800,829,971
South Carolina,Dillon County,10,1739,837,902
South Carolina,Dillon County,11,1937,901,1036
South Carolina,Dillon County,12,2102,949,1153
South Carolina,Dillon County,13,2053,968,1085
South Carolina,Dillon County,14,1728,800,928
South Carolina,Dillon County,15,1337,571,766
South Carolina,Dillon County,16,893,387,506
South Carolina,Dillon County,17,571,230,341
South Carolina,Dillon County,18,571,160,411
South Carolina,Dorchester County,0,160647,78076,82571
South Carolina,Dorchester County,1,9797,4973,4824
South Carolina,Dorchester County,2,10745,5476,5269
South Carolina,Dorchester County,3,11670,5957,5713
South Carolina,Dorchester County,4,10657,5388,5269
South Carolina,Dorchester County,5,9089,4623,4466
South Carolina,Dorchester County,6,11286,5620,5666
South Carolina,Dorchester County,7,11120,5521,5599
South Carolina,Dorchester County,8,11472,5445,6027
South Carolina,Dorchester County,9,10004,4847,5157
South Carolina,Dorchester County,10,10989,5341,5648
South Carolina,Dorchester County,11,10878,5263,5615
South Carolina,Dorchester County,12,11043,5279,5764
South Carolina,Dorchester County,13,9263,4276,4987
South Carolina,Dorchester County,14,8270,3799,4471
South Carolina,Dorchester County,15,6183,2894,3289
South Carolina,Dorchester County,16,3827,1701,2126
South Carolina,Dorchester County,17,2310,964,1346
South Carolina,Dorchester County,18,2044,709,1335
South Carolina,Edgefield County,0,27052,14524,12528
South Carolina,Edgefield County,1,1073,540,533
South Carolina,Edgefield County,2,1307,635,672
South Carolina,Edgefield County,3,1524,764,760
South Carolina,Edgefield County,4,1561,871,690
South Carolina,Edgefield County,5,1660,994,666
South Carolina,Edgefield County,6,1813,1082,731
South Carolina,Edgefield County,7,1783,1153,630
South Carolina,Edgefield County,8,1892,1141,751
South Carolina,Edgefield County,9,1628,926,702
South Carolina,Edgefield County,10,1849,1022,827
South Carolina,Edgefield County,11,1901,1024,877
South Carolina,Edgefield County,12,2028,1009,1019
South Carolina,Edgefield County,13,1959,1017,942
South Carolina,Edgefield County,14,1719,854,865
South Carolina,Edgefield County,15,1356,634,722
South Carolina,Edgefield County,16,902,449,453
South Carolina,Edgefield County,17,552,239,313
South Carolina,Edgefield County,18,545,170,375
South Carolina,Fairfield County,0,22402,10703,11699
South Carolina,Fairfield County,1,1013,534,479
South Carolina,Fairfield County,2,1186,614,572
South Carolina,Fairfield County,3,1308,661,647
South Carolina,Fairfield County,4,1238,631,607
South Carolina,Fairfield County,5,1215,590,625
South Carolina,Fairfield County,6,1350,645,705
South Carolina,Fairfield County,7,1095,516,579
South Carolina,Fairfield County,8,1173,542,631
South Carolina,Fairfield County,9,1166,570,596
South Carolina,Fairfield County,10,1367,637,730
South Carolina,Fairfield County,11,1615,786,829
South Carolina,Fairfield County,12,1914,856,1058
South Carolina,Fairfield County,13,1892,903,989
South Carolina,Fairfield County,14,1771,843,928
South Carolina,Fairfield County,15,1292,615,677
South Carolina,Fairfield County,16,836,392,444
South Carolina,Fairfield County,17,526,226,300
South Carolina,Fairfield County,18,445,142,303
South Carolina,Florence County,0,138159,64459,73700
South Carolina,Florence County,1,8256,4103,4153
South Carolina,Florence County,2,9168,4585,4583
South Carolina,Florence County,3,9617,4842,4775
South Carolina,Florence County,4,8826,4527,4299
South Carolina,Florence County,5,8702,4046,4656
South Carolina,Florence County,6,9303,4342,4961
South Carolina,Florence County,7,8307,3858,4449
South Carolina,Florence County,8,8503,4017,4486
South Carolina,Florence County,9,8317,3808,4509
South Carolina,Florence County,10,8816,4078,4738
South Carolina,Florence County,11,8962,4159,4803
South Carolina,Florence County,12,9058,4133,4925
South Carolina,Florence County,13,8853,4107,4746
South Carolina,Florence County,14,7993,3579,4414
South Carolina,Florence County,15,6329,2807,3522
South Carolina,Florence County,16,4185,1760,2425
South Carolina,Florence County,17,2605,978,1627
South Carolina,Florence County,18,2359,730,1629
South Carolina,Georgetown County,0,62249,29460,32789
South Carolina,Georgetown County,1,2787,1475,1312
South Carolina,Georgetown County,2,3015,1504,1511
South Carolina,Georgetown County,3,3478,1804,1674
South Carolina,Georgetown County,4,3403,1794,1609
South Carolina,Georgetown County,5,3065,1572,1493
South Carolina,Georgetown County,6,2990,1436,1554
South Carolina,Georgetown County,7,2775,1382,1393
South Carolina,Georgetown County,8,2871,1311,1560
South Carolina,Georgetown County,9,3153,1446,1707
South Carolina,Georgetown County,10,3532,1643,1889
South Carolina,Georgetown County,11,3962,1809,2153
South Carolina,Georgetown County,12,4593,2021,2572
South Carolina,Georgetown County,13,5335,2388,2947
South Carolina,Georgetown County,14,5705,2557,3148
South Carolina,Georgetown County,15,4977,2325,2652
South Carolina,Georgetown County,16,3347,1619,1728
South Carolina,Georgetown County,17,1841,844,997
South Carolina,Georgetown County,18,1420,530,890
South Carolina,Greenville County,0,514213,249364,264849
South Carolina,Greenville County,1,32066,16602,15464
South Carolina,Greenville County,2,32901,16656,16245
South Carolina,Greenville County,3,33902,17155,16747
South Carolina,Greenville County,4,32071,16040,16031
South Carolina,Greenville County,5,32565,16049,16516
South Carolina,Greenville County,6,37084,18444,18640
South Carolina,Greenville County,7,34888,17188,17700
South Carolina,Greenville County,8,33800,16527,17273
South Carolina,Greenville County,9,31741,15503,16238
South Carolina,Greenville County,10,33773,16516,17257
South Carolina,Greenville County,11,33431,16299,17132
South Carolina,Greenville County,12,33788,16201,17587
South Carolina,Greenville County,13,31067,14539,16528
South Carolina,Greenville County,14,26832,12341,14491
South Carolina,Greenville County,15,21752,9934,11818
South Carolina,Greenville County,16,14739,6554,8185
South Carolina,Greenville County,17,9056,3740,5316
South Carolina,Greenville County,18,8757,3076,5681
South Carolina,Greenwood County,0,70741,32949,37792
South Carolina,Greenwood County,1,4230,2093,2137
South Carolina,Greenwood County,2,4493,2211,2282
South Carolina,Greenwood County,3,4648,2392,2256
South Carolina,Greenwood County,4,4762,2295,2467
South Carolina,Greenwood County,5,4548,2103,2445
South Carolina,Greenwood County,6,4812,2159,2653
South Carolina,Greenwood County,7,4104,1886,2218
South Carolina,Greenwood County,8,4111,1888,2223
South Carolina,Greenwood County,9,3895,1837,2058
South Carolina,Greenwood County,10,4426,2066,2360
South Carolina,Greenwood County,11,4479,2112,2367
South Carolina,Greenwood County,12,4626,2173,2453
South Carolina,Greenwood County,13,4512,2090,2422
South Carolina,Greenwood County,14,3972,1825,2147
South Carolina,Greenwood County,15,3349,1526,1823
South Carolina,Greenwood County,16,2384,1051,1333
South Carolina,Greenwood County,17,1565,612,953
South Carolina,Greenwood County,18,1825,630,1195
South Carolina,Hampton County,0,19351,9900,9451
South Carolina,Hampton County,1,1029,506,523
South Carolina,Hampton County,2,1119,570,549
South Carolina,Hampton County,3,1224,641,583
South Carolina,Hampton County,4,1157,588,569
South Carolina,Hampton County,5,1140,641,499
South Carolina,Hampton County,6,1367,757,610
South Carolina,Hampton County,7,1173,709,464
South Carolina,Hampton County,8,1302,720,582
South Carolina,Hampton County,9,1162,605,557
South Carolina,Hampton County,10,1180,613,567
South Carolina,Hampton County,11,1291,641,650
South Carolina,Hampton County,12,1319,682,637
South Carolina,Hampton County,13,1325,623,702
South Carolina,Hampton County,14,1186,563,623
South Carolina,Hampton County,15,937,439,498
South Carolina,Hampton County,16,655,314,341
South Carolina,Hampton County,17,411,153,258
South Carolina,Hampton County,18,374,135,239
South Carolina,Horry County,0,344147,165810,178337
South Carolina,Horry County,1,15934,7979,7955
South Carolina,Horry County,2,17066,8725,8341
South Carolina,Horry County,3,18004,9128,8876
South Carolina,Horry County,4,18532,9408,9124
South Carolina,Horry County,5,17261,8618,8643
South Carolina,Horry County,6,21218,10432,10786
South Carolina,Horry County,7,18925,9254,9671
South Carolina,Horry County,8,19301,9436,9865
South Carolina,Horry County,9,18705,9141,9564
South Carolina,Horry County,10,20641,9967,10674
South Carolina,Horry County,11,22168,10411,11757
South Carolina,Horry County,12,25630,11786,13844
South Carolina,Horry County,13,28331,12688,15643
South Carolina,Horry County,14,29888,13992,15896
South Carolina,Horry County,15,24277,11867,12410
South Carolina,Horry County,16,14242,6839,7403
South Carolina,Horry County,17,7996,3820,4176
South Carolina,Horry County,18,6028,2319,3709
South Carolina,Jasper County,0,28971,14620,14351
South Carolina,Jasper County,1,1659,865,794
South Carolina,Jasper County,2,1622,800,822
South Carolina,Jasper County,3,1668,867,801
South Carolina,Jasper County,4,1503,764,739
South Carolina,Jasper County,5,1911,1059,852
South Carolina,Jasper County,6,2058,1164,894
South Carolina,Jasper County,7,1846,1043,803
South Carolina,Jasper County,8,1623,847,776
South Carolina,Jasper County,9,1575,837,738
South Carolina,Jasper County,10,1718,867,851
South Carolina,Jasper County,11,1875,931,944
South Carolina,Jasper County,12,2181,1037,1144
South Carolina,Jasper County,13,2122,975,1147
South Carolina,Jasper County,14,2110,956,1154
South Carolina,Jasper County,15,1593,752,841
South Carolina,Jasper County,16,965,465,500
South Carolina,Jasper County,17,480,231,249
South Carolina,Jasper County,18,462,160,302
South Carolina,Kershaw County,0,65592,31622,33970
South Carolina,Kershaw County,1,3882,1971,1911
South Carolina,Kershaw County,2,4082,2124,1958
South Carolina,Kershaw County,3,4564,2369,2195
South Carolina,Kershaw County,4,4040,2062,1978
South Carolina,Kershaw County,5,3461,1767,1694
South Carolina,Kershaw County,6,3885,1920,1965
South Carolina,Kershaw County,7,3760,1803,1957
South Carolina,Kershaw County,8,4036,1941,2095
South Carolina,Kershaw County,9,3836,1838,1998
South Carolina,Kershaw County,10,4165,1980,2185
South Carolina,Kershaw County,11,4424,2101,2323
South Carolina,Kershaw County,12,4826,2303,2523
South Carolina,Kershaw County,13,4603,2154,2449
South Carolina,Kershaw County,14,4094,1903,2191
South Carolina,Kershaw County,15,3232,1529,1703
South Carolina,Kershaw County,16,2156,948,1208
South Carolina,Kershaw County,17,1326,523,803
South Carolina,Kershaw County,18,1220,386,834
South Carolina,Lancaster County,0,95380,46267,49113
South Carolina,Lancaster County,1,5777,2987,2790
South Carolina,Lancaster County,2,6032,2974,3058
South Carolina,Lancaster County,3,5809,2956,2853
South Carolina,Lancaster County,4,4905,2431,2474
South Carolina,Lancaster County,5,4449,2343,2106
South Carolina,Lancaster County,6,5673,2844,2829
South Carolina,Lancaster County,7,5847,2828,3019
South Carolina,Lancaster County,8,6390,3137,3253
South Carolina,Lancaster County,9,6123,3048,3075
South Carolina,Lancaster County,10,6375,3252,3123
South Carolina,Lancaster County,11,5958,2937,3021
South Carolina,Lancaster County,12,6060,2890,3170
South Carolina,Lancaster County,13,5923,2713,3210
South Carolina,Lancaster County,14,6209,2766,3443
South Carolina,Lancaster County,15,5975,2696,3279
South Carolina,Lancaster County,16,3960,1844,2116
South Carolina,Lancaster County,17,2162,943,1219
South Carolina,Lancaster County,18,1753,678,1075
South Carolina,Laurens County,0,66994,32381,34613
South Carolina,Laurens County,1,3816,1972,1844
South Carolina,Laurens County,2,4102,2100,2002
South Carolina,Laurens County,3,4232,2175,2057
South Carolina,Laurens County,4,4205,2160,2045
South Carolina,Laurens County,5,4219,2113,2106
South Carolina,Laurens County,6,4384,2104,2280
South Carolina,Laurens County,7,3842,1832,2010
South Carolina,Laurens County,8,3659,1710,1949
South Carolina,Laurens County,9,3714,1872,1842
South Carolina,Laurens County,10,4387,2132,2255
South Carolina,Laurens County,11,4518,2177,2341
South Carolina,Laurens County,12,4847,2286,2561
South Carolina,Laurens County,13,4659,2209,2450
South Carolina,Laurens County,14,4068,1992,2076
South Carolina,Laurens County,15,3187,1473,1714
South Carolina,Laurens County,16,2256,1042,1214
South Carolina,Laurens County,17,1395,554,841
South Carolina,Laurens County,18,1504,478,1026
South Carolina,Lee County,0,17142,8813,8329
South Carolina,Lee County,1,869,436,433
South Carolina,Lee County,2,900,485,415
South Carolina,Lee County,3,1045,548,497
South Carolina,Lee County,4,1046,539,507
South Carolina,Lee County,5,1190,744,446
South Carolina,Lee County,6,1325,819,506
South Carolina,Lee County,7,1063,624,439
South Carolina,Lee County,8,1046,578,468
South Carolina,Lee County,9,922,503,419
South Carolina,Lee County,10,1009,506,503
South Carolina,Lee County,11,1117,547,570
South Carolina,Lee County,12,1236,566,670
South Carolina,Lee County,13,1227,564,663
South Carolina,Lee County,14,1123,534,589
South Carolina,Lee County,15,837,376,461
South Carolina,Lee County,16,535,218,317
South Carolina,Lee County,17,359,132,227
South Carolina,Lee County,18,293,94,199
South Carolina,Lexington County,0,295032,143554,151478
South Carolina,Lexington County,1,17000,8671,8329
South Carolina,Lexington County,2,19181,9755,9426
South Carolina,Lexington County,3,20200,10314,9886
South Carolina,Lexington County,4,18152,9308,8844
South Carolina,Lexington County,5,16065,8145,7920
South Carolina,Lexington County,6,20447,10059,10388
South Carolina,Lexington County,7,19463,9588,9875
South Carolina,Lexington County,8,19680,9552,10128
South Carolina,Lexington County,9,18543,8964,9579
South Carolina,Lexington County,10,20290,9968,10322
South Carolina,Lexington County,11,19854,9674,10180
South Carolina,Lexington County,12,20459,9925,10534
South Carolina,Lexington County,13,19117,8955,10162
South Carolina,Lexington County,14,15875,7392,8483
South Carolina,Lexington County,15,12535,5827,6708
South Carolina,Lexington County,16,8338,3757,4581
South Carolina,Lexington County,17,5027,2055,2972
South Carolina,Lexington County,18,4806,1645,3161
South Carolina,McCormick County,0,9410,5053,4357
South Carolina,McCormick County,1,262,140,122
South Carolina,McCormick County,2,293,146,147
South Carolina,McCormick County,3,354,177,177
South Carolina,McCormick County,4,299,149,150
South Carolina,McCormick County,5,390,236,154
South Carolina,McCormick County,6,488,332,156
South Carolina,McCormick County,7,466,312,154
South Carolina,McCormick County,8,437,283,154
South Carolina,McCormick County,9,419,246,173
South Carolina,McCormick County,10,536,301,235
South Carolina,McCormick County,11,603,334,269
South Carolina,McCormick County,12,706,364,342
South Carolina,McCormick County,13,870,436,434
South Carolina,McCormick County,14,980,462,518
South Carolina,McCormick County,15,1005,467,538
South Carolina,McCormick County,16,739,384,355
South Carolina,McCormick County,17,362,177,185
South Carolina,McCormick County,18,201,107,94
South Carolina,Marion County,0,31039,14230,16809
South Carolina,Marion County,1,1824,931,893
South Carolina,Marion County,2,1948,978,970
South Carolina,Marion County,3,2074,1056,1018
South Carolina,Marion County,4,1901,957,944
South Carolina,Marion County,5,1776,864,912
South Carolina,Marion County,6,2023,994,1029
South Carolina,Marion County,7,1486,643,843
South Carolina,Marion County,8,1805,816,989
South Carolina,Marion County,9,1785,805,980
South Carolina,Marion County,10,1791,817,974
South Carolina,Marion County,11,2022,919,1103
South Carolina,Marion County,12,2085,941,1144
South Carolina,Marion County,13,2357,1006,1351
South Carolina,Marion County,14,2151,942,1209
South Carolina,Marion County,15,1686,698,988
South Carolina,Marion County,16,1088,472,616
South Carolina,Marion County,17,651,237,414
South Carolina,Marion County,18,586,154,432
South Carolina,Marlboro County,0,26398,13778,12620
South Carolina,Marlboro County,1,1386,724,662
South Carolina,Marlboro County,2,1430,706,724
South Carolina,Marlboro County,3,1567,799,768
South Carolina,Marlboro County,4,1428,748,680
South Carolina,Marlboro County,5,1572,901,671
South Carolina,Marlboro County,6,2005,1221,784
South Carolina,Marlboro County,7,1773,1146,627
South Carolina,Marlboro County,8,1731,1013,718
South Carolina,Marlboro County,9,1653,891,762
South Carolina,Marlboro County,10,1638,906,732
South Carolina,Marlboro County,11,1850,927,923
South Carolina,Marlboro County,12,1865,924,941
South Carolina,Marlboro County,13,1739,819,920
South Carolina,Marlboro County,14,1585,724,861
South Carolina,Marlboro County,15,1395,641,754
South Carolina,Marlboro County,16,842,361,481
South Carolina,Marlboro County,17,495,197,298
South Carolina,Marlboro County,18,444,130,314
South Carolina,Newberry County,0,38520,18793,19727
South Carolina,Newberry County,1,2303,1150,1153
South Carolina,Newberry County,2,2329,1194,1135
South Carolina,Newberry County,3,2346,1162,1184
South Carolina,Newberry County,4,2664,1387,1277
South Carolina,Newberry County,5,2492,1332,1160
South Carolina,Newberry County,6,2401,1220,1181
South Carolina,Newberry County,7,1941,966,975
South Carolina,Newberry County,8,2081,1033,1048
South Carolina,Newberry County,9,2018,965,1053
South Carolina,Newberry County,10,2380,1169,1211
South Carolina,Newberry County,11,2523,1226,1297
South Carolina,Newberry County,12,2722,1314,1408
South Carolina,Newberry County,13,2768,1351,1417
South Carolina,Newberry County,14,2442,1146,1296
South Carolina,Newberry County,15,2041,955,1086
South Carolina,Newberry County,16,1374,614,760
South Carolina,Newberry County,17,828,356,472
South Carolina,Newberry County,18,867,253,614
South Carolina,Oconee County,0,78374,38557,39817
South Carolina,Oconee County,1,3871,1974,1897
South Carolina,Oconee County,2,4327,2174,2153
South Carolina,Oconee County,3,4686,2394,2292
South Carolina,Oconee County,4,4209,2175,2034
South Carolina,Oconee County,5,4111,2159,1952
South Carolina,Oconee County,6,4951,2537,2414
South Carolina,Oconee County,7,3940,2007,1933
South Carolina,Oconee County,8,4080,1999,2081
South Carolina,Oconee County,9,4078,2031,2047
South Carolina,Oconee County,10,4829,2398,2431
South Carolina,Oconee County,11,5033,2475,2558
South Carolina,Oconee County,12,5785,2793,2992
South Carolina,Oconee County,13,6278,2978,3300
South Carolina,Oconee County,14,5812,2741,3071
South Carolina,Oconee County,15,5140,2528,2612
South Carolina,Oconee County,16,3483,1648,1835
South Carolina,Oconee County,17,2129,968,1161
South Carolina,Oconee County,18,1632,578,1054
South Carolina,Orangeburg County,0,86934,40548,46386
South Carolina,Orangeburg County,1,4816,2380,2436
South Carolina,Orangeburg County,2,5496,2729,2767
South Carolina,Orangeburg County,3,5559,2882,2677
South Carolina,Orangeburg County,4,5941,2917,3024
South Carolina,Orangeburg County,5,5956,2893,3063
South Carolina,Orangeburg County,6,5846,2795,3051
South Carolina,Orangeburg County,7,4662,2112,2550
South Carolina,Orangeburg County,8,4641,2158,2483
South Carolina,Orangeburg County,9,4220,1937,2283
South Carolina,Orangeburg County,10,4849,2200,2649
South Carolina,Orangeburg County,11,5631,2604,3027
South Carolina,Orangeburg County,12,6189,2865,3324
South Carolina,Orangeburg County,13,6014,2763,3251
South Carolina,Orangeburg County,14,5497,2448,3049
South Carolina,Orangeburg County,15,4630,2119,2511
South Carolina,Orangeburg County,16,3129,1327,1802
South Carolina,Orangeburg County,17,1969,793,1176
South Carolina,Orangeburg County,18,1889,626,1263
South Carolina,Pickens County,0,124937,62214,62723
South Carolina,Pickens County,1,6392,3227,3165
South Carolina,Pickens County,2,6235,3189,3046
South Carolina,Pickens County,3,6958,3546,3412
South Carolina,Pickens County,4,10903,5721,5182
South Carolina,Pickens County,5,15049,8056,6993
South Carolina,Pickens County,6,8526,4460,4066
South Carolina,Pickens County,7,6626,3410,3216
South Carolina,Pickens County,8,6658,3349,3309
South Carolina,Pickens County,9,6558,3221,3337
South Carolina,Pickens County,10,7261,3557,3704
South Carolina,Pickens County,11,7569,3643,3926
South Carolina,Pickens County,12,8015,3898,4117
South Carolina,Pickens County,13,7527,3651,3876
South Carolina,Pickens County,14,6437,3047,3390
South Carolina,Pickens County,15,5500,2596,2904
South Carolina,Pickens County,16,3922,1802,2120
South Carolina,Pickens County,17,2462,979,1483
South Carolina,Pickens County,18,2339,862,1477
South Carolina,Richland County,0,414576,200319,214257
South Carolina,Richland County,1,24036,12219,11817
South Carolina,Richland County,2,24197,12220,11977
South Carolina,Richland County,3,25212,12646,12566
South Carolina,Richland County,4,33958,17555,16403
South Carolina,Richland County,5,46109,24201,21908
South Carolina,Richland County,6,34012,16947,17065
South Carolina,Richland County,7,28000,13596,14404
South Carolina,Richland County,8,26810,12814,13996
South Carolina,Richland County,9,24024,11406,12618
South Carolina,Richland County,10,24344,11507,12837
South Carolina,Richland County,11,23953,11156,12797
South Carolina,Richland County,12,24572,11349,13223
South Carolina,Richland County,13,22559,10255,12304
South Carolina,Richland County,14,18788,8336,10452
South Carolina,Richland County,15,14244,6439,7805
South Carolina,Richland County,16,8811,3747,5064
South Carolina,Richland County,17,5501,2136,3365
South Carolina,Richland County,18,5446,1790,3656
South Carolina,Saluda County,0,20544,10416,10128
South Carolina,Saluda County,1,1241,656,585
South Carolina,Saluda County,2,1227,657,570
South Carolina,Saluda County,3,1272,636,636
South Carolina,Saluda County,4,1145,621,524
South Carolina,Saluda County,5,1115,627,488
South Carolina,Saluda County,6,1341,713,628
South Carolina,Saluda County,7,1172,661,511
South Carolina,Saluda County,8,1193,613,580
South Carolina,Saluda County,9,1148,590,558
South Carolina,Saluda County,10,1327,670,657
South Carolina,Saluda County,11,1343,639,704
South Carolina,Saluda County,12,1535,758,777
South Carolina,Saluda County,13,1425,725,700
South Carolina,Saluda County,14,1212,602,610
South Carolina,Saluda County,15,1045,494,551
South Carolina,Saluda County,16,821,386,435
South Carolina,Saluda County,17,496,213,283
South Carolina,Saluda County,18,486,155,331
South Carolina,Spartanburg County,0,313888,152188,161700
South Carolina,Spartanburg County,1,19007,9653,9354
South Carolina,Spartanburg County,2,20079,10116,9963
South Carolina,Spartanburg County,3,20770,10578,10192
South Carolina,Spartanburg County,4,21102,10656,10446
South Carolina,Spartanburg County,5,20103,10032,10071
South Carolina,Spartanburg County,6,23273,11421,11852
South Carolina,Spartanburg County,7,19940,9814,10126
South Carolina,Spartanburg County,8,18889,9276,9613
South Carolina,Spartanburg County,9,18426,8941,9485
South Carolina,Spartanburg County,10,20646,10130,10516
South Carolina,Spartanburg County,11,20956,10282,10674
South Carolina,Spartanburg County,12,20999,10214,10785
South Carolina,Spartanburg County,13,18886,8844,10042
South Carolina,Spartanburg County,14,16809,7673,9136
South Carolina,Spartanburg County,15,13475,6321,7154
South Carolina,Spartanburg County,16,9629,4176,5453
South Carolina,Spartanburg County,17,5837,2394,3443
South Carolina,Spartanburg County,18,5062,1667,3395
South Carolina,Sumter County,0,106512,51216,55296
South Carolina,Sumter County,1,7089,3647,3442
South Carolina,Sumter County,2,7075,3550,3525
South Carolina,Sumter County,3,7108,3526,3582
South Carolina,Sumter County,4,6757,3471,3286
South Carolina,Sumter County,5,7929,4330,3599
South Carolina,Sumter County,6,8323,4254,4069
South Carolina,Sumter County,7,6771,3314,3457
South Carolina,Sumter County,8,6366,3031,3335
South Carolina,Sumter County,9,5551,2633,2918
South Carolina,Sumter County,10,6041,2779,3262
South Carolina,Sumter County,11,6435,3013,3422
South Carolina,Sumter County,12,7009,3332,3677
South Carolina,Sumter County,13,6542,2990,3552
South Carolina,Sumter County,14,5619,2493,3126
South Carolina,Sumter County,15,4513,1965,2548
South Carolina,Sumter County,16,3232,1375,1857
South Carolina,Sumter County,17,2193,870,1323
South Carolina,Sumter County,18,1959,643,1316
South Carolina,Union County,0,27410,12987,14423
South Carolina,Union County,1,1589,787,802
South Carolina,Union County,2,1553,799,754
South Carolina,Union County,3,1624,837,787
South Carolina,Union County,4,1583,822,761
South Carolina,Union County,5,1546,794,752
South Carolina,Union County,6,1706,793,913
South Carolina,Union County,7,1356,615,741
South Carolina,Union County,8,1462,686,776
South Carolina,Union County,9,1542,736,806
South Carolina,Union County,10,1824,867,957
South Carolina,Union County,11,1955,926,1029
South Carolina,Union County,12,2024,962,1062
South Carolina,Union County,13,2092,1008,1084
South Carolina,Union County,14,1787,814,973
South Carolina,Union County,15,1528,682,846
South Carolina,Union County,16,984,424,560
South Carolina,Union County,17,630,254,376
South Carolina,Union County,18,625,181,444
South Carolina,Williamsburg County,0,30606,14492,16114
South Carolina,Williamsburg County,1,1558,747,811
South Carolina,Williamsburg County,2,1665,818,847
South Carolina,Williamsburg County,3,1916,965,951
South Carolina,Williamsburg County,4,1878,947,931
South Carolina,Williamsburg County,5,1719,863,856
South Carolina,Williamsburg County,6,2021,1074,947
South Carolina,Williamsburg County,7,1640,892,748
South Carolina,Williamsburg County,8,1683,841,842
South Carolina,Williamsburg County,9,1714,817,897
South Carolina,Williamsburg County,10,1908,877,1031
South Carolina,Williamsburg County,11,1927,892,1035
South Carolina,Williamsburg County,12,2133,977,1156
South Carolina,Williamsburg County,13,2403,1029,1374
South Carolina,Williamsburg County,14,2205,1024,1181
South Carolina,Williamsburg County,15,1700,768,932
South Carolina,Williamsburg County,16,1150,516,634
South Carolina,Williamsburg County,17,694,258,436
South Carolina,Williamsburg County,18,692,187,505
South Carolina,York County,0,274118,132238,141880
South Carolina,York County,1,16680,8518,8162
South Carolina,York County,2,18884,9598,9286
South Carolina,York County,3,19482,9931,9551
South Carolina,York County,4,18468,9071,9397
South Carolina,York County,5,15638,7687,7951
South Carolina,York County,6,16847,8028,8819
South Carolina,York County,7,17393,8262,9131
South Carolina,York County,8,19179,9179,10000
South Carolina,York County,9,18701,9091,9610
South Carolina,York County,10,20328,9822,10506
South Carolina,York County,11,18612,9048,9564
South Carolina,York County,12,18274,8833,9441
South Carolina,York County,13,16396,7824,8572
South Carolina,York County,14,13708,6265,7443
South Carolina,York County,15,10757,5026,5731
South Carolina,York County,16,7135,3211,3924
South Carolina,York County,17,4068,1647,2421
South Carolina,York County,18,3568,1197,2371
South Dakota,Aurora County,0,2801,1490,1311
South Dakota,Aurora County,1,179,99,80
South Dakota,Aurora County,2,182,105,77
South Dakota,Aurora County,3,196,106,90
South Dakota,Aurora County,4,206,124,82
South Dakota,Aurora County,5,144,78,66
South Dakota,Aurora County,6,133,69,64
South Dakota,Aurora County,7,181,99,82
South Dakota,Aurora County,8,169,103,66
South Dakota,Aurora County,9,128,69,59
South Dakota,Aurora County,10,159,74,85
South Dakota,Aurora County,11,149,78,71
South Dakota,Aurora County,12,182,99,83
South Dakota,Aurora County,13,216,110,106
South Dakota,Aurora County,14,161,77,84
South Dakota,Aurora County,15,145,78,67
South Dakota,Aurora County,16,87,42,45
South Dakota,Aurora County,17,95,44,51
South Dakota,Aurora County,18,89,36,53
South Dakota,Beadle County,0,18883,9619,9264
South Dakota,Beadle County,1,1659,778,881
South Dakota,Beadle County,2,1423,747,676
South Dakota,Beadle County,3,1285,692,593
South Dakota,Beadle County,4,1241,738,503
South Dakota,Beadle County,5,1035,544,491
South Dakota,Beadle County,6,1090,574,516
South Dakota,Beadle County,7,1204,646,558
South Dakota,Beadle County,8,1147,616,531
South Dakota,Beadle County,9,1008,545,463
South Dakota,Beadle County,10,985,447,538
South Dakota,Beadle County,11,1019,527,492
South Dakota,Beadle County,12,1362,673,689
South Dakota,Beadle County,13,1216,614,602
South Dakota,Beadle County,14,1010,543,467
South Dakota,Beadle County,15,689,344,345
South Dakota,Beadle County,16,528,239,289
South Dakota,Beadle County,17,430,184,246
South Dakota,Beadle County,18,552,168,384
South Dakota,Bennett County,0,3468,1695,1773
South Dakota,Bennett County,1,336,174,162
South Dakota,Bennett County,2,358,169,189
South Dakota,Bennett County,3,316,163,153
South Dakota,Bennett County,4,262,131,131
South Dakota,Bennett County,5,249,122,127
South Dakota,Bennett County,6,217,100,117
South Dakota,Bennett County,7,228,104,124
South Dakota,Bennett County,8,177,81,96
South Dakota,Bennett County,9,142,74,68
South Dakota,Bennett County,10,167,79,88
South Dakota,Bennett County,11,196,93,103
South Dakota,Bennett County,12,220,124,96
South Dakota,Bennett County,13,167,80,87
South Dakota,Bennett County,14,146,62,84
South Dakota,Bennett County,15,90,44,46
South Dakota,Bennett County,16,61,25,36
South Dakota,Bennett County,17,85,41,44
South Dakota,Bennett County,18,51,29,22
South Dakota,Bon Homme County,0,6980,4131,2849
South Dakota,Bon Homme County,1,370,192,178
South Dakota,Bon Homme County,2,369,195,174
South Dakota,Bon Homme County,3,407,187,220
South Dakota,Bon Homme County,4,410,247,163
South Dakota,Bon Homme County,5,460,332,128
South Dakota,Bon Homme County,6,473,358,115
South Dakota,Bon Homme County,7,454,309,145
South Dakota,Bon Homme County,8,455,326,129
South Dakota,Bon Homme County,9,395,276,119
South Dakota,Bon Homme County,10,402,267,135
South Dakota,Bon Homme County,11,421,247,174
South Dakota,Bon Homme County,12,487,280,207
South Dakota,Bon Homme County,13,455,257,198
South Dakota,Bon Homme County,14,401,203,198
South Dakota,Bon Homme County,15,302,155,147
South Dakota,Bon Homme County,16,226,111,115
South Dakota,Bon Homme County,17,190,84,106
South Dakota,Bon Homme County,18,303,105,198
South Dakota,Brookings County,0,35232,18287,16945
South Dakota,Brookings County,1,2237,1224,1013
South Dakota,Brookings County,2,1936,1004,932
South Dakota,Brookings County,3,1948,986,962
South Dakota,Brookings County,4,3889,1946,1943
South Dakota,Brookings County,5,6228,3291,2937
South Dakota,Brookings County,6,2687,1579,1108
South Dakota,Brookings County,7,2130,1137,993
South Dakota,Brookings County,8,1982,1044,938
South Dakota,Brookings County,9,1582,849,733
South Dakota,Brookings County,10,1537,777,760
South Dakota,Brookings County,11,1514,793,721
South Dakota,Brookings County,12,1654,841,813
South Dakota,Brookings County,13,1713,878,835
South Dakota,Brookings County,14,1429,699,730
South Dakota,Brookings County,15,973,472,501
South Dakota,Brookings County,16,700,329,371
South Dakota,Brookings County,17,515,238,277
South Dakota,Brookings County,18,578,200,378
South Dakota,Brown County,0,39316,19322,19994
South Dakota,Brown County,1,2659,1350,1309
South Dakota,Brown County,2,2613,1305,1308
South Dakota,Brown County,3,2691,1342,1349
South Dakota,Brown County,4,2533,1214,1319
South Dakota,Brown County,5,2613,1246,1367
South Dakota,Brown County,6,2702,1364,1338
South Dakota,Brown County,7,2669,1458,1211
South Dakota,Brown County,8,2564,1334,1230
South Dakota,Brown County,9,2010,1026,984
South Dakota,Brown County,10,2173,1126,1047
South Dakota,Brown County,11,2160,1103,1057
South Dakota,Brown County,12,2710,1316,1394
South Dakota,Brown County,13,2472,1227,1245
South Dakota,Brown County,14,2101,988,1113
South Dakota,Brown County,15,1519,735,784
South Dakota,Brown County,16,1083,456,627
South Dakota,Brown County,17,901,364,537
South Dakota,Brown County,18,1143,368,775
South Dakota,Brule County,0,5229,2612,2617
South Dakota,Brule County,1,346,187,159
South Dakota,Brule County,2,382,184,198
South Dakota,Brule County,3,409,213,196
South Dakota,Brule County,4,355,184,171
South Dakota,Brule County,5,263,140,123
South Dakota,Brule County,6,257,138,119
South Dakota,Brule County,7,259,130,129
South Dakota,Brule County,8,310,155,155
South Dakota,Brule County,9,264,127,137
South Dakota,Brule County,10,278,129,149
South Dakota,Brule County,11,328,168,160
South Dakota,Brule County,12,387,191,196
South Dakota,Brule County,13,399,206,193
South Dakota,Brule County,14,339,187,152
South Dakota,Brule County,15,174,87,87
South Dakota,Brule County,16,171,70,101
South Dakota,Brule County,17,130,56,74
South Dakota,Brule County,18,178,60,118
South Dakota,Buffalo County,0,2036,1012,1024
South Dakota,Buffalo County,1,248,128,120
South Dakota,Buffalo County,2,214,121,93
South Dakota,Buffalo County,3,219,93,126
South Dakota,Buffalo County,4,175,85,90
South Dakota,Buffalo County,5,133,74,59
South Dakota,Buffalo County,6,158,79,79
South Dakota,Buffalo County,7,120,53,67
South Dakota,Buffalo County,8,122,64,58
South Dakota,Buffalo County,9,120,63,57
South Dakota,Buffalo County,10,93,50,43
South Dakota,Buffalo County,11,88,45,43
South Dakota,Buffalo County,12,79,35,44
South Dakota,Buffalo County,13,107,56,51
South Dakota,Buffalo County,14,50,18,32
South Dakota,Buffalo County,15,50,22,28
South Dakota,Buffalo County,16,29,10,19
South Dakota,Buffalo County,17,18,11,7
South Dakota,Buffalo County,18,13,5,8
South Dakota,Butte County,0,10222,5176,5046
South Dakota,Butte County,1,653,341,312
South Dakota,Butte County,2,673,343,330
South Dakota,Butte County,3,715,391,324
South Dakota,Butte County,4,647,327,320
South Dakota,Butte County,5,457,243,214
South Dakota,Butte County,6,608,314,294
South Dakota,Butte County,7,574,284,290
South Dakota,Butte County,8,630,312,318
South Dakota,Butte County,9,494,266,228
South Dakota,Butte County,10,529,256,273
South Dakota,Butte County,11,602,301,301
South Dakota,Butte County,12,785,384,401
South Dakota,Butte County,13,807,408,399
South Dakota,Butte County,14,690,362,328
South Dakota,Butte County,15,545,282,263
South Dakota,Butte County,16,360,178,182
South Dakota,Butte County,17,218,97,121
South Dakota,Butte County,18,235,87,148
South Dakota,Campbell County,0,1377,716,661
South Dakota,Campbell County,1,59,36,23
South Dakota,Campbell County,2,63,37,26
South Dakota,Campbell County,3,53,20,33
South Dakota,Campbell County,4,71,33,38
South Dakota,Campbell County,5,62,36,26
South Dakota,Campbell County,6,47,26,21
South Dakota,Campbell County,7,61,31,30
South Dakota,Campbell County,8,61,30,31
South Dakota,Campbell County,9,55,28,27
South Dakota,Campbell County,10,54,27,27
South Dakota,Campbell County,11,104,56,48
South Dakota,Campbell County,12,154,87,67
South Dakota,Campbell County,13,143,77,66
South Dakota,Campbell County,14,87,50,37
South Dakota,Campbell County,15,85,39,46
South Dakota,Campbell County,16,73,39,34
South Dakota,Campbell County,17,77,36,41
South Dakota,Campbell County,18,68,28,40
South Dakota,Charles Mix County,0,9338,4667,4671
South Dakota,Charles Mix County,1,826,433,393
South Dakota,Charles Mix County,2,822,437,385
South Dakota,Charles Mix County,3,732,362,370
South Dakota,Charles Mix County,4,625,321,304
South Dakota,Charles Mix County,5,554,260,294
South Dakota,Charles Mix County,6,476,248,228
South Dakota,Charles Mix County,7,486,234,252
South Dakota,Charles Mix County,8,476,258,218
South Dakota,Charles Mix County,9,439,202,237
South Dakota,Charles Mix County,10,465,246,219
South Dakota,Charles Mix County,11,497,245,252
South Dakota,Charles Mix County,12,633,319,314
South Dakota,Charles Mix County,13,592,304,288
South Dakota,Charles Mix County,14,480,245,235
South Dakota,Charles Mix County,15,367,171,196
South Dakota,Charles Mix County,16,333,166,167
South Dakota,Charles Mix County,17,239,108,131
South Dakota,Charles Mix County,18,296,108,188
South Dakota,Clark County,0,3739,1925,1814
South Dakota,Clark County,1,392,198,194
South Dakota,Clark County,2,259,127,132
South Dakota,Clark County,3,219,127,92
South Dakota,Clark County,4,167,82,85
South Dakota,Clark County,5,210,127,83
South Dakota,Clark County,6,228,115,113
South Dakota,Clark County,7,205,108,97
South Dakota,Clark County,8,190,106,84
South Dakota,Clark County,9,162,99,63
South Dakota,Clark County,10,161,82,79
South Dakota,Clark County,11,197,94,103
South Dakota,Clark County,12,276,143,133
South Dakota,Clark County,13,282,159,123
South Dakota,Clark County,14,269,140,129
South Dakota,Clark County,15,172,84,88
South Dakota,Clark County,16,141,72,69
South Dakota,Clark County,17,94,35,59
South Dakota,Clark County,18,115,27,88
South Dakota,Clay County,0,14041,7027,7014
South Dakota,Clay County,1,742,388,354
South Dakota,Clay County,2,678,357,321
South Dakota,Clay County,3,649,340,309
South Dakota,Clay County,4,1644,729,915
South Dakota,Clay County,5,3212,1593,1619
South Dakota,Clay County,6,1057,611,446
South Dakota,Clay County,7,691,379,312
South Dakota,Clay County,8,661,338,323
South Dakota,Clay County,9,568,286,282
South Dakota,Clay County,10,560,296,264
South Dakota,Clay County,11,594,275,319
South Dakota,Clay County,12,620,292,328
South Dakota,Clay County,13,648,329,319
South Dakota,Clay County,14,626,319,307
South Dakota,Clay County,15,385,212,173
South Dakota,Clay County,16,287,145,142
South Dakota,Clay County,17,199,81,118
South Dakota,Clay County,18,220,57,163
South Dakota,Codington County,0,28015,14081,13934
South Dakota,Codington County,1,1760,905,855
South Dakota,Codington County,2,1875,967,908
South Dakota,Codington County,3,2040,1021,1019
South Dakota,Codington County,4,1658,897,761
South Dakota,Codington County,5,1593,816,777
South Dakota,Codington County,6,1815,978,837
South Dakota,Codington County,7,1695,868,827
South Dakota,Codington County,8,1773,887,886
South Dakota,Codington County,9,1583,832,751
South Dakota,Codington County,10,1610,831,779
South Dakota,Codington County,11,1728,888,840
South Dakota,Codington County,12,1996,949,1047
South Dakota,Codington County,13,1940,979,961
South Dakota,Codington County,14,1514,779,735
South Dakota,Codington County,15,1136,546,590
South Dakota,Codington County,16,840,384,456
South Dakota,Codington County,17,669,257,412
South Dakota,Codington County,18,790,297,493
South Dakota,Corson County,0,4165,2089,2076
South Dakota,Corson County,1,429,193,236
South Dakota,Corson County,2,419,202,217
South Dakota,Corson County,3,450,235,215
South Dakota,Corson County,4,355,176,179
South Dakota,Corson County,5,219,105,114
South Dakota,Corson County,6,278,148,130
South Dakota,Corson County,7,231,123,108
South Dakota,Corson County,8,216,101,115
South Dakota,Corson County,9,215,106,109
South Dakota,Corson County,10,168,105,63
South Dakota,Corson County,11,233,127,106
South Dakota,Corson County,12,250,126,124
South Dakota,Corson County,13,231,117,114
South Dakota,Corson County,14,153,76,77
South Dakota,Corson County,15,128,65,63
South Dakota,Corson County,16,91,43,48
South Dakota,Corson County,17,55,24,31
South Dakota,Corson County,18,44,17,27
South Dakota,Custer County,0,8726,4337,4389
South Dakota,Custer County,1,350,172,178
South Dakota,Custer County,2,310,166,144
South Dakota,Custer County,3,355,176,179
South Dakota,Custer County,4,431,249,182
South Dakota,Custer County,5,260,136,124
South Dakota,Custer County,6,329,167,162
South Dakota,Custer County,7,351,159,192
South Dakota,Custer County,8,430,224,206
South Dakota,Custer County,9,412,206,206
South Dakota,Custer County,10,474,222,252
South Dakota,Custer County,11,599,304,295
South Dakota,Custer County,12,826,357,469
South Dakota,Custer County,13,978,468,510
South Dakota,Custer County,14,982,510,472
South Dakota,Custer County,15,691,371,320
South Dakota,Custer County,16,455,233,222
South Dakota,Custer County,17,262,135,127
South Dakota,Custer County,18,231,82,149
South Dakota,Davison County,0,19790,9894,9896
South Dakota,Davison County,1,1254,649,605
South Dakota,Davison County,2,1179,606,573
South Dakota,Davison County,3,1394,711,683
South Dakota,Davison County,4,1274,660,614
South Dakota,Davison County,5,1366,730,636
South Dakota,Davison County,6,1333,731,602
South Dakota,Davison County,7,1175,615,560
South Dakota,Davison County,8,1177,626,551
South Dakota,Davison County,9,1099,558,541
South Dakota,Davison County,10,953,483,470
South Dakota,Davison County,11,1134,584,550
South Dakota,Davison County,12,1401,699,702
South Dakota,Davison County,13,1327,637,690
South Dakota,Davison County,14,1070,537,533
South Dakota,Davison County,15,821,390,431
South Dakota,Davison County,16,626,286,340
South Dakota,Davison County,17,482,185,297
South Dakota,Davison County,18,725,207,518
South Dakota,Day County,0,5505,2807,2698
South Dakota,Day County,1,276,133,143
South Dakota,Day County,2,361,178,183
South Dakota,Day County,3,373,203,170
South Dakota,Day County,4,333,170,163
South Dakota,Day County,5,242,130,112
South Dakota,Day County,6,239,123,116
South Dakota,Day County,7,259,138,121
South Dakota,Day County,8,302,159,143
South Dakota,Day County,9,269,143,126
South Dakota,Day County,10,262,149,113
South Dakota,Day County,11,287,137,150
South Dakota,Day County,12,426,216,210
South Dakota,Day County,13,476,257,219
South Dakota,Day County,14,429,221,208
South Dakota,Day County,15,326,168,158
South Dakota,Day County,16,218,111,107
South Dakota,Day County,17,184,91,93
South Dakota,Day County,18,243,80,163
South Dakota,Deuel County,0,4337,2243,2094
South Dakota,Deuel County,1,278,159,119
South Dakota,Deuel County,2,279,148,131
South Dakota,Deuel County,3,305,169,136
South Dakota,Deuel County,4,262,146,116
South Dakota,Deuel County,5,194,95,99
South Dakota,Deuel County,6,228,106,122
South Dakota,Deuel County,7,228,128,100
South Dakota,Deuel County,8,246,137,109
South Dakota,Deuel County,9,216,117,99
South Dakota,Deuel County,10,224,118,106
South Dakota,Deuel County,11,272,134,138
South Dakota,Deuel County,12,336,176,160
South Dakota,Deuel County,13,320,174,146
South Dakota,Deuel County,14,293,139,154
South Dakota,Deuel County,15,232,114,118
South Dakota,Deuel County,16,151,73,78
South Dakota,Deuel County,17,130,50,80
South Dakota,Deuel County,18,143,60,83
South Dakota,Dewey County,0,5904,2927,2977
South Dakota,Dewey County,1,770,418,352
South Dakota,Dewey County,2,634,328,306
South Dakota,Dewey County,3,535,263,272
South Dakota,Dewey County,4,463,228,235
South Dakota,Dewey County,5,365,180,185
South Dakota,Dewey County,6,377,179,198
South Dakota,Dewey County,7,358,161,197
South Dakota,Dewey County,8,359,196,163
South Dakota,Dewey County,9,259,114,145
South Dakota,Dewey County,10,271,128,143
South Dakota,Dewey County,11,326,165,161
South Dakota,Dewey County,12,349,173,176
South Dakota,Dewey County,13,279,142,137
South Dakota,Dewey County,14,192,90,102
South Dakota,Dewey County,15,140,64,76
South Dakota,Dewey County,16,97,49,48
South Dakota,Dewey County,17,77,28,49
South Dakota,Dewey County,18,53,21,32
South Dakota,Douglas County,0,2935,1452,1483
South Dakota,Douglas County,1,223,100,123
South Dakota,Douglas County,2,196,93,103
South Dakota,Douglas County,3,197,91,106
South Dakota,Douglas County,4,195,106,89
South Dakota,Douglas County,5,122,65,57
South Dakota,Douglas County,6,138,79,59
South Dakota,Douglas County,7,148,74,74
South Dakota,Douglas County,8,132,71,61
South Dakota,Douglas County,9,120,61,59
South Dakota,Douglas County,10,124,59,65
South Dakota,Douglas County,11,175,90,85
South Dakota,Douglas County,12,218,109,109
South Dakota,Douglas County,13,240,119,121
South Dakota,Douglas County,14,189,101,88
South Dakota,Douglas County,15,161,84,77
South Dakota,Douglas County,16,113,61,52
South Dakota,Douglas County,17,96,46,50
South Dakota,Douglas County,18,148,43,105
South Dakota,Edmunds County,0,3875,1939,1936
South Dakota,Edmunds County,1,272,129,143
South Dakota,Edmunds County,2,253,115,138
South Dakota,Edmunds County,3,255,150,105
South Dakota,Edmunds County,4,215,102,113
South Dakota,Edmunds County,5,193,111,82
South Dakota,Edmunds County,6,176,89,87
South Dakota,Edmunds County,7,192,90,102
South Dakota,Edmunds County,8,200,99,101
South Dakota,Edmunds County,9,182,94,88
South Dakota,Edmunds County,10,214,118,96
South Dakota,Edmunds County,11,250,110,140
South Dakota,Edmunds County,12,324,181,143
South Dakota,Edmunds County,13,315,166,149
South Dakota,Edmunds County,14,250,127,123
South Dakota,Edmunds County,15,176,83,93
South Dakota,Edmunds County,16,157,74,83
South Dakota,Edmunds County,17,97,46,51
South Dakota,Edmunds County,18,154,55,99
South Dakota,Fall River County,0,6758,3417,3341
South Dakota,Fall River County,1,274,134,140
South Dakota,Fall River County,2,314,170,144
South Dakota,Fall River County,3,355,183,172
South Dakota,Fall River County,4,350,181,169
South Dakota,Fall River County,5,288,161,127
South Dakota,Fall River County,6,303,146,157
South Dakota,Fall River County,7,268,141,127
South Dakota,Fall River County,8,294,151,143
South Dakota,Fall River County,9,334,152,182
South Dakota,Fall River County,10,366,192,174
South Dakota,Fall River County,11,435,226,209
South Dakota,Fall River County,12,550,272,278
South Dakota,Fall River County,13,667,330,337
South Dakota,Fall River County,14,653,331,322
South Dakota,Fall River County,15,526,276,250
South Dakota,Fall River County,16,297,156,141
South Dakota,Fall River County,17,264,134,130
South Dakota,Fall River County,18,220,81,139
South Dakota,Faulk County,0,2330,1156,1174
South Dakota,Faulk County,1,193,100,93
South Dakota,Faulk County,2,156,77,79
South Dakota,Faulk County,3,150,71,79
South Dakota,Faulk County,4,124,54,70
South Dakota,Faulk County,5,113,57,56
South Dakota,Faulk County,6,123,64,59
South Dakota,Faulk County,7,113,49,64
South Dakota,Faulk County,8,121,64,57
South Dakota,Faulk County,9,105,51,54
South Dakota,Faulk County,10,104,51,53
South Dakota,Faulk County,11,126,61,65
South Dakota,Faulk County,12,175,101,74
South Dakota,Faulk County,13,183,91,92
South Dakota,Faulk County,14,148,78,70
South Dakota,Faulk County,15,102,56,46
South Dakota,Faulk County,16,88,38,50
South Dakota,Faulk County,17,89,41,48
South Dakota,Faulk County,18,117,52,65
South Dakota,Grant County,0,7147,3756,3391
South Dakota,Grant County,1,443,246,197
South Dakota,Grant County,2,423,216,207
South Dakota,Grant County,3,473,282,191
South Dakota,Grant County,4,426,223,203
South Dakota,Grant County,5,367,190,177
South Dakota,Grant County,6,337,184,153
South Dakota,Grant County,7,337,187,150
South Dakota,Grant County,8,385,200,185
South Dakota,Grant County,9,398,203,195
South Dakota,Grant County,10,426,268,158
South Dakota,Grant County,11,445,223,222
South Dakota,Grant County,12,622,326,296
South Dakota,Grant County,13,576,314,262
South Dakota,Grant County,14,470,236,234
South Dakota,Grant County,15,355,173,182
South Dakota,Grant County,16,250,116,134
South Dakota,Grant County,17,190,85,105
South Dakota,Grant County,18,224,84,140
South Dakota,Gregory County,0,4212,2167,2045
South Dakota,Gregory County,1,277,155,122
South Dakota,Gregory County,2,249,136,113
South Dakota,Gregory County,3,296,159,137
South Dakota,Gregory County,4,260,146,114
South Dakota,Gregory County,5,202,106,96
South Dakota,Gregory County,6,172,93,79
South Dakota,Gregory County,7,175,91,84
South Dakota,Gregory County,8,216,121,95
South Dakota,Gregory County,9,224,116,108
South Dakota,Gregory County,10,215,115,100
South Dakota,Gregory County,11,218,111,107
South Dakota,Gregory County,12,308,157,151
South Dakota,Gregory County,13,328,161,167
South Dakota,Gregory County,14,304,161,143
South Dakota,Gregory County,15,251,124,127
South Dakota,Gregory County,16,180,90,90
South Dakota,Gregory County,17,140,58,82
South Dakota,Gregory County,18,197,67,130
South Dakota,Haakon County,0,1918,954,964
South Dakota,Haakon County,1,115,48,67
South Dakota,Haakon County,2,126,63,63
South Dakota,Haakon County,3,137,67,70
South Dakota,Haakon County,4,114,61,53
South Dakota,Haakon County,5,88,43,45
South Dakota,Haakon County,6,86,39,47
South Dakota,Haakon County,7,89,42,47
South Dakota,Haakon County,8,118,69,49
South Dakota,Haakon County,9,85,40,45
South Dakota,Haakon County,10,85,47,38
South Dakota,Haakon County,11,73,41,32
South Dakota,Haakon County,12,158,81,77
South Dakota,Haakon County,13,176,103,73
South Dakota,Haakon County,14,125,56,69
South Dakota,Haakon County,15,105,52,53
South Dakota,Haakon County,16,94,46,48
South Dakota,Haakon County,17,73,41,32
South Dakota,Haakon County,18,71,15,56
South Dakota,Hamlin County,0,6111,3138,2973
South Dakota,Hamlin County,1,550,296,254
South Dakota,Hamlin County,2,505,247,258
South Dakota,Hamlin County,3,547,288,259
South Dakota,Hamlin County,4,481,249,232
South Dakota,Hamlin County,5,353,179,174
South Dakota,Hamlin County,6,342,173,169
South Dakota,Hamlin County,7,291,165,126
South Dakota,Hamlin County,8,348,189,159
South Dakota,Hamlin County,9,320,176,144
South Dakota,Hamlin County,10,318,163,155
South Dakota,Hamlin County,11,306,153,153
South Dakota,Hamlin County,12,414,220,194
South Dakota,Hamlin County,13,383,196,187
South Dakota,Hamlin County,14,297,154,143
South Dakota,Hamlin County,15,215,117,98
South Dakota,Hamlin County,16,155,74,81
South Dakota,Hamlin County,17,125,54,71
South Dakota,Hamlin County,18,161,45,116
South Dakota,Hand County,0,3262,1627,1635
South Dakota,Hand County,1,191,108,83
South Dakota,Hand County,2,205,100,105
South Dakota,Hand County,3,227,115,112
South Dakota,Hand County,4,147,69,78
South Dakota,Hand County,5,162,85,77
South Dakota,Hand County,6,169,96,73
South Dakota,Hand County,7,147,72,75
South Dakota,Hand County,8,167,91,76
South Dakota,Hand County,9,159,81,78
South Dakota,Hand County,10,132,64,68
South Dakota,Hand County,11,215,110,105
South Dakota,Hand County,12,255,141,114
South Dakota,Hand County,13,260,125,135
South Dakota,Hand County,14,228,112,116
South Dakota,Hand County,15,128,58,70
South Dakota,Hand County,16,140,66,74
South Dakota,Hand County,17,133,58,75
South Dakota,Hand County,18,197,76,121
South Dakota,Hanson County,0,3376,1690,1686
South Dakota,Hanson County,1,256,115,141
South Dakota,Hanson County,2,290,149,141
South Dakota,Hanson County,3,302,154,148
South Dakota,Hanson County,4,275,136,139
South Dakota,Hanson County,5,159,85,74
South Dakota,Hanson County,6,172,83,89
South Dakota,Hanson County,7,143,59,84
South Dakota,Hanson County,8,217,114,103
South Dakota,Hanson County,9,204,105,99
South Dakota,Hanson County,10,185,94,91
South Dakota,Hanson County,11,225,114,111
South Dakota,Hanson County,12,202,100,102
South Dakota,Hanson County,13,225,121,104
South Dakota,Hanson County,14,258,129,129
South Dakota,Hanson County,15,128,66,62
South Dakota,Hanson County,16,77,41,36
South Dakota,Hanson County,17,28,14,14
South Dakota,Hanson County,18,30,11,19
South Dakota,Harding County,0,1249,657,592
South Dakota,Harding County,1,82,42,40
South Dakota,Harding County,2,78,30,48
South Dakota,Harding County,3,66,31,35
South Dakota,Harding County,4,87,56,31
South Dakota,Harding County,5,60,29,31
South Dakota,Harding County,6,76,45,31
South Dakota,Harding County,7,76,47,29
South Dakota,Harding County,8,71,33,38
South Dakota,Harding County,9,63,37,26
South Dakota,Harding County,10,75,40,35
South Dakota,Harding County,11,76,40,36
South Dakota,Harding County,12,109,60,49
South Dakota,Harding County,13,108,54,54
South Dakota,Harding County,14,82,44,38
South Dakota,Harding County,15,49,28,21
South Dakota,Harding County,16,33,16,17
South Dakota,Harding County,17,24,11,13
South Dakota,Harding County,18,34,14,20
South Dakota,Hughes County,0,17650,8680,8970
South Dakota,Hughes County,1,1183,606,577
South Dakota,Hughes County,2,1260,661,599
South Dakota,Hughes County,3,1192,606,586
South Dakota,Hughes County,4,963,488,475
South Dakota,Hughes County,5,968,482,486
South Dakota,Hughes County,6,1126,534,592
South Dakota,Hughes County,7,1249,628,621
South Dakota,Hughes County,8,1122,544,578
South Dakota,Hughes County,9,971,461,510
South Dakota,Hughes County,10,996,477,519
South Dakota,Hughes County,11,1054,490,564
South Dakota,Hughes County,12,1294,635,659
South Dakota,Hughes County,13,1215,602,613
South Dakota,Hughes County,14,1049,546,503
South Dakota,Hughes County,15,741,382,359
South Dakota,Hughes County,16,490,237,253
South Dakota,Hughes County,17,334,136,198
South Dakota,Hughes County,18,443,165,278
South Dakota,Hutchinson County,0,7380,3605,3775
South Dakota,Hutchinson County,1,683,309,374
South Dakota,Hutchinson County,2,460,246,214
South Dakota,Hutchinson County,3,468,208,260
South Dakota,Hutchinson County,4,408,209,199
South Dakota,Hutchinson County,5,397,198,199
South Dakota,Hutchinson County,6,337,174,163
South Dakota,Hutchinson County,7,361,184,177
South Dakota,Hutchinson County,8,364,194,170
South Dakota,Hutchinson County,9,371,184,187
South Dakota,Hutchinson County,10,429,224,205
South Dakota,Hutchinson County,11,374,198,176
South Dakota,Hutchinson County,12,520,273,247
South Dakota,Hutchinson County,13,511,265,246
South Dakota,Hutchinson County,14,462,226,236
South Dakota,Hutchinson County,15,327,163,164
South Dakota,Hutchinson County,16,277,123,154
South Dakota,Hutchinson County,17,257,97,160
South Dakota,Hutchinson County,18,374,130,244
South Dakota,Hyde County,0,1282,666,616
South Dakota,Hyde County,1,78,38,40
South Dakota,Hyde County,2,60,36,24
South Dakota,Hyde County,3,84,48,36
South Dakota,Hyde County,4,68,35,33
South Dakota,Hyde County,5,52,28,24
South Dakota,Hyde County,6,82,49,33
South Dakota,Hyde County,7,58,30,28
South Dakota,Hyde County,8,66,35,31
South Dakota,Hyde County,9,69,43,26
South Dakota,Hyde County,10,44,13,31
South Dakota,Hyde County,11,84,41,43
South Dakota,Hyde County,12,83,49,34
South Dakota,Hyde County,13,130,55,75
South Dakota,Hyde County,14,81,47,34
South Dakota,Hyde County,15,57,36,21
South Dakota,Hyde County,16,60,31,29
South Dakota,Hyde County,17,63,35,28
South Dakota,Hyde County,18,63,17,46
South Dakota,Jackson County,0,3307,1662,1645
South Dakota,Jackson County,1,354,183,171
South Dakota,Jackson County,2,303,155,148
South Dakota,Jackson County,3,301,151,150
South Dakota,Jackson County,4,264,139,125
South Dakota,Jackson County,5,229,111,118
South Dakota,Jackson County,6,189,104,85
South Dakota,Jackson County,7,192,88,104
South Dakota,Jackson County,8,151,76,75
South Dakota,Jackson County,9,150,79,71
South Dakota,Jackson County,10,155,69,86
South Dakota,Jackson County,11,196,102,94
South Dakota,Jackson County,12,203,100,103
South Dakota,Jackson County,13,178,88,90
South Dakota,Jackson County,14,138,65,73
South Dakota,Jackson County,15,110,57,53
South Dakota,Jackson County,16,72,37,35
South Dakota,Jackson County,17,63,33,30
South Dakota,Jackson County,18,59,25,34
South Dakota,Jerauld County,0,2043,1032,1011
South Dakota,Jerauld County,1,131,60,71
South Dakota,Jerauld County,2,138,80,58
South Dakota,Jerauld County,3,137,71,66
South Dakota,Jerauld County,4,100,55,45
South Dakota,Jerauld County,5,73,46,27
South Dakota,Jerauld County,6,83,48,35
South Dakota,Jerauld County,7,116,63,53
South Dakota,Jerauld County,8,129,61,68
South Dakota,Jerauld County,9,107,60,47
South Dakota,Jerauld County,10,91,53,38
South Dakota,Jerauld County,11,100,48,52
South Dakota,Jerauld County,12,138,70,68
South Dakota,Jerauld County,13,150,77,73
South Dakota,Jerauld County,14,174,90,84
South Dakota,Jerauld County,15,118,61,57
South Dakota,Jerauld County,16,88,39,49
South Dakota,Jerauld County,17,68,26,42
South Dakota,Jerauld County,18,102,24,78
South Dakota,Jones County,0,928,458,470
South Dakota,Jones County,1,57,29,28
South Dakota,Jones County,2,63,33,30
South Dakota,Jones County,3,59,29,30
South Dakota,Jones County,4,40,24,16
South Dakota,Jones County,5,37,14,23
South Dakota,Jones County,6,40,17,23
South Dakota,Jones County,7,52,30,22
South Dakota,Jones County,8,43,21,22
South Dakota,Jones County,9,33,13,20
South Dakota,Jones County,10,61,32,29
South Dakota,Jones County,11,54,24,30
South Dakota,Jones County,12,89,37,52
South Dakota,Jones County,13,84,47,37
South Dakota,Jones County,14,68,37,31
South Dakota,Jones County,15,51,25,26
South Dakota,Jones County,16,34,18,16
South Dakota,Jones County,17,30,15,15
South Dakota,Jones County,18,33,13,20
South Dakota,Kingsbury County,0,4919,2524,2395
South Dakota,Kingsbury County,1,327,171,156
South Dakota,Kingsbury County,2,323,157,166
South Dakota,Kingsbury County,3,311,164,147
South Dakota,Kingsbury County,4,255,141,114
South Dakota,Kingsbury County,5,245,112,133
South Dakota,Kingsbury County,6,243,134,109
South Dakota,Kingsbury County,7,237,126,111
South Dakota,Kingsbury County,8,291,140,151
South Dakota,Kingsbury County,9,234,128,106
South Dakota,Kingsbury County,10,237,121,116
South Dakota,Kingsbury County,11,288,147,141
South Dakota,Kingsbury County,12,430,224,206
South Dakota,Kingsbury County,13,359,207,152
South Dakota,Kingsbury County,14,353,174,179
South Dakota,Kingsbury County,15,256,145,111
South Dakota,Kingsbury County,16,192,90,102
South Dakota,Kingsbury County,17,145,74,71
South Dakota,Kingsbury County,18,193,69,124
South Dakota,Lake County,0,13057,6810,6247
South Dakota,Lake County,1,709,376,333
South Dakota,Lake County,2,719,379,340
South Dakota,Lake County,3,732,375,357
South Dakota,Lake County,4,968,530,438
South Dakota,Lake County,5,856,497,359
South Dakota,Lake County,6,566,314,252
South Dakota,Lake County,7,615,321,294
South Dakota,Lake County,8,725,392,333
South Dakota,Lake County,9,607,317,290
South Dakota,Lake County,10,609,318,291
South Dakota,Lake County,11,750,387,363
South Dakota,Lake County,12,1083,508,575
South Dakota,Lake County,13,1247,599,648
South Dakota,Lake County,14,1225,679,546
South Dakota,Lake County,15,741,408,333
South Dakota,Lake County,16,391,212,179
South Dakota,Lake County,17,237,103,134
South Dakota,Lake County,18,277,95,182
South Dakota,Lawrence County,0,25741,12867,12874
South Dakota,Lawrence County,1,1121,605,516
South Dakota,Lawrence County,2,1268,652,616
South Dakota,Lawrence County,3,1431,731,700
South Dakota,Lawrence County,4,1716,875,841
South Dakota,Lawrence County,5,2003,969,1034
South Dakota,Lawrence County,6,1548,813,735
South Dakota,Lawrence County,7,1559,783,776
South Dakota,Lawrence County,8,1495,784,711
South Dakota,Lawrence County,9,1283,650,633
South Dakota,Lawrence County,10,1264,651,613
South Dakota,Lawrence County,11,1461,733,728
South Dakota,Lawrence County,12,1849,851,998
South Dakota,Lawrence County,13,2126,1071,1055
South Dakota,Lawrence County,14,2059,1041,1018
South Dakota,Lawrence County,15,1379,724,655
South Dakota,Lawrence County,16,892,440,452
South Dakota,Lawrence County,17,584,259,325
South Dakota,Lawrence County,18,703,235,468
South Dakota,Lincoln County,0,58807,29097,29710
South Dakota,Lincoln County,1,4321,2255,2066
South Dakota,Lincoln County,2,4805,2477,2328
South Dakota,Lincoln County,3,4848,2528,2320
South Dakota,Lincoln County,4,3622,1861,1761
South Dakota,Lincoln County,5,3148,1522,1626
South Dakota,Lincoln County,6,4117,2003,2114
South Dakota,Lincoln County,7,4401,2185,2216
South Dakota,Lincoln County,8,4716,2352,2364
South Dakota,Lincoln County,9,4001,2006,1995
South Dakota,Lincoln County,10,3700,1791,1909
South Dakota,Lincoln County,11,3199,1624,1575
South Dakota,Lincoln County,12,3320,1603,1717
South Dakota,Lincoln County,13,3041,1484,1557
South Dakota,Lincoln County,14,2775,1286,1489
South Dakota,Lincoln County,15,1924,932,992
South Dakota,Lincoln County,16,1175,532,643
South Dakota,Lincoln County,17,765,333,432
South Dakota,Lincoln County,18,929,323,606
South Dakota,Lyman County,0,3821,1998,1823
South Dakota,Lyman County,1,350,185,165
South Dakota,Lyman County,2,311,147,164
South Dakota,Lyman County,3,298,171,127
South Dakota,Lyman County,4,261,144,117
South Dakota,Lyman County,5,219,126,93
South Dakota,Lyman County,6,221,116,105
South Dakota,Lyman County,7,213,109,104
South Dakota,Lyman County,8,208,100,108
South Dakota,Lyman County,9,201,119,82
South Dakota,Lyman County,10,170,93,77
South Dakota,Lyman County,11,197,102,95
South Dakota,Lyman County,12,285,147,138
South Dakota,Lyman County,13,282,150,132
South Dakota,Lyman County,14,189,98,91
South Dakota,Lyman County,15,148,77,71
South Dakota,Lyman County,16,125,60,65
South Dakota,Lyman County,17,84,38,46
South Dakota,Lyman County,18,59,16,43
South Dakota,McCook County,0,5546,2779,2767
South Dakota,McCook County,1,409,210,199
South Dakota,McCook County,2,445,237,208
South Dakota,McCook County,3,436,230,206
South Dakota,McCook County,4,347,158,189
South Dakota,McCook County,5,286,149,137
South Dakota,McCook County,6,278,162,116
South Dakota,McCook County,7,263,115,148
South Dakota,McCook County,8,338,185,153
South Dakota,McCook County,9,313,157,156
South Dakota,McCook County,10,314,158,156
South Dakota,McCook County,11,314,172,142
South Dakota,McCook County,12,380,199,181
South Dakota,McCook County,13,370,186,184
South Dakota,McCook County,14,318,158,160
South Dakota,McCook County,15,223,93,130
South Dakota,McCook County,16,210,96,114
South Dakota,McCook County,17,140,68,72
South Dakota,McCook County,18,162,46,116
South Dakota,McPherson County,0,2407,1192,1215
South Dakota,McPherson County,1,157,87,70
South Dakota,McPherson County,2,175,82,93
South Dakota,McPherson County,3,166,84,82
South Dakota,McPherson County,4,137,68,69
South Dakota,McPherson County,5,95,54,41
South Dakota,McPherson County,6,99,54,45
South Dakota,McPherson County,7,104,51,53
South Dakota,McPherson County,8,124,63,61
South Dakota,McPherson County,9,111,57,54
South Dakota,McPherson County,10,110,51,59
South Dakota,McPherson County,11,124,58,66
South Dakota,McPherson County,12,160,85,75
South Dakota,McPherson County,13,169,86,83
South Dakota,McPherson County,14,165,83,82
South Dakota,McPherson County,15,139,70,69
South Dakota,McPherson County,16,110,54,56
South Dakota,McPherson County,17,122,58,64
South Dakota,McPherson County,18,140,47,93
South Dakota,Marshall County,0,5112,2750,2362
South Dakota,Marshall County,1,435,216,219
South Dakota,Marshall County,2,308,167,141
South Dakota,Marshall County,3,281,135,146
South Dakota,Marshall County,4,254,152,102
South Dakota,Marshall County,5,311,180,131
South Dakota,Marshall County,6,365,204,161
South Dakota,Marshall County,7,352,220,132
South Dakota,Marshall County,8,272,160,112
South Dakota,Marshall County,9,243,153,90
South Dakota,Marshall County,10,240,138,102
South Dakota,Marshall County,11,293,148,145
South Dakota,Marshall County,12,341,166,175
South Dakota,Marshall County,13,384,212,172
South Dakota,Marshall County,14,362,190,172
South Dakota,Marshall County,15,249,132,117
South Dakota,Marshall County,16,155,75,80
South Dakota,Marshall County,17,110,50,60
South Dakota,Marshall County,18,157,52,105
South Dakota,Meade County,0,28294,14725,13569
South Dakota,Meade County,1,1522,784,738
South Dakota,Meade County,2,1909,975,934
South Dakota,Meade County,3,2027,1017,1010
South Dakota,Meade County,4,1697,948,749
South Dakota,Meade County,5,2387,1540,847
South Dakota,Meade County,6,2095,1126,969
South Dakota,Meade County,7,1998,1035,963
South Dakota,Meade County,8,2013,1025,988
South Dakota,Meade County,9,1539,802,737
South Dakota,Meade County,10,1459,749,710
South Dakota,Meade County,11,1566,753,813
South Dakota,Meade County,12,1926,966,960
South Dakota,Meade County,13,1840,900,940
South Dakota,Meade County,14,1589,816,773
South Dakota,Meade County,15,1108,570,538
South Dakota,Meade County,16,702,346,356
South Dakota,Meade County,17,459,205,254
South Dakota,Meade County,18,458,168,290
South Dakota,Mellette County,0,2042,1059,983
South Dakota,Mellette County,1,210,98,112
South Dakota,Mellette County,2,139,87,52
South Dakota,Mellette County,3,200,108,92
South Dakota,Mellette County,4,140,73,67
South Dakota,Mellette County,5,134,72,62
South Dakota,Mellette County,6,144,77,67
South Dakota,Mellette County,7,99,53,46
South Dakota,Mellette County,8,81,24,57
South Dakota,Mellette County,9,95,50,45
South Dakota,Mellette County,10,91,48,43
South Dakota,Mellette County,11,122,60,62
South Dakota,Mellette County,12,137,66,71
South Dakota,Mellette County,13,134,74,60
South Dakota,Mellette County,14,109,67,42
South Dakota,Mellette County,15,82,41,41
South Dakota,Mellette County,16,49,25,24
South Dakota,Mellette County,17,40,22,18
South Dakota,Mellette County,18,36,14,22
South Dakota,Miner County,0,2213,1149,1064
South Dakota,Miner County,1,132,75,57
South Dakota,Miner County,2,132,72,60
South Dakota,Miner County,3,166,89,77
South Dakota,Miner County,4,142,69,73
South Dakota,Miner County,5,115,68,47
South Dakota,Miner County,6,107,58,49
South Dakota,Miner County,7,105,52,53
South Dakota,Miner County,8,98,52,46
South Dakota,Miner County,9,109,58,51
South Dakota,Miner County,10,94,43,51
South Dakota,Miner County,11,150,73,77
South Dakota,Miner County,12,197,105,92
South Dakota,Miner County,13,202,101,101
South Dakota,Miner County,14,138,95,43
South Dakota,Miner County,15,89,47,42
South Dakota,Miner County,16,84,33,51
South Dakota,Miner County,17,63,25,38
South Dakota,Miner County,18,90,34,56
South Dakota,Minnehaha County,0,192876,97356,95520
South Dakota,Minnehaha County,1,14858,7515,7343
South Dakota,Minnehaha County,2,14005,7213,6792
South Dakota,Minnehaha County,3,12978,6638,6340
South Dakota,Minnehaha County,4,11879,6142,5737
South Dakota,Minnehaha County,5,12259,6073,6186
South Dakota,Minnehaha County,6,15281,8017,7264
South Dakota,Minnehaha County,7,15392,8234,7158
South Dakota,Minnehaha County,8,14005,7349,6656
South Dakota,Minnehaha County,9,11408,5971,5437
South Dakota,Minnehaha County,10,11014,5651,5363
South Dakota,Minnehaha County,11,11105,5719,5386
South Dakota,Minnehaha County,12,12302,6034,6268
South Dakota,Minnehaha County,13,11161,5469,5692
South Dakota,Minnehaha County,14,9433,4667,4766
South Dakota,Minnehaha County,15,6080,2895,3185
South Dakota,Minnehaha County,16,3632,1601,2031
South Dakota,Minnehaha County,17,2690,1045,1645
South Dakota,Minnehaha County,18,3394,1123,2271
South Dakota,Moody County,0,6579,3272,3307
South Dakota,Moody County,1,504,247,257
South Dakota,Moody County,2,466,228,238
South Dakota,Moody County,3,461,236,225
South Dakota,Moody County,4,433,220,213
South Dakota,Moody County,5,360,203,157
South Dakota,Moody County,6,313,166,147
South Dakota,Moody County,7,321,151,170
South Dakota,Moody County,8,409,214,195
South Dakota,Moody County,9,355,161,194
South Dakota,Moody County,10,338,176,162
South Dakota,Moody County,11,404,196,208
South Dakota,Moody County,12,532,278,254
South Dakota,Moody County,13,449,215,234
South Dakota,Moody County,14,398,209,189
South Dakota,Moody County,15,283,143,140
South Dakota,Moody County,16,229,97,132
South Dakota,Moody County,17,151,61,90
South Dakota,Moody County,18,173,71,102
South Dakota,Oglala Lakota County,0,14309,7010,7299
South Dakota,Oglala Lakota County,1,1462,773,689
South Dakota,Oglala Lakota County,2,1563,761,802
South Dakota,Oglala Lakota County,3,1508,759,749
South Dakota,Oglala Lakota County,4,1262,640,622
South Dakota,Oglala Lakota County,5,1114,586,528
South Dakota,Oglala Lakota County,6,1168,575,593
South Dakota,Oglala Lakota County,7,1019,516,503
South Dakota,Oglala Lakota County,8,846,402,444
South Dakota,Oglala Lakota County,9,681,321,360
South Dakota,Oglala Lakota County,10,715,341,374
South Dakota,Oglala Lakota County,11,714,338,376
South Dakota,Oglala Lakota County,12,669,337,332
South Dakota,Oglala Lakota County,13,543,248,295
South Dakota,Oglala Lakota County,14,415,170,245
South Dakota,Oglala Lakota County,15,268,110,158
South Dakota,Oglala Lakota County,16,194,72,122
South Dakota,Oglala Lakota County,17,90,40,50
South Dakota,Oglala Lakota County,18,78,21,57
South Dakota,Pennington County,0,111729,56294,55435
South Dakota,Pennington County,1,7209,3741,3468
South Dakota,Pennington County,2,7112,3729,3383
South Dakota,Pennington County,3,7271,3767,3504
South Dakota,Pennington County,4,6555,3482,3073
South Dakota,Pennington County,5,6723,3671,3052
South Dakota,Pennington County,6,7755,4056,3699
South Dakota,Pennington County,7,7363,3774,3589
South Dakota,Pennington County,8,7024,3524,3500
South Dakota,Pennington County,9,6009,2990,3019
South Dakota,Pennington County,10,5933,2947,2986
South Dakota,Pennington County,11,6389,3217,3172
South Dakota,Pennington County,12,7861,3843,4018
South Dakota,Pennington County,13,8438,4118,4320
South Dakota,Pennington County,14,7301,3604,3697
South Dakota,Pennington County,15,5040,2530,2510
South Dakota,Pennington County,16,3200,1515,1685
South Dakota,Pennington County,17,2055,891,1164
South Dakota,Pennington County,18,2491,895,1596
South Dakota,Perkins County,0,2922,1465,1457
South Dakota,Perkins County,1,175,94,81
South Dakota,Perkins County,2,172,80,92
South Dakota,Perkins County,3,152,78,74
South Dakota,Perkins County,4,168,94,74
South Dakota,Perkins County,5,151,80,71
South Dakota,Perkins County,6,123,62,61
South Dakota,Perkins County,7,122,59,63
South Dakota,Perkins County,8,154,84,70
South Dakota,Perkins County,9,152,75,77
South Dakota,Perkins County,10,141,72,69
South Dakota,Perkins County,11,180,80,100
South Dakota,Perkins County,12,246,122,124
South Dakota,Perkins County,13,251,125,126
South Dakota,Perkins County,14,208,113,95
South Dakota,Perkins County,15,178,95,83
South Dakota,Perkins County,16,122,67,55
South Dakota,Perkins County,17,75,40,35
South Dakota,Perkins County,18,152,45,107
South Dakota,Potter County,0,2207,1094,1113
South Dakota,Potter County,1,122,79,43
South Dakota,Potter County,2,121,60,61
South Dakota,Potter County,3,154,73,81
South Dakota,Potter County,4,121,62,59
South Dakota,Potter County,5,96,47,49
South Dakota,Potter County,6,103,51,52
South Dakota,Potter County,7,87,46,41
South Dakota,Potter County,8,111,57,54
South Dakota,Potter County,9,87,47,40
South Dakota,Potter County,10,100,49,51
South Dakota,Potter County,11,122,51,71
South Dakota,Potter County,12,184,103,81
South Dakota,Potter County,13,161,84,77
South Dakota,Potter County,14,187,86,101
South Dakota,Potter County,15,144,73,71
South Dakota,Potter County,16,98,49,49
South Dakota,Potter County,17,97,42,55
South Dakota,Potter County,18,112,35,77
South Dakota,Roberts County,0,10447,5254,5193
South Dakota,Roberts County,1,931,488,443
South Dakota,Roberts County,2,846,434,412
South Dakota,Roberts County,3,799,387,412
South Dakota,Roberts County,4,663,356,307
South Dakota,Roberts County,5,644,355,289
South Dakota,Roberts County,6,552,257,295
South Dakota,Roberts County,7,503,251,252
South Dakota,Roberts County,8,503,241,262
South Dakota,Roberts County,9,472,227,245
South Dakota,Roberts County,10,517,275,242
South Dakota,Roberts County,11,613,295,318
South Dakota,Roberts County,12,712,343,369
South Dakota,Roberts County,13,659,355,304
South Dakota,Roberts County,14,616,311,305
South Dakota,Roberts County,15,521,274,247
South Dakota,Roberts County,16,345,173,172
South Dakota,Roberts County,17,254,122,132
South Dakota,Roberts County,18,297,110,187
South Dakota,Sanborn County,0,2429,1266,1163
South Dakota,Sanborn County,1,186,91,95
South Dakota,Sanborn County,2,167,94,73
South Dakota,Sanborn County,3,174,90,84
South Dakota,Sanborn County,4,128,68,60
South Dakota,Sanborn County,5,116,62,54
South Dakota,Sanborn County,6,117,61,56
South Dakota,Sanborn County,7,167,95,72
South Dakota,Sanborn County,8,152,72,80
South Dakota,Sanborn County,9,135,85,50
South Dakota,Sanborn County,10,117,66,51
South Dakota,Sanborn County,11,111,50,61
South Dakota,Sanborn County,12,199,96,103
South Dakota,Sanborn County,13,183,100,83
South Dakota,Sanborn County,14,181,99,82
South Dakota,Sanborn County,15,101,50,51
South Dakota,Sanborn County,16,68,33,35
South Dakota,Sanborn County,17,56,29,27
South Dakota,Sanborn County,18,71,25,46
South Dakota,Spink County,0,6495,3251,3244
South Dakota,Spink County,1,392,186,206
South Dakota,Spink County,2,367,189,178
South Dakota,Spink County,3,464,242,222
South Dakota,Spink County,4,405,223,182
South Dakota,Spink County,5,342,171,171
South Dakota,Spink County,6,342,175,167
South Dakota,Spink County,7,392,212,180
South Dakota,Spink County,8,412,225,187
South Dakota,Spink County,9,287,135,152
South Dakota,Spink County,10,338,163,175
South Dakota,Spink County,11,381,194,187
South Dakota,Spink County,12,537,265,272
South Dakota,Spink County,13,488,258,230
South Dakota,Spink County,14,418,210,208
South Dakota,Spink County,15,269,142,127
South Dakota,Spink County,16,231,101,130
South Dakota,Spink County,17,185,84,101
South Dakota,Spink County,18,245,76,169
South Dakota,Stanley County,0,3022,1550,1472
South Dakota,Stanley County,1,187,98,89
South Dakota,Stanley County,2,198,94,104
South Dakota,Stanley County,3,228,105,123
South Dakota,Stanley County,4,178,108,70
South Dakota,Stanley County,5,123,75,48
South Dakota,Stanley County,6,174,93,81
South Dakota,Stanley County,7,156,82,74
South Dakota,Stanley County,8,186,95,91
South Dakota,Stanley County,9,188,101,87
South Dakota,Stanley County,10,169,83,86
South Dakota,Stanley County,11,199,99,100
South Dakota,Stanley County,12,198,96,102
South Dakota,Stanley County,13,221,103,118
South Dakota,Stanley County,14,203,113,90
South Dakota,Stanley County,15,155,70,85
South Dakota,Stanley County,16,124,60,64
South Dakota,Stanley County,17,73,47,26
South Dakota,Stanley County,18,62,28,34
South Dakota,Sully County,0,1392,732,660
South Dakota,Sully County,1,78,33,45
South Dakota,Sully County,2,83,47,36
South Dakota,Sully County,3,84,42,42
South Dakota,Sully County,4,71,38,33
South Dakota,Sully County,5,53,29,24
South Dakota,Sully County,6,65,39,26
South Dakota,Sully County,7,74,43,31
South Dakota,Sully County,8,75,36,39
South Dakota,Sully County,9,72,39,33
South Dakota,Sully County,10,63,31,32
South Dakota,Sully County,11,90,48,42
South Dakota,Sully County,12,112,60,52
South Dakota,Sully County,13,124,64,60
South Dakota,Sully County,14,124,77,47
South Dakota,Sully County,15,76,40,36
South Dakota,Sully County,16,55,24,31
South Dakota,Sully County,17,40,22,18
South Dakota,Sully County,18,53,20,33
South Dakota,Todd County,0,10283,5004,5279
South Dakota,Todd County,1,1334,649,685
South Dakota,Todd County,2,1235,651,584
South Dakota,Todd County,3,1134,551,583
South Dakota,Todd County,4,947,487,460
South Dakota,Todd County,5,685,327,358
South Dakota,Todd County,6,764,385,379
South Dakota,Todd County,7,650,313,337
South Dakota,Todd County,8,559,278,281
South Dakota,Todd County,9,486,229,257
South Dakota,Todd County,10,421,192,229
South Dakota,Todd County,11,456,201,255
South Dakota,Todd County,12,427,218,209
South Dakota,Todd County,13,424,194,230
South Dakota,Todd County,14,290,117,173
South Dakota,Todd County,15,185,85,100
South Dakota,Todd County,16,114,58,56
South Dakota,Todd County,17,80,35,45
South Dakota,Todd County,18,92,34,58
South Dakota,Tripp County,0,5478,2761,2717
South Dakota,Tripp County,1,391,215,176
South Dakota,Tripp County,2,328,168,160
South Dakota,Tripp County,3,334,166,168
South Dakota,Tripp County,4,326,167,159
South Dakota,Tripp County,5,297,151,146
South Dakota,Tripp County,6,312,173,139
South Dakota,Tripp County,7,292,160,132
South Dakota,Tripp County,8,241,119,122
South Dakota,Tripp County,9,266,144,122
South Dakota,Tripp County,10,294,152,142
South Dakota,Tripp County,11,350,168,182
South Dakota,Tripp County,12,451,242,209
South Dakota,Tripp County,13,367,198,169
South Dakota,Tripp County,14,335,167,168
South Dakota,Tripp County,15,294,130,164
South Dakota,Tripp County,16,213,100,113
South Dakota,Tripp County,17,153,70,83
South Dakota,Tripp County,18,234,71,163
South Dakota,Turner County,0,8424,4241,4183
South Dakota,Turner County,1,521,273,248
South Dakota,Turner County,2,607,314,293
South Dakota,Turner County,3,569,286,283
South Dakota,Turner County,4,513,279,234
South Dakota,Turner County,5,367,176,191
South Dakota,Turner County,6,413,220,193
South Dakota,Turner County,7,480,242,238
South Dakota,Turner County,8,523,273,250
South Dakota,Turner County,9,491,253,238
South Dakota,Turner County,10,497,252,245
South Dakota,Turner County,11,484,243,241
South Dakota,Turner County,12,619,322,297
South Dakota,Turner County,13,594,298,296
South Dakota,Turner County,14,531,292,239
South Dakota,Turner County,15,387,176,211
South Dakota,Turner County,16,304,130,174
South Dakota,Turner County,17,233,99,134
South Dakota,Turner County,18,291,113,178
South Dakota,Union County,0,15619,7874,7745
South Dakota,Union County,1,969,447,522
South Dakota,Union County,2,1046,524,522
South Dakota,Union County,3,1113,573,540
South Dakota,Union County,4,989,511,478
South Dakota,Union County,5,771,406,365
South Dakota,Union County,6,934,525,409
South Dakota,Union County,7,905,456,449
South Dakota,Union County,8,957,477,480
South Dakota,Union County,9,989,498,491
South Dakota,Union County,10,926,481,445
South Dakota,Union County,11,1025,557,468
South Dakota,Union County,12,1094,532,562
South Dakota,Union County,13,1069,531,538
South Dakota,Union County,14,1017,530,487
South Dakota,Union County,15,690,336,354
South Dakota,Union County,16,487,230,257
South Dakota,Union County,17,274,127,147
South Dakota,Union County,18,364,133,231
South Dakota,Walworth County,0,5587,2775,2812
South Dakota,Walworth County,1,396,203,193
South Dakota,Walworth County,2,331,141,190
South Dakota,Walworth County,3,373,178,195
South Dakota,Walworth County,4,353,215,138
South Dakota,Walworth County,5,277,133,144
South Dakota,Walworth County,6,292,153,139
South Dakota,Walworth County,7,317,175,142
South Dakota,Walworth County,8,279,140,139
South Dakota,Walworth County,9,298,160,138
South Dakota,Walworth County,10,267,138,129
South Dakota,Walworth County,11,295,136,159
South Dakota,Walworth County,12,381,199,182
South Dakota,Walworth County,13,416,201,215
South Dakota,Walworth County,14,378,188,190
South Dakota,Walworth County,15,295,149,146
South Dakota,Walworth County,16,217,105,112
South Dakota,Walworth County,17,202,84,118
South Dakota,Walworth County,18,220,77,143
South Dakota,Yankton County,0,22869,11900,10969
South Dakota,Yankton County,1,1380,689,691
South Dakota,Yankton County,2,1291,655,636
South Dakota,Yankton County,3,1390,711,679
South Dakota,Yankton County,4,1338,689,649
South Dakota,Yankton County,5,1473,773,700
South Dakota,Yankton County,6,1417,824,593
South Dakota,Yankton County,7,1456,852,604
South Dakota,Yankton County,8,1404,842,562
South Dakota,Yankton County,9,1285,715,570
South Dakota,Yankton County,10,1383,781,602
South Dakota,Yankton County,11,1458,796,662
South Dakota,Yankton County,12,1652,839,813
South Dakota,Yankton County,13,1631,826,805
South Dakota,Yankton County,14,1358,668,690
South Dakota,Yankton County,15,953,450,503
South Dakota,Yankton County,16,739,343,396
South Dakota,Yankton County,17,534,207,327
South Dakota,Yankton County,18,727,240,487
South Dakota,Ziebach County,0,2742,1369,1373
South Dakota,Ziebach County,1,159,89,70
South Dakota,Ziebach County,2,182,77,105
South Dakota,Ziebach County,3,263,108,155
South Dakota,Ziebach County,4,288,147,141
South Dakota,Ziebach County,5,213,102,111
South Dakota,Ziebach County,6,163,95,68
South Dakota,Ziebach County,7,133,68,65
South Dakota,Ziebach County,8,215,134,81
South Dakota,Ziebach County,9,190,89,101
South Dakota,Ziebach County,10,175,90,85
South Dakota,Ziebach County,11,146,57,89
South Dakota,Ziebach County,12,232,124,108
South Dakota,Ziebach County,13,120,63,57
South Dakota,Ziebach County,14,87,48,39
South Dakota,Ziebach County,15,63,20,43
South Dakota,Ziebach County,16,47,27,20
South Dakota,Ziebach County,17,32,11,21
South Dakota,Ziebach County,18,34,20,14
Tennessee,Anderson County,0,76482,37216,39266
Tennessee,Anderson County,1,4013,2062,1951
Tennessee,Anderson County,2,4418,2233,2185
Tennessee,Anderson County,3,4773,2440,2333
Tennessee,Anderson County,4,4381,2269,2112
Tennessee,Anderson County,5,4128,2171,1957
Tennessee,Anderson County,6,4943,2480,2463
Tennessee,Anderson County,7,4334,2177,2157
Tennessee,Anderson County,8,4421,2206,2215
Tennessee,Anderson County,9,4440,2204,2236
Tennessee,Anderson County,10,4993,2399,2594
Tennessee,Anderson County,11,5175,2438,2737
Tennessee,Anderson County,12,5632,2740,2892
Tennessee,Anderson County,13,5475,2638,2837
Tennessee,Anderson County,14,4869,2290,2579
Tennessee,Anderson County,15,3914,1827,2087
Tennessee,Anderson County,16,2613,1208,1405
Tennessee,Anderson County,17,1805,705,1100
Tennessee,Anderson County,18,2155,729,1426
Tennessee,Bedford County,0,49038,24090,24948
Tennessee,Bedford County,1,3284,1612,1672
Tennessee,Bedford County,2,3417,1712,1705
Tennessee,Bedford County,3,3628,1847,1781
Tennessee,Bedford County,4,3235,1722,1513
Tennessee,Bedford County,5,2929,1502,1427
Tennessee,Bedford County,6,3509,1778,1731
Tennessee,Bedford County,7,3025,1489,1536
Tennessee,Bedford County,8,3072,1563,1509
Tennessee,Bedford County,9,3037,1514,1523
Tennessee,Bedford County,10,3303,1638,1665
Tennessee,Bedford County,11,3174,1534,1640
Tennessee,Bedford County,12,3227,1552,1675
Tennessee,Bedford County,13,2801,1368,1433
Tennessee,Bedford County,14,2439,1125,1314
Tennessee,Bedford County,15,2059,918,1141
Tennessee,Bedford County,16,1382,633,749
Tennessee,Bedford County,17,844,364,480
Tennessee,Bedford County,18,673,219,454
Tennessee,Benton County,0,16184,7926,8258
Tennessee,Benton County,1,815,419,396
Tennessee,Benton County,2,948,504,444
Tennessee,Benton County,3,913,453,460
Tennessee,Benton County,4,879,449,430
Tennessee,Benton County,5,776,398,378
Tennessee,Benton County,6,832,413,419
Tennessee,Benton County,7,780,392,388
Tennessee,Benton County,8,866,429,437
Tennessee,Benton County,9,879,443,436
Tennessee,Benton County,10,1065,527,538
Tennessee,Benton County,11,1168,582,586
Tennessee,Benton County,12,1187,547,640
Tennessee,Benton County,13,1251,585,666
Tennessee,Benton County,14,1152,580,572
Tennessee,Benton County,15,1098,524,574
Tennessee,Benton County,16,718,353,365
Tennessee,Benton County,17,457,197,260
Tennessee,Benton County,18,400,131,269
Tennessee,Bledsoe County,0,14755,8697,6058
Tennessee,Bledsoe County,1,600,326,274
Tennessee,Bledsoe County,2,560,323,237
Tennessee,Bledsoe County,3,628,332,296
Tennessee,Bledsoe County,4,732,430,302
Tennessee,Bledsoe County,5,783,474,309
Tennessee,Bledsoe County,6,1050,689,361
Tennessee,Bledsoe County,7,984,715,269
Tennessee,Bledsoe County,8,1053,701,352
Tennessee,Bledsoe County,9,1124,738,386
Tennessee,Bledsoe County,10,1103,683,420
Tennessee,Bledsoe County,11,1137,689,448
Tennessee,Bledsoe County,12,1237,681,556
Tennessee,Bledsoe County,13,1041,567,474
Tennessee,Bledsoe County,14,884,456,428
Tennessee,Bledsoe County,15,755,387,368
Tennessee,Bledsoe County,16,539,268,271
Tennessee,Bledsoe County,17,287,125,162
Tennessee,Bledsoe County,18,258,113,145
Tennessee,Blount County,0,131349,63707,67642
Tennessee,Blount County,1,6588,3341,3247
Tennessee,Blount County,2,7100,3596,3504
Tennessee,Blount County,3,7840,4019,3821
Tennessee,Blount County,4,7938,4031,3907
Tennessee,Blount County,5,7369,3723,3646
Tennessee,Blount County,6,8260,4221,4039
Tennessee,Blount County,7,7227,3579,3648
Tennessee,Blount County,8,7561,3681,3880
Tennessee,Blount County,9,7534,3658,3876
Tennessee,Blount County,10,9032,4407,4625
Tennessee,Blount County,11,9370,4494,4876
Tennessee,Blount County,12,9757,4739,5018
Tennessee,Blount County,13,9198,4305,4893
Tennessee,Blount County,14,8470,3972,4498
Tennessee,Blount County,15,7118,3305,3813
Tennessee,Blount County,16,5049,2318,2731
Tennessee,Blount County,17,3060,1308,1752
Tennessee,Blount County,18,2878,1010,1868
Tennessee,Bradley County,0,106727,51892,54835
Tennessee,Bradley County,1,6134,3108,3026
Tennessee,Bradley County,2,6221,3172,3049
Tennessee,Bradley County,3,6683,3451,3232
Tennessee,Bradley County,4,7305,3651,3654
Tennessee,Bradley County,5,7162,3563,3599
Tennessee,Bradley County,6,7317,3642,3675
Tennessee,Bradley County,7,6336,3194,3142
Tennessee,Bradley County,8,6411,3149,3262
Tennessee,Bradley County,9,6704,3362,3342
Tennessee,Bradley County,10,7224,3581,3643
Tennessee,Bradley County,11,7169,3524,3645
Tennessee,Bradley County,12,7247,3471,3776
Tennessee,Bradley County,13,6539,3084,3455
Tennessee,Bradley County,14,5648,2605,3043
Tennessee,Bradley County,15,4936,2199,2737
Tennessee,Bradley County,16,3518,1550,1968
Tennessee,Bradley County,17,2219,941,1278
Tennessee,Bradley County,18,1954,645,1309
Tennessee,Campbell County,0,39583,19454,20129
Tennessee,Campbell County,1,2185,1163,1022
Tennessee,Campbell County,2,2081,1077,1004
Tennessee,Campbell County,3,2416,1265,1151
Tennessee,Campbell County,4,2232,1140,1092
Tennessee,Campbell County,5,2140,1102,1038
Tennessee,Campbell County,6,2560,1276,1284
Tennessee,Campbell County,7,2026,977,1049
Tennessee,Campbell County,8,2195,1077,1118
Tennessee,Campbell County,9,2385,1201,1184
Tennessee,Campbell County,10,2775,1378,1397
Tennessee,Campbell County,11,2857,1448,1409
Tennessee,Campbell County,12,2729,1313,1416
Tennessee,Campbell County,13,2790,1334,1456
Tennessee,Campbell County,14,2551,1212,1339
Tennessee,Campbell County,15,2178,990,1188
Tennessee,Campbell County,16,1647,755,892
Tennessee,Campbell County,17,1031,457,574
Tennessee,Campbell County,18,805,289,516
Tennessee,Cannon County,0,14462,7186,7276
Tennessee,Cannon County,1,869,432,437
Tennessee,Cannon County,2,828,447,381
Tennessee,Cannon County,3,870,439,431
Tennessee,Cannon County,4,809,404,405
Tennessee,Cannon County,5,792,417,375
Tennessee,Cannon County,6,983,519,464
Tennessee,Cannon County,7,866,447,419
Tennessee,Cannon County,8,839,438,401
Tennessee,Cannon County,9,801,405,396
Tennessee,Cannon County,10,1012,508,504
Tennessee,Cannon County,11,1087,557,530
Tennessee,Cannon County,12,1096,559,537
Tennessee,Cannon County,13,959,442,517
Tennessee,Cannon County,14,842,384,458
Tennessee,Cannon County,15,700,322,378
Tennessee,Cannon County,16,510,231,279
Tennessee,Cannon County,17,318,139,179
Tennessee,Cannon County,18,281,96,185
Tennessee,Carroll County,0,28020,13713,14307
Tennessee,Carroll County,1,1572,794,778
Tennessee,Carroll County,2,1725,904,821
Tennessee,Carroll County,3,1681,879,802
Tennessee,Carroll County,4,1946,1063,883
Tennessee,Carroll County,5,1860,964,896
Tennessee,Carroll County,6,1699,876,823
Tennessee,Carroll County,7,1431,693,738
Tennessee,Carroll County,8,1427,689,738
Tennessee,Carroll County,9,1485,733,752
Tennessee,Carroll County,10,1769,863,906
Tennessee,Carroll County,11,1889,925,964
Tennessee,Carroll County,12,1966,971,995
Tennessee,Carroll County,13,1871,889,982
Tennessee,Carroll County,14,1720,773,947
Tennessee,Carroll County,15,1565,734,831
Tennessee,Carroll County,16,1052,458,594
Tennessee,Carroll County,17,696,273,423
Tennessee,Carroll County,18,666,232,434
Tennessee,Carter County,0,56351,27579,28772
Tennessee,Carter County,1,2534,1275,1259
Tennessee,Carter County,2,2708,1361,1347
Tennessee,Carter County,3,3174,1595,1579
Tennessee,Carter County,4,2995,1531,1464
Tennessee,Carter County,5,2867,1449,1418
Tennessee,Carter County,6,3670,1854,1816
Tennessee,Carter County,7,3301,1701,1600
Tennessee,Carter County,8,3149,1608,1541
Tennessee,Carter County,9,3200,1563,1637
Tennessee,Carter County,10,4031,1936,2095
Tennessee,Carter County,11,4032,2003,2029
Tennessee,Carter County,12,4172,2050,2122
Tennessee,Carter County,13,4154,1981,2173
Tennessee,Carter County,14,3811,1803,2008
Tennessee,Carter County,15,3220,1563,1657
Tennessee,Carter County,16,2413,1125,1288
Tennessee,Carter County,17,1508,645,863
Tennessee,Carter County,18,1412,536,876
Tennessee,Cheatham County,0,40439,20093,20346
Tennessee,Cheatham County,1,2335,1211,1124
Tennessee,Cheatham County,2,2260,1166,1094
Tennessee,Cheatham County,3,2725,1378,1347
Tennessee,Cheatham County,4,2517,1273,1244
Tennessee,Cheatham County,5,2122,1116,1006
Tennessee,Cheatham County,6,2624,1368,1256
Tennessee,Cheatham County,7,2536,1268,1268
Tennessee,Cheatham County,8,2600,1269,1331
Tennessee,Cheatham County,9,2513,1215,1298
Tennessee,Cheatham County,10,2951,1499,1452
Tennessee,Cheatham County,11,3160,1566,1594
Tennessee,Cheatham County,12,3292,1621,1671
Tennessee,Cheatham County,13,2751,1340,1411
Tennessee,Cheatham County,14,2300,1121,1179
Tennessee,Cheatham County,15,1626,798,828
Tennessee,Cheatham County,16,1044,452,592
Tennessee,Cheatham County,17,598,264,334
Tennessee,Cheatham County,18,485,168,317
Tennessee,Chester County,0,17276,8309,8967
Tennessee,Chester County,1,944,467,477
Tennessee,Chester County,2,1005,511,494
Tennessee,Chester County,3,1139,600,539
Tennessee,Chester County,4,1493,736,757
Tennessee,Chester County,5,1509,760,749
Tennessee,Chester County,6,1068,522,546
Tennessee,Chester County,7,895,427,468
Tennessee,Chester County,8,1005,480,525
Tennessee,Chester County,9,1020,464,556
Tennessee,Chester County,10,1039,522,517
Tennessee,Chester County,11,1047,485,562
Tennessee,Chester County,12,1134,557,577
Tennessee,Chester County,13,1012,493,519
Tennessee,Chester County,14,913,416,497
Tennessee,Chester County,15,782,378,404
Tennessee,Chester County,16,534,231,303
Tennessee,Chester County,17,369,141,228
Tennessee,Chester County,18,368,119,249
Tennessee,Claiborne County,0,31756,15530,16226
Tennessee,Claiborne County,1,1585,813,772
Tennessee,Claiborne County,2,1582,785,797
Tennessee,Claiborne County,3,1773,900,873
Tennessee,Claiborne County,4,1922,977,945
Tennessee,Claiborne County,5,2050,1064,986
Tennessee,Claiborne County,6,2226,1115,1111
Tennessee,Claiborne County,7,1772,916,856
Tennessee,Claiborne County,8,1749,874,875
Tennessee,Claiborne County,9,1894,943,951
Tennessee,Claiborne County,10,2116,1012,1104
Tennessee,Claiborne County,11,2208,1084,1124
Tennessee,Claiborne County,12,2213,1061,1152
Tennessee,Claiborne County,13,2332,1137,1195
Tennessee,Claiborne County,14,2071,978,1093
Tennessee,Claiborne County,15,1777,819,958
Tennessee,Claiborne County,16,1162,548,614
Tennessee,Claiborne County,17,769,330,439
Tennessee,Claiborne County,18,555,174,381
Tennessee,Clay County,0,7717,3800,3917
Tennessee,Clay County,1,370,175,195
Tennessee,Clay County,2,452,234,218
Tennessee,Clay County,3,479,243,236
Tennessee,Clay County,4,386,191,195
Tennessee,Clay County,5,349,166,183
Tennessee,Clay County,6,418,201,217
Tennessee,Clay County,7,357,171,186
Tennessee,Clay County,8,384,211,173
Tennessee,Clay County,9,399,205,194
Tennessee,Clay County,10,513,277,236
Tennessee,Clay County,11,588,290,298
Tennessee,Clay County,12,546,277,269
Tennessee,Clay County,13,599,284,315
Tennessee,Clay County,14,555,272,283
Tennessee,Clay County,15,480,240,240
Tennessee,Clay County,16,418,191,227
Tennessee,Clay County,17,234,102,132
Tennessee,Clay County,18,190,70,120
Tennessee,Cocke County,0,35774,17289,18485
Tennessee,Cocke County,1,1889,938,951
Tennessee,Cocke County,2,1969,1007,962
Tennessee,Cocke County,3,2130,1119,1011
Tennessee,Cocke County,4,1930,972,958
Tennessee,Cocke County,5,1854,926,928
Tennessee,Cocke County,6,2088,1005,1083
Tennessee,Cocke County,7,1857,861,996
Tennessee,Cocke County,8,1893,903,990
Tennessee,Cocke County,9,2025,957,1068
Tennessee,Cocke County,10,2457,1193,1264
Tennessee,Cocke County,11,2583,1264,1319
Tennessee,Cocke County,12,2783,1329,1454
Tennessee,Cocke County,13,2780,1286,1494
Tennessee,Cocke County,14,2479,1191,1288
Tennessee,Cocke County,15,2132,1033,1099
Tennessee,Cocke County,16,1418,695,723
Tennessee,Cocke County,17,874,362,512
Tennessee,Cocke County,18,633,248,385
Tennessee,Coffee County,0,55700,27208,28492
Tennessee,Coffee County,1,3519,1818,1701
Tennessee,Coffee County,2,3656,1878,1778
Tennessee,Coffee County,3,3942,2022,1920
Tennessee,Coffee County,4,3469,1783,1686
Tennessee,Coffee County,5,3143,1627,1516
Tennessee,Coffee County,6,3691,1853,1838
Tennessee,Coffee County,7,3186,1506,1680
Tennessee,Coffee County,8,3414,1671,1743
Tennessee,Coffee County,9,3310,1623,1687
Tennessee,Coffee County,10,3556,1752,1804
Tennessee,Coffee County,11,3706,1815,1891
Tennessee,Coffee County,12,3914,1895,2019
Tennessee,Coffee County,13,3574,1762,1812
Tennessee,Coffee County,14,2916,1362,1554
Tennessee,Coffee County,15,2559,1142,1417
Tennessee,Coffee County,16,1851,812,1039
Tennessee,Coffee County,17,1217,503,714
Tennessee,Coffee County,18,1077,384,693
Tennessee,Crockett County,0,14328,6853,7475
Tennessee,Crockett County,1,833,451,382
Tennessee,Crockett County,2,925,433,492
Tennessee,Crockett County,3,1019,493,526
Tennessee,Crockett County,4,908,454,454
Tennessee,Crockett County,5,768,361,407
Tennessee,Crockett County,6,902,468,434
Tennessee,Crockett County,7,811,394,417
Tennessee,Crockett County,8,853,397,456
Tennessee,Crockett County,9,822,417,405
Tennessee,Crockett County,10,879,418,461
Tennessee,Crockett County,11,945,474,471
Tennessee,Crockett County,12,1072,503,569
Tennessee,Crockett County,13,899,438,461
Tennessee,Crockett County,14,805,400,405
Tennessee,Crockett County,15,694,311,383
Tennessee,Crockett County,16,509,216,293
Tennessee,Crockett County,17,341,132,209
Tennessee,Crockett County,18,343,93,250
Tennessee,Cumberland County,0,59673,29067,30606
Tennessee,Cumberland County,1,2703,1362,1341
Tennessee,Cumberland County,2,3024,1507,1517
Tennessee,Cumberland County,3,2954,1544,1410
Tennessee,Cumberland County,4,2746,1420,1326
Tennessee,Cumberland County,5,2580,1374,1206
Tennessee,Cumberland County,6,3148,1589,1559
Tennessee,Cumberland County,7,2753,1317,1436
Tennessee,Cumberland County,8,2667,1287,1380
Tennessee,Cumberland County,9,2687,1295,1392
Tennessee,Cumberland County,10,3325,1693,1632
Tennessee,Cumberland County,11,3603,1759,1844
Tennessee,Cumberland County,12,4318,1996,2322
Tennessee,Cumberland County,13,4858,2198,2660
Tennessee,Cumberland County,14,5312,2490,2822
Tennessee,Cumberland County,15,5117,2469,2648
Tennessee,Cumberland County,16,3901,1924,1977
Tennessee,Cumberland County,17,2265,1110,1155
Tennessee,Cumberland County,18,1712,733,979
Tennessee,Davidson County,0,692587,334279,358308
Tennessee,Davidson County,1,45764,23302,22462
Tennessee,Davidson County,2,39954,20149,19805
Tennessee,Davidson County,3,37521,18993,18528
Tennessee,Davidson County,4,38792,19628,19164
Tennessee,Davidson County,5,49657,23557,26100
Tennessee,Davidson County,6,74523,35374,39149
Tennessee,Davidson County,7,66108,32769,33339
Tennessee,Davidson County,8,52816,26428,26388
Tennessee,Davidson County,9,42545,21328,21217
Tennessee,Davidson County,10,41292,20438,20854
Tennessee,Davidson County,11,39395,19571,19824
Tennessee,Davidson County,12,41449,19451,21998
Tennessee,Davidson County,13,37976,17547,20429
Tennessee,Davidson County,14,30137,13691,16446
Tennessee,Davidson County,15,21454,9560,11894
Tennessee,Davidson County,16,13826,5811,8015
Tennessee,Davidson County,17,9326,3509,5817
Tennessee,Davidson County,18,10052,3173,6879
Tennessee,Decatur County,0,11706,5748,5958
Tennessee,Decatur County,1,637,337,300
Tennessee,Decatur County,2,614,335,279
Tennessee,Decatur County,3,730,366,364
Tennessee,Decatur County,4,709,379,330
Tennessee,Decatur County,5,549,266,283
Tennessee,Decatur County,6,594,316,278
Tennessee,Decatur County,7,549,256,293
Tennessee,Decatur County,8,644,314,330
Tennessee,Decatur County,9,676,348,328
Tennessee,Decatur County,10,698,353,345
Tennessee,Decatur County,11,772,382,390
Tennessee,Decatur County,12,889,472,417
Tennessee,Decatur County,13,903,426,477
Tennessee,Decatur County,14,810,380,430
Tennessee,Decatur County,15,702,330,372
Tennessee,Decatur County,16,536,233,303
Tennessee,Decatur County,17,349,144,205
Tennessee,Decatur County,18,345,111,234
Tennessee,DeKalb County,0,20138,10061,10077
Tennessee,DeKalb County,1,1137,614,523
Tennessee,DeKalb County,2,1166,610,556
Tennessee,DeKalb County,3,1288,671,617
Tennessee,DeKalb County,4,1150,613,537
Tennessee,DeKalb County,5,1090,561,529
Tennessee,DeKalb County,6,1240,651,589
Tennessee,DeKalb County,7,1195,613,582
Tennessee,DeKalb County,8,1204,635,569
Tennessee,DeKalb County,9,1223,559,664
Tennessee,DeKalb County,10,1384,724,660
Tennessee,DeKalb County,11,1438,716,722
Tennessee,DeKalb County,12,1522,733,789
Tennessee,DeKalb County,13,1402,699,703
Tennessee,DeKalb County,14,1224,590,634
Tennessee,DeKalb County,15,1047,498,549
Tennessee,DeKalb County,16,660,283,377
Tennessee,DeKalb County,17,423,175,248
Tennessee,DeKalb County,18,345,116,229
Tennessee,Dickson County,0,53446,26248,27198
Tennessee,Dickson County,1,3210,1632,1578
Tennessee,Dickson County,2,3391,1729,1662
Tennessee,Dickson County,3,3542,1822,1720
Tennessee,Dickson County,4,3321,1794,1527
Tennessee,Dickson County,5,2953,1554,1399
Tennessee,Dickson County,6,3543,1767,1776
Tennessee,Dickson County,7,3361,1659,1702
Tennessee,Dickson County,8,3365,1622,1743
Tennessee,Dickson County,9,3322,1631,1691
Tennessee,Dickson County,10,3654,1794,1860
Tennessee,Dickson County,11,3754,1876,1878
Tennessee,Dickson County,12,3809,1823,1986
Tennessee,Dickson County,13,3566,1681,1885
Tennessee,Dickson County,14,2901,1354,1547
Tennessee,Dickson County,15,2310,1087,1223
Tennessee,Dickson County,16,1563,711,852
Tennessee,Dickson County,17,1018,421,597
Tennessee,Dickson County,18,863,291,572
Tennessee,Dyer County,0,37320,17994,19326
Tennessee,Dyer County,1,2328,1215,1113
Tennessee,Dyer County,2,2403,1204,1199
Tennessee,Dyer County,3,2607,1367,1240
Tennessee,Dyer County,4,2436,1231,1205
Tennessee,Dyer County,5,2209,1097,1112
Tennessee,Dyer County,6,2398,1178,1220
Tennessee,Dyer County,7,2188,1016,1172
Tennessee,Dyer County,8,2132,960,1172
Tennessee,Dyer County,9,2241,1065,1176
Tennessee,Dyer County,10,2433,1169,1264
Tennessee,Dyer County,11,2534,1255,1279
Tennessee,Dyer County,12,2514,1251,1263
Tennessee,Dyer County,13,2331,1143,1188
Tennessee,Dyer County,14,2054,939,1115
Tennessee,Dyer County,15,1850,844,1006
Tennessee,Dyer County,16,1175,513,662
Tennessee,Dyer County,17,793,327,466
Tennessee,Dyer County,18,694,220,474
Tennessee,Fayette County,0,40507,19937,20570
Tennessee,Fayette County,1,2027,1049,978
Tennessee,Fayette County,2,2055,1012,1043
Tennessee,Fayette County,3,2155,1124,1031
Tennessee,Fayette County,4,2224,1202,1022
Tennessee,Fayette County,5,2000,1007,993
Tennessee,Fayette County,6,2307,1157,1150
Tennessee,Fayette County,7,2209,1097,1112
Tennessee,Fayette County,8,2193,1057,1136
Tennessee,Fayette County,9,2248,1121,1127
Tennessee,Fayette County,10,2675,1297,1378
Tennessee,Fayette County,11,2940,1415,1525
Tennessee,Fayette County,12,3481,1704,1777
Tennessee,Fayette County,13,3338,1619,1719
Tennessee,Fayette County,14,2901,1389,1512
Tennessee,Fayette County,15,2348,1175,1173
Tennessee,Fayette County,16,1627,774,853
Tennessee,Fayette County,17,1006,438,568
Tennessee,Fayette County,18,773,300,473
Tennessee,Fentress County,0,18217,8890,9327
Tennessee,Fentress County,1,965,482,483
Tennessee,Fentress County,2,1040,533,507
Tennessee,Fentress County,3,1088,543,545
Tennessee,Fentress County,4,1121,588,533
Tennessee,Fentress County,5,929,484,445
Tennessee,Fentress County,6,969,501,468
Tennessee,Fentress County,7,872,428,444
Tennessee,Fentress County,8,967,480,487
Tennessee,Fentress County,9,989,485,504
Tennessee,Fentress County,10,1220,589,631
Tennessee,Fentress County,11,1314,630,684
Tennessee,Fentress County,12,1345,631,714
Tennessee,Fentress County,13,1398,686,712
Tennessee,Fentress County,14,1310,629,681
Tennessee,Fentress County,15,1197,550,647
Tennessee,Fentress County,16,773,375,398
Tennessee,Fentress County,17,414,175,239
Tennessee,Fentress County,18,306,101,205
Tennessee,Franklin County,0,41890,20459,21431
Tennessee,Franklin County,1,2105,1091,1014
Tennessee,Franklin County,2,2213,1082,1131
Tennessee,Franklin County,3,2430,1225,1205
Tennessee,Franklin County,4,3129,1590,1539
Tennessee,Franklin County,5,3344,1658,1686
Tennessee,Franklin County,6,2394,1205,1189
Tennessee,Franklin County,7,2039,1028,1011
Tennessee,Franklin County,8,2324,1166,1158
Tennessee,Franklin County,9,2304,1152,1152
Tennessee,Franklin County,10,2576,1270,1306
Tennessee,Franklin County,11,2577,1255,1322
Tennessee,Franklin County,12,3034,1473,1561
Tennessee,Franklin County,13,3033,1437,1596
Tennessee,Franklin County,14,2653,1249,1404
Tennessee,Franklin County,15,2248,1093,1155
Tennessee,Franklin County,16,1596,733,863
Tennessee,Franklin County,17,996,429,567
Tennessee,Franklin County,18,895,323,572
Tennessee,Gibson County,0,49045,23517,25528
Tennessee,Gibson County,1,3116,1636,1480
Tennessee,Gibson County,2,3267,1657,1610
Tennessee,Gibson County,3,3457,1787,1670
Tennessee,Gibson County,4,3130,1574,1556
Tennessee,Gibson County,5,2670,1331,1339
Tennessee,Gibson County,6,2909,1392,1517
Tennessee,Gibson County,7,2881,1329,1552
Tennessee,Gibson County,8,3148,1541,1607
Tennessee,Gibson County,9,2929,1410,1519
Tennessee,Gibson County,10,3105,1510,1595
Tennessee,Gibson County,11,3055,1463,1592
Tennessee,Gibson County,12,3400,1625,1775
Tennessee,Gibson County,13,3115,1491,1624
Tennessee,Gibson County,14,2615,1205,1410
Tennessee,Gibson County,15,2307,1040,1267
Tennessee,Gibson County,16,1626,700,926
Tennessee,Gibson County,17,1107,433,674
Tennessee,Gibson County,18,1208,393,815
Tennessee,Giles County,0,29503,14321,15182
Tennessee,Giles County,1,1664,842,822
Tennessee,Giles County,2,1669,833,836
Tennessee,Giles County,3,1814,886,928
Tennessee,Giles County,4,1824,920,904
Tennessee,Giles County,5,1689,837,852
Tennessee,Giles County,6,1870,929,941
Tennessee,Giles County,7,1567,752,815
Tennessee,Giles County,8,1600,792,808
Tennessee,Giles County,9,1557,787,770
Tennessee,Giles County,10,1867,899,968
Tennessee,Giles County,11,2043,1010,1033
Tennessee,Giles County,12,2361,1176,1185
Tennessee,Giles County,13,2075,1027,1048
Tennessee,Giles County,14,1833,849,984
Tennessee,Giles County,15,1616,786,830
Tennessee,Giles County,16,1103,479,624
Tennessee,Giles County,17,713,317,396
Tennessee,Giles County,18,638,200,438
Tennessee,Grainger County,0,23145,11660,11485
Tennessee,Grainger County,1,1153,580,573
Tennessee,Grainger County,2,1222,647,575
Tennessee,Grainger County,3,1418,762,656
Tennessee,Grainger County,4,1359,732,627
Tennessee,Grainger County,5,1194,624,570
Tennessee,Grainger County,6,1316,718,598
Tennessee,Grainger County,7,1180,595,585
Tennessee,Grainger County,8,1259,624,635
Tennessee,Grainger County,9,1377,706,671
Tennessee,Grainger County,10,1647,845,802
Tennessee,Grainger County,11,1813,871,942
Tennessee,Grainger County,12,1729,854,875
Tennessee,Grainger County,13,1737,846,891
Tennessee,Grainger County,14,1576,778,798
Tennessee,Grainger County,15,1371,671,700
Tennessee,Grainger County,16,929,454,475
Tennessee,Grainger County,17,524,233,291
Tennessee,Grainger County,18,341,120,221
Tennessee,Greene County,0,69087,33987,35100
Tennessee,Greene County,1,3353,1774,1579
Tennessee,Greene County,2,3410,1793,1617
Tennessee,Greene County,3,4080,2136,1944
Tennessee,Greene County,4,4140,2150,1990
Tennessee,Greene County,5,3924,2059,1865
Tennessee,Greene County,6,4089,2104,1985
Tennessee,Greene County,7,3482,1693,1789
Tennessee,Greene County,8,3810,1925,1885
Tennessee,Greene County,9,4096,1985,2111
Tennessee,Greene County,10,4690,2366,2324
Tennessee,Greene County,11,4903,2354,2549
Tennessee,Greene County,12,5171,2497,2674
Tennessee,Greene County,13,5021,2429,2592
Tennessee,Greene County,14,4622,2121,2501
Tennessee,Greene County,15,4086,1952,2134
Tennessee,Greene County,16,2945,1352,1593
Tennessee,Greene County,17,1842,816,1026
Tennessee,Greene County,18,1423,481,942
Tennessee,Grundy County,0,13346,6602,6744
Tennessee,Grundy County,1,753,404,349
Tennessee,Grundy County,2,741,396,345
Tennessee,Grundy County,3,845,451,394
Tennessee,Grundy County,4,804,424,380
Tennessee,Grundy County,5,731,381,350
Tennessee,Grundy County,6,807,401,406
Tennessee,Grundy County,7,671,315,356
Tennessee,Grundy County,8,799,401,398
Tennessee,Grundy County,9,785,388,397
Tennessee,Grundy County,10,879,467,412
Tennessee,Grundy County,11,886,431,455
Tennessee,Grundy County,12,932,484,448
Tennessee,Grundy County,13,917,437,480
Tennessee,Grundy County,14,817,362,455
Tennessee,Grundy County,15,837,390,447
Tennessee,Grundy County,16,537,255,282
Tennessee,Grundy County,17,355,137,218
Tennessee,Grundy County,18,250,78,172
Tennessee,Hamblen County,0,64569,31520,33049
Tennessee,Hamblen County,1,3798,1991,1807
Tennessee,Hamblen County,2,4137,2104,2033
Tennessee,Hamblen County,3,4308,2153,2155
Tennessee,Hamblen County,4,4046,2017,2029
Tennessee,Hamblen County,5,3642,1926,1716
Tennessee,Hamblen County,6,4178,2127,2051
Tennessee,Hamblen County,7,3659,1814,1845
Tennessee,Hamblen County,8,3806,1906,1900
Tennessee,Hamblen County,9,3878,1934,1944
Tennessee,Hamblen County,10,4495,2214,2281
Tennessee,Hamblen County,11,4317,2184,2133
Tennessee,Hamblen County,12,4501,2137,2364
Tennessee,Hamblen County,13,3881,1875,2006
Tennessee,Hamblen County,14,3552,1623,1929
Tennessee,Hamblen County,15,3250,1453,1797
Tennessee,Hamblen County,16,2324,1039,1285
Tennessee,Hamblen County,17,1478,614,864
Tennessee,Hamblen County,18,1319,409,910
Tennessee,Hamilton County,0,364286,175888,188398
Tennessee,Hamilton County,1,21007,10720,10287
Tennessee,Hamilton County,2,20983,10806,10177
Tennessee,Hamilton County,3,21336,10874,10462
Tennessee,Hamilton County,4,21310,10476,10834
Tennessee,Hamilton County,5,22598,11229,11369
Tennessee,Hamilton County,6,27937,13698,14239
Tennessee,Hamilton County,7,25135,12595,12540
Tennessee,Hamilton County,8,23541,11681,11860
Tennessee,Hamilton County,9,21305,10451,10854
Tennessee,Hamilton County,10,23266,11386,11880
Tennessee,Hamilton County,11,23093,11192,11901
Tennessee,Hamilton County,12,24654,11713,12941
Tennessee,Hamilton County,13,24091,11290,12801
Tennessee,Hamilton County,14,20799,9644,11155
Tennessee,Hamilton County,15,16350,7603,8747
Tennessee,Hamilton County,16,11108,4852,6256
Tennessee,Hamilton County,17,7383,2962,4421
Tennessee,Hamilton County,18,8390,2716,5674
Tennessee,Hancock County,0,6549,3231,3318
Tennessee,Hancock County,1,352,154,198
Tennessee,Hancock County,2,363,190,173
Tennessee,Hancock County,3,401,219,182
Tennessee,Hancock County,4,360,201,159
Tennessee,Hancock County,5,326,163,163
Tennessee,Hancock County,6,395,201,194
Tennessee,Hancock County,7,338,156,182
Tennessee,Hancock County,8,370,198,172
Tennessee,Hancock County,9,383,183,200
Tennessee,Hancock County,10,392,210,182
Tennessee,Hancock County,11,444,211,233
Tennessee,Hancock County,12,505,234,271
Tennessee,Hancock County,13,524,266,258
Tennessee,Hancock County,14,516,254,262
Tennessee,Hancock County,15,361,190,171
Tennessee,Hancock County,16,223,100,123
Tennessee,Hancock County,17,170,62,108
Tennessee,Hancock County,18,126,39,87
Tennessee,Hardeman County,0,25220,13778,11442
Tennessee,Hardeman County,1,1317,653,664
Tennessee,Hardeman County,2,1321,645,676
Tennessee,Hardeman County,3,1418,693,725
Tennessee,Hardeman County,4,1407,732,675
Tennessee,Hardeman County,5,1671,1040,631
Tennessee,Hardeman County,6,1899,1272,627
Tennessee,Hardeman County,7,1820,1192,628
Tennessee,Hardeman County,8,1637,1009,628
Tennessee,Hardeman County,9,1576,927,649
Tennessee,Hardeman County,10,1558,956,602
Tennessee,Hardeman County,11,1693,908,785
Tennessee,Hardeman County,12,1720,880,840
Tennessee,Hardeman County,13,1621,779,842
Tennessee,Hardeman County,14,1465,738,727
Tennessee,Hardeman County,15,1278,591,687
Tennessee,Hardeman County,16,789,361,428
Tennessee,Hardeman County,17,561,241,320
Tennessee,Hardeman County,18,469,161,308
Tennessee,Hardin County,0,25776,12572,13204
Tennessee,Hardin County,1,1371,725,646
Tennessee,Hardin County,2,1437,699,738
Tennessee,Hardin County,3,1537,777,760
Tennessee,Hardin County,4,1459,760,699
Tennessee,Hardin County,5,1299,684,615
Tennessee,Hardin County,6,1511,747,764
Tennessee,Hardin County,7,1239,610,629
Tennessee,Hardin County,8,1362,656,706
Tennessee,Hardin County,9,1434,691,743
Tennessee,Hardin County,10,1631,801,830
Tennessee,Hardin County,11,1754,881,873
Tennessee,Hardin County,12,1889,902,987
Tennessee,Hardin County,13,1898,903,995
Tennessee,Hardin County,14,1816,882,934
Tennessee,Hardin County,15,1598,804,794
Tennessee,Hardin County,16,1158,556,602
Tennessee,Hardin County,17,728,326,402
Tennessee,Hardin County,18,655,168,487
Tennessee,Hawkins County,0,56530,27743,28787
Tennessee,Hawkins County,1,2709,1386,1323
Tennessee,Hawkins County,2,2915,1474,1441
Tennessee,Hawkins County,3,3477,1805,1672
Tennessee,Hawkins County,4,3302,1658,1644
Tennessee,Hawkins County,5,2905,1470,1435
Tennessee,Hawkins County,6,3414,1771,1643
Tennessee,Hawkins County,7,2948,1458,1490
Tennessee,Hawkins County,8,3013,1504,1509
Tennessee,Hawkins County,9,3210,1561,1649
Tennessee,Hawkins County,10,4088,1997,2091
Tennessee,Hawkins County,11,4242,2101,2141
Tennessee,Hawkins County,12,4273,2100,2173
Tennessee,Hawkins County,13,4090,1988,2102
Tennessee,Hawkins County,14,3847,1804,2043
Tennessee,Hawkins County,15,3265,1548,1717
Tennessee,Hawkins County,16,2296,1109,1187
Tennessee,Hawkins County,17,1350,569,781
Tennessee,Hawkins County,18,1186,440,746
Tennessee,Haywood County,0,17335,8085,9250
Tennessee,Haywood County,1,961,478,483
Tennessee,Haywood County,2,1035,526,509
Tennessee,Haywood County,3,1153,573,580
Tennessee,Haywood County,4,1090,545,545
Tennessee,Haywood County,5,980,496,484
Tennessee,Haywood County,6,1029,494,535
Tennessee,Haywood County,7,957,444,513
Tennessee,Haywood County,8,1031,483,548
Tennessee,Haywood County,9,1003,427,576
Tennessee,Haywood County,10,987,443,544
Tennessee,Haywood County,11,1201,556,645
Tennessee,Haywood County,12,1281,611,670
Tennessee,Haywood County,13,1328,614,714
Tennessee,Haywood County,14,1178,530,648
Tennessee,Haywood County,15,791,347,444
Tennessee,Haywood County,16,549,233,316
Tennessee,Haywood County,17,368,138,230
Tennessee,Haywood County,18,413,147,266
Tennessee,Henderson County,0,27847,13519,14328
Tennessee,Henderson County,1,1609,857,752
Tennessee,Henderson County,2,1693,876,817
Tennessee,Henderson County,3,1934,966,968
Tennessee,Henderson County,4,1703,876,827
Tennessee,Henderson County,5,1488,767,721
Tennessee,Henderson County,6,1705,850,855
Tennessee,Henderson County,7,1571,738,833
Tennessee,Henderson County,8,1785,885,900
Tennessee,Henderson County,9,1672,803,869
Tennessee,Henderson County,10,1795,863,932
Tennessee,Henderson County,11,1914,925,989
Tennessee,Henderson County,12,2018,987,1031
Tennessee,Henderson County,13,1830,868,962
Tennessee,Henderson County,14,1649,791,858
Tennessee,Henderson County,15,1354,608,746
Tennessee,Henderson County,16,968,417,551
Tennessee,Henderson County,17,592,239,353
Tennessee,Henderson County,18,567,203,364
Tennessee,Henry County,0,32358,15686,16672
Tennessee,Henry County,1,1683,841,842
Tennessee,Henry County,2,1744,889,855
Tennessee,Henry County,3,2030,1000,1030
Tennessee,Henry County,4,1822,959,863
Tennessee,Henry County,5,1600,870,730
Tennessee,Henry County,6,1785,888,897
Tennessee,Henry County,7,1619,788,831
Tennessee,Henry County,8,1759,860,899
Tennessee,Henry County,9,1737,886,851
Tennessee,Henry County,10,1975,956,1019
Tennessee,Henry County,11,2203,1041,1162
Tennessee,Henry County,12,2483,1197,1286
Tennessee,Henry County,13,2392,1144,1248
Tennessee,Henry County,14,2319,1045,1274
Tennessee,Henry County,15,2070,989,1081
Tennessee,Henry County,16,1449,668,781
Tennessee,Henry County,17,925,398,527
Tennessee,Henry County,18,763,267,496
Tennessee,Hickman County,0,25063,13172,11891
Tennessee,Hickman County,1,1389,725,664
Tennessee,Hickman County,2,1375,739,636
Tennessee,Hickman County,3,1509,772,737
Tennessee,Hickman County,4,1481,788,693
Tennessee,Hickman County,5,1456,862,594
Tennessee,Hickman County,6,1699,947,752
Tennessee,Hickman County,7,1589,922,667
Tennessee,Hickman County,8,1593,893,700
Tennessee,Hickman County,9,1541,839,702
Tennessee,Hickman County,10,1712,899,813
Tennessee,Hickman County,11,1825,973,852
Tennessee,Hickman County,12,1880,1002,878
Tennessee,Hickman County,13,1613,814,799
Tennessee,Hickman County,14,1473,676,797
Tennessee,Hickman County,15,1170,566,604
Tennessee,Hickman County,16,831,384,447
Tennessee,Hickman County,17,517,239,278
Tennessee,Hickman County,18,410,132,278
Tennessee,Houston County,0,8263,4058,4205
Tennessee,Houston County,1,430,219,211
Tennessee,Houston County,2,492,249,243
Tennessee,Houston County,3,533,263,270
Tennessee,Houston County,4,516,271,245
Tennessee,Houston County,5,437,221,216
Tennessee,Houston County,6,501,265,236
Tennessee,Houston County,7,446,202,244
Tennessee,Houston County,8,466,227,239
Tennessee,Houston County,9,491,258,233
Tennessee,Houston County,10,540,268,272
Tennessee,Houston County,11,544,264,280
Tennessee,Houston County,12,598,312,286
Tennessee,Houston County,13,573,266,307
Tennessee,Houston County,14,535,244,291
Tennessee,Houston County,15,450,230,220
Tennessee,Houston County,16,338,157,181
Tennessee,Houston County,17,189,67,122
Tennessee,Houston County,18,184,75,109
Tennessee,Humphreys County,0,18486,9196,9290
Tennessee,Humphreys County,1,1011,528,483
Tennessee,Humphreys County,2,1079,588,491
Tennessee,Humphreys County,3,1146,572,574
Tennessee,Humphreys County,4,1119,612,507
Tennessee,Humphreys County,5,954,478,476
Tennessee,Humphreys County,6,1157,592,565
Tennessee,Humphreys County,7,985,501,484
Tennessee,Humphreys County,8,1060,508,552
Tennessee,Humphreys County,9,1032,514,518
Tennessee,Humphreys County,10,1228,617,611
Tennessee,Humphreys County,11,1295,642,653
Tennessee,Humphreys County,12,1359,666,693
Tennessee,Humphreys County,13,1361,663,698
Tennessee,Humphreys County,14,1154,570,584
Tennessee,Humphreys County,15,990,454,536
Tennessee,Humphreys County,16,747,359,388
Tennessee,Humphreys County,17,445,187,258
Tennessee,Humphreys County,18,364,145,219
Tennessee,Jackson County,0,11758,5848,5910
Tennessee,Jackson County,1,558,287,271
Tennessee,Jackson County,2,578,267,311
Tennessee,Jackson County,3,626,345,281
Tennessee,Jackson County,4,554,288,266
Tennessee,Jackson County,5,606,305,301
Tennessee,Jackson County,6,709,382,327
Tennessee,Jackson County,7,569,286,283
Tennessee,Jackson County,8,589,299,290
Tennessee,Jackson County,9,687,329,358
Tennessee,Jackson County,10,777,376,401
Tennessee,Jackson County,11,863,433,430
Tennessee,Jackson County,12,952,474,478
Tennessee,Jackson County,13,1049,513,536
Tennessee,Jackson County,14,857,426,431
Tennessee,Jackson County,15,743,377,366
Tennessee,Jackson County,16,475,232,243
Tennessee,Jackson County,17,327,141,186
Tennessee,Jackson County,18,239,88,151
Tennessee,Jefferson County,0,54012,26586,27426
Tennessee,Jefferson County,1,2598,1342,1256
Tennessee,Jefferson County,2,2831,1388,1443
Tennessee,Jefferson County,3,3175,1644,1531
Tennessee,Jefferson County,4,3447,1791,1656
Tennessee,Jefferson County,5,3284,1656,1628
Tennessee,Jefferson County,6,3269,1672,1597
Tennessee,Jefferson County,7,2703,1377,1326
Tennessee,Jefferson County,8,2985,1451,1534
Tennessee,Jefferson County,9,3100,1550,1550
Tennessee,Jefferson County,10,3759,1847,1912
Tennessee,Jefferson County,11,4016,2002,2014
Tennessee,Jefferson County,12,4113,2007,2106
Tennessee,Jefferson County,13,3914,1921,1993
Tennessee,Jefferson County,14,3395,1557,1838
Tennessee,Jefferson County,15,2997,1420,1577
Tennessee,Jefferson County,16,2145,1018,1127
Tennessee,Jefferson County,17,1296,602,694
Tennessee,Jefferson County,18,985,341,644
Tennessee,Johnson County,0,17778,9573,8205
Tennessee,Johnson County,1,747,422,325
Tennessee,Johnson County,2,789,383,406
Tennessee,Johnson County,3,914,477,437
Tennessee,Johnson County,4,853,457,396
Tennessee,Johnson County,5,931,582,349
Tennessee,Johnson County,6,1015,607,408
Tennessee,Johnson County,7,1135,732,403
Tennessee,Johnson County,8,944,516,428
Tennessee,Johnson County,9,1217,748,469
Tennessee,Johnson County,10,1352,827,525
Tennessee,Johnson County,11,1262,697,565
Tennessee,Johnson County,12,1209,588,621
Tennessee,Johnson County,13,1354,653,701
Tennessee,Johnson County,14,1249,574,675
Tennessee,Johnson County,15,1141,569,572
Tennessee,Johnson County,16,789,370,419
Tennessee,Johnson County,17,467,224,243
Tennessee,Johnson County,18,410,147,263
Tennessee,Knox County,0,465289,226006,239283
Tennessee,Knox County,1,26506,13527,12979
Tennessee,Knox County,2,26776,13673,13103
Tennessee,Knox County,3,27631,14116,13515
Tennessee,Knox County,4,30841,15779,15062
Tennessee,Knox County,5,41280,20807,20473
Tennessee,Knox County,6,33348,16495,16853
Tennessee,Knox County,7,30278,14722,15556
Tennessee,Knox County,8,30459,14992,15467
Tennessee,Knox County,9,27530,13586,13944
Tennessee,Knox County,10,29588,14505,15083
Tennessee,Knox County,11,29128,14058,15070
Tennessee,Knox County,12,30187,14578,15609
Tennessee,Knox County,13,28076,13271,14805
Tennessee,Knox County,14,24280,11085,13195
Tennessee,Knox County,15,19200,8750,10450
Tennessee,Knox County,16,13195,5778,7417
Tennessee,Knox County,17,8451,3474,4977
Tennessee,Knox County,18,8535,2810,5725
Tennessee,Lake County,0,7411,4764,2647
Tennessee,Lake County,1,289,143,146
Tennessee,Lake County,2,291,150,141
Tennessee,Lake County,3,261,132,129
Tennessee,Lake County,4,353,243,110
Tennessee,Lake County,5,628,521,107
Tennessee,Lake County,6,763,589,174
Tennessee,Lake County,7,617,472,145
Tennessee,Lake County,8,532,388,144
Tennessee,Lake County,9,547,409,138
Tennessee,Lake County,10,522,336,186
Tennessee,Lake County,11,516,322,194
Tennessee,Lake County,12,466,277,189
Tennessee,Lake County,13,460,253,207
Tennessee,Lake County,14,374,202,172
Tennessee,Lake County,15,286,129,157
Tennessee,Lake County,16,208,100,108
Tennessee,Lake County,17,159,61,98
Tennessee,Lake County,18,139,37,102
Tennessee,Lauderdale County,0,25825,13304,12521
Tennessee,Lauderdale County,1,1494,751,743
Tennessee,Lauderdale County,2,1531,800,731
Tennessee,Lauderdale County,3,1724,859,865
Tennessee,Lauderdale County,4,1679,904,775
Tennessee,Lauderdale County,5,1713,1006,707
Tennessee,Lauderdale County,6,1859,1091,768
Tennessee,Lauderdale County,7,1614,948,666
Tennessee,Lauderdale County,8,1781,972,809
Tennessee,Lauderdale County,9,1562,816,746
Tennessee,Lauderdale County,10,1646,845,801
Tennessee,Lauderdale County,11,1772,929,843
Tennessee,Lauderdale County,12,1761,837,924
Tennessee,Lauderdale County,13,1612,765,847
Tennessee,Lauderdale County,14,1348,594,754
Tennessee,Lauderdale County,15,1119,529,590
Tennessee,Lauderdale County,16,774,362,412
Tennessee,Lauderdale County,17,463,176,287
Tennessee,Lauderdale County,18,373,120,253
Tennessee,Lawrence County,0,43734,21488,22246
Tennessee,Lawrence County,1,2889,1460,1429
Tennessee,Lawrence County,2,2992,1559,1433
Tennessee,Lawrence County,3,3084,1605,1479
Tennessee,Lawrence County,4,2883,1490,1393
Tennessee,Lawrence County,5,2324,1202,1122
Tennessee,Lawrence County,6,2928,1428,1500
Tennessee,Lawrence County,7,2467,1248,1219
Tennessee,Lawrence County,8,2480,1224,1256
Tennessee,Lawrence County,9,2442,1168,1274
Tennessee,Lawrence County,10,2844,1402,1442
Tennessee,Lawrence County,11,2929,1479,1450
Tennessee,Lawrence County,12,2971,1466,1505
Tennessee,Lawrence County,13,2707,1266,1441
Tennessee,Lawrence County,14,2386,1172,1214
Tennessee,Lawrence County,15,2072,986,1086
Tennessee,Lawrence County,16,1538,689,849
Tennessee,Lawrence County,17,932,380,552
Tennessee,Lawrence County,18,866,264,602
Tennessee,Lewis County,0,12086,5893,6193
Tennessee,Lewis County,1,676,341,335
Tennessee,Lewis County,2,670,327,343
Tennessee,Lewis County,3,786,409,377
Tennessee,Lewis County,4,722,385,337
Tennessee,Lewis County,5,649,352,297
Tennessee,Lewis County,6,702,356,346
Tennessee,Lewis County,7,648,304,344
Tennessee,Lewis County,8,667,312,355
Tennessee,Lewis County,9,716,375,341
Tennessee,Lewis County,10,791,376,415
Tennessee,Lewis County,11,725,358,367
Tennessee,Lewis County,12,869,424,445
Tennessee,Lewis County,13,936,444,492
Tennessee,Lewis County,14,830,398,432
Tennessee,Lewis County,15,653,319,334
Tennessee,Lewis County,16,458,205,253
Tennessee,Lewis County,17,280,105,175
Tennessee,Lewis County,18,308,103,205
Tennessee,Lincoln County,0,34117,16753,17364
Tennessee,Lincoln County,1,1875,925,950
Tennessee,Lincoln County,2,1989,1004,985
Tennessee,Lincoln County,3,2350,1181,1169
Tennessee,Lincoln County,4,2058,1113,945
Tennessee,Lincoln County,5,1730,917,813
Tennessee,Lincoln County,6,2033,1050,983
Tennessee,Lincoln County,7,1871,922,949
Tennessee,Lincoln County,8,2020,1031,989
Tennessee,Lincoln County,9,1855,940,915
Tennessee,Lincoln County,10,2216,1077,1139
Tennessee,Lincoln County,11,2383,1184,1199
Tennessee,Lincoln County,12,2595,1295,1300
Tennessee,Lincoln County,13,2512,1213,1299
Tennessee,Lincoln County,14,2087,990,1097
Tennessee,Lincoln County,15,1663,725,938
Tennessee,Lincoln County,16,1299,568,731
Tennessee,Lincoln County,17,902,385,517
Tennessee,Lincoln County,18,679,233,446
Tennessee,Loudon County,0,53054,26085,26969
Tennessee,Loudon County,1,2771,1461,1310
Tennessee,Loudon County,2,2805,1456,1349
Tennessee,Loudon County,3,2963,1519,1444
Tennessee,Loudon County,4,2728,1436,1292
Tennessee,Loudon County,5,2568,1331,1237
Tennessee,Loudon County,6,2752,1408,1344
Tennessee,Loudon County,7,2573,1294,1279
Tennessee,Loudon County,8,2535,1242,1293
Tennessee,Loudon County,9,2681,1306,1375
Tennessee,Loudon County,10,3225,1560,1665
Tennessee,Loudon County,11,3373,1640,1733
Tennessee,Loudon County,12,3800,1864,1936
Tennessee,Loudon County,13,4254,1980,2274
Tennessee,Loudon County,14,4249,2026,2223
Tennessee,Loudon County,15,3978,1910,2068
Tennessee,Loudon County,16,2847,1375,1472
Tennessee,Loudon County,17,1577,762,815
Tennessee,Loudon County,18,1375,515,860
Tennessee,McMinn County,0,53285,25975,27310
Tennessee,McMinn County,1,2937,1493,1444
Tennessee,McMinn County,2,2970,1540,1430
Tennessee,McMinn County,3,3320,1690,1630
Tennessee,McMinn County,4,3363,1750,1613
Tennessee,McMinn County,5,3111,1557,1554
Tennessee,McMinn County,6,3320,1665,1655
Tennessee,McMinn County,7,2730,1344,1386
Tennessee,McMinn County,8,3033,1439,1594
Tennessee,McMinn County,9,3028,1443,1585
Tennessee,McMinn County,10,3635,1801,1834
Tennessee,McMinn County,11,3668,1776,1892
Tennessee,McMinn County,12,3827,1854,1973
Tennessee,McMinn County,13,3885,1904,1981
Tennessee,McMinn County,14,3200,1521,1679
Tennessee,McMinn County,15,2787,1342,1445
Tennessee,McMinn County,16,2038,881,1157
Tennessee,McMinn County,17,1269,541,728
Tennessee,McMinn County,18,1164,434,730
Tennessee,McNairy County,0,25832,12692,13140
Tennessee,McNairy County,1,1347,672,675
Tennessee,McNairy County,2,1518,812,706
Tennessee,McNairy County,3,1685,856,829
Tennessee,McNairy County,4,1614,877,737
Tennessee,McNairy County,5,1371,708,663
Tennessee,McNairy County,6,1578,786,792
Tennessee,McNairy County,7,1263,648,615
Tennessee,McNairy County,8,1479,727,752
Tennessee,McNairy County,9,1539,775,764
Tennessee,McNairy County,10,1733,851,882
Tennessee,McNairy County,11,1753,852,901
Tennessee,McNairy County,12,1816,896,920
Tennessee,McNairy County,13,1766,812,954
Tennessee,McNairy County,14,1624,768,856
Tennessee,McNairy County,15,1517,718,799
Tennessee,McNairy County,16,1080,483,597
Tennessee,McNairy County,17,645,276,369
Tennessee,McNairy County,18,504,175,329
Tennessee,Macon County,0,24265,11862,12403
Tennessee,Macon County,1,1719,888,831
Tennessee,Macon County,2,1688,857,831
Tennessee,Macon County,3,1627,849,778
Tennessee,Macon County,4,1491,759,732
Tennessee,Macon County,5,1466,727,739
Tennessee,Macon County,6,1663,806,857
Tennessee,Macon County,7,1494,695,799
Tennessee,Macon County,8,1394,692,702
Tennessee,Macon County,9,1436,704,732
Tennessee,Macon County,10,1651,814,837
Tennessee,Macon County,11,1667,835,832
Tennessee,Macon County,12,1641,828,813
Tennessee,Macon County,13,1514,714,800
Tennessee,Macon County,14,1285,634,651
Tennessee,Macon County,15,1024,466,558
Tennessee,Macon County,16,700,297,403
Tennessee,Macon County,17,446,169,277
Tennessee,Macon County,18,359,128,231
Tennessee,Madison County,0,97605,46226,51379
Tennessee,Madison County,1,6040,3142,2898
Tennessee,Madison County,2,6043,3117,2926
Tennessee,Madison County,3,6069,3033,3036
Tennessee,Madison County,4,7203,3539,3664
Tennessee,Madison County,5,6729,3181,3548
Tennessee,Madison County,6,6764,3210,3554
Tennessee,Madison County,7,5613,2683,2930
Tennessee,Madison County,8,5703,2702,3001
Tennessee,Madison County,9,5382,2547,2835
Tennessee,Madison County,10,5915,2804,3111
Tennessee,Madison County,11,6276,2984,3292
Tennessee,Madison County,12,6802,3116,3686
Tennessee,Madison County,13,6451,2936,3515
Tennessee,Madison County,14,5610,2625,2985
Tennessee,Madison County,15,4216,1937,2279
Tennessee,Madison County,16,2934,1282,1652
Tennessee,Madison County,17,1889,727,1162
Tennessee,Madison County,18,1966,661,1305
Tennessee,Marion County,0,28575,13960,14615
Tennessee,Marion County,1,1618,811,807
Tennessee,Marion County,2,1571,810,761
Tennessee,Marion County,3,1745,897,848
Tennessee,Marion County,4,1679,860,819
Tennessee,Marion County,5,1522,790,732
Tennessee,Marion County,6,1761,882,879
Tennessee,Marion County,7,1545,759,786
Tennessee,Marion County,8,1592,803,789
Tennessee,Marion County,9,1682,823,859
Tennessee,Marion County,10,1915,944,971
Tennessee,Marion County,11,1964,972,992
Tennessee,Marion County,12,2123,989,1134
Tennessee,Marion County,13,2121,1030,1091
Tennessee,Marion County,14,1899,920,979
Tennessee,Marion County,15,1574,727,847
Tennessee,Marion County,16,1080,495,585
Tennessee,Marion County,17,633,250,383
Tennessee,Marion County,18,551,198,353
Tennessee,Marshall County,0,33683,16495,17188
Tennessee,Marshall County,1,2078,1060,1018
Tennessee,Marshall County,2,2117,1076,1041
Tennessee,Marshall County,3,2261,1166,1095
Tennessee,Marshall County,4,2203,1108,1095
Tennessee,Marshall County,5,1768,912,856
Tennessee,Marshall County,6,2282,1111,1171
Tennessee,Marshall County,7,2070,1033,1037
Tennessee,Marshall County,8,2139,1054,1085
Tennessee,Marshall County,9,2111,1034,1077
Tennessee,Marshall County,10,2337,1159,1178
Tennessee,Marshall County,11,2344,1169,1175
Tennessee,Marshall County,12,2357,1125,1232
Tennessee,Marshall County,13,2186,1040,1146
Tennessee,Marshall County,14,1873,896,977
Tennessee,Marshall County,15,1488,671,817
Tennessee,Marshall County,16,959,477,482
Tennessee,Marshall County,17,555,226,329
Tennessee,Marshall County,18,555,178,377
Tennessee,Maury County,0,94340,45506,48834
Tennessee,Maury County,1,6216,3103,3113
Tennessee,Maury County,2,6170,3039,3131
Tennessee,Maury County,3,6185,3162,3023
Tennessee,Maury County,4,5358,2750,2608
Tennessee,Maury County,5,5137,2568,2569
Tennessee,Maury County,6,6667,3241,3426
Tennessee,Maury County,7,6370,3117,3253
Tennessee,Maury County,8,6411,3141,3270
Tennessee,Maury County,9,5866,2758,3108
Tennessee,Maury County,10,5956,2987,2969
Tennessee,Maury County,11,5945,2860,3085
Tennessee,Maury County,12,6551,3020,3531
Tennessee,Maury County,13,6494,3063,3431
Tennessee,Maury County,14,5269,2520,2749
Tennessee,Maury County,15,3996,1842,2154
Tennessee,Maury County,16,2673,1201,1472
Tennessee,Maury County,17,1575,660,915
Tennessee,Maury County,18,1501,474,1027
Tennessee,Meigs County,0,12306,6109,6197
Tennessee,Meigs County,1,650,323,327
Tennessee,Meigs County,2,681,322,359
Tennessee,Meigs County,3,724,364,360
Tennessee,Meigs County,4,743,363,380
Tennessee,Meigs County,5,604,302,302
Tennessee,Meigs County,6,676,345,331
Tennessee,Meigs County,7,619,323,296
Tennessee,Meigs County,8,713,342,371
Tennessee,Meigs County,9,745,392,353
Tennessee,Meigs County,10,856,420,436
Tennessee,Meigs County,11,927,461,466
Tennessee,Meigs County,12,910,454,456
Tennessee,Meigs County,13,846,378,468
Tennessee,Meigs County,14,876,462,414
Tennessee,Meigs County,15,798,400,398
Tennessee,Meigs County,16,490,258,232
Tennessee,Meigs County,17,244,110,134
Tennessee,Meigs County,18,204,90,114
Tennessee,Monroe County,0,46357,23088,23269
Tennessee,Monroe County,1,2525,1339,1186
Tennessee,Monroe County,2,2537,1360,1177
Tennessee,Monroe County,3,2934,1485,1449
Tennessee,Monroe County,4,2764,1477,1287
Tennessee,Monroe County,5,2499,1294,1205
Tennessee,Monroe County,6,2827,1493,1334
Tennessee,Monroe County,7,2476,1247,1229
Tennessee,Monroe County,8,2490,1248,1242
Tennessee,Monroe County,9,2546,1265,1281
Tennessee,Monroe County,10,3028,1500,1528
Tennessee,Monroe County,11,3209,1578,1631
Tennessee,Monroe County,12,3353,1684,1669
Tennessee,Monroe County,13,3351,1618,1733
Tennessee,Monroe County,14,3248,1506,1742
Tennessee,Monroe County,15,2762,1338,1424
Tennessee,Monroe County,16,1915,922,993
Tennessee,Monroe County,17,1025,428,597
Tennessee,Monroe County,18,868,306,562
Tennessee,Montgomery County,0,205950,102544,103406
Tennessee,Montgomery County,1,16962,8710,8252
Tennessee,Montgomery County,2,15707,7984,7723
Tennessee,Montgomery County,3,14441,7331,7110
Tennessee,Montgomery County,4,13117,6552,6565
Tennessee,Montgomery County,5,17790,9340,8450
Tennessee,Montgomery County,6,21424,11215,10209
Tennessee,Montgomery County,7,17947,9162,8785
Tennessee,Montgomery County,8,15146,7699,7447
Tennessee,Montgomery County,9,12333,6059,6274
Tennessee,Montgomery County,10,11687,5641,6046
Tennessee,Montgomery County,11,10738,5198,5540
Tennessee,Montgomery County,12,10587,5000,5587
Tennessee,Montgomery County,13,9066,4248,4818
Tennessee,Montgomery County,14,6668,3130,3538
Tennessee,Montgomery County,15,5134,2342,2792
Tennessee,Montgomery County,16,3301,1413,1888
Tennessee,Montgomery County,17,2163,868,1295
Tennessee,Montgomery County,18,1739,652,1087
Tennessee,Moore County,0,6411,3203,3208
Tennessee,Moore County,1,269,156,113
Tennessee,Moore County,2,315,165,150
Tennessee,Moore County,3,390,189,201
Tennessee,Moore County,4,382,191,191
Tennessee,Moore County,5,342,178,164
Tennessee,Moore County,6,370,187,183
Tennessee,Moore County,7,319,169,150
Tennessee,Moore County,8,344,184,160
Tennessee,Moore County,9,413,206,207
Tennessee,Moore County,10,450,221,229
Tennessee,Moore County,11,426,231,195
Tennessee,Moore County,12,488,248,240
Tennessee,Moore County,13,524,228,296
Tennessee,Moore County,14,394,187,207
Tennessee,Moore County,15,385,189,196
Tennessee,Moore County,16,265,132,133
Tennessee,Moore County,17,170,79,91
Tennessee,Moore County,18,165,63,102
Tennessee,Morgan County,0,21579,11809,9770
Tennessee,Morgan County,1,1032,539,493
Tennessee,Morgan County,2,1054,548,506
Tennessee,Morgan County,3,1264,654,610
Tennessee,Morgan County,4,1224,642,582
Tennessee,Morgan County,5,1410,878,532
Tennessee,Morgan County,6,1499,946,553
Tennessee,Morgan County,7,1291,828,463
Tennessee,Morgan County,8,1371,822,549
Tennessee,Morgan County,9,1413,842,571
Tennessee,Morgan County,10,1588,887,701
Tennessee,Morgan County,11,1618,886,732
Tennessee,Morgan County,12,1478,799,679
Tennessee,Morgan County,13,1501,735,766
Tennessee,Morgan County,14,1302,641,661
Tennessee,Morgan County,15,1019,487,532
Tennessee,Morgan County,16,711,345,366
Tennessee,Morgan County,17,438,195,243
Tennessee,Morgan County,18,366,135,231
Tennessee,Obion County,0,30267,14647,15620
Tennessee,Obion County,1,1712,874,838
Tennessee,Obion County,2,1821,957,864
Tennessee,Obion County,3,1834,886,948
Tennessee,Obion County,4,1857,966,891
Tennessee,Obion County,5,1661,824,837
Tennessee,Obion County,6,1865,963,902
Tennessee,Obion County,7,1596,759,837
Tennessee,Obion County,8,1766,871,895
Tennessee,Obion County,9,1767,888,879
Tennessee,Obion County,10,2006,990,1016
Tennessee,Obion County,11,1918,919,999
Tennessee,Obion County,12,2113,1014,1099
Tennessee,Obion County,13,2172,1026,1146
Tennessee,Obion County,14,1889,880,1009
Tennessee,Obion County,15,1650,782,868
Tennessee,Obion County,16,1184,525,659
Tennessee,Obion County,17,766,323,443
Tennessee,Obion County,18,690,200,490
Tennessee,Overton County,0,22068,10939,11129
Tennessee,Overton County,1,1139,610,529
Tennessee,Overton County,2,1218,635,583
Tennessee,Overton County,3,1441,753,688
Tennessee,Overton County,4,1303,679,624
Tennessee,Overton County,5,1254,641,613
Tennessee,Overton County,6,1432,764,668
Tennessee,Overton County,7,1058,503,555
Tennessee,Overton County,8,1241,609,632
Tennessee,Overton County,9,1323,679,644
Tennessee,Overton County,10,1473,721,752
Tennessee,Overton County,11,1570,767,803
Tennessee,Overton County,12,1499,729,770
Tennessee,Overton County,13,1576,775,801
Tennessee,Overton County,14,1448,703,745
Tennessee,Overton County,15,1246,580,666
Tennessee,Overton County,16,872,384,488
Tennessee,Overton County,17,565,260,305
Tennessee,Overton County,18,410,147,263
Tennessee,Perry County,0,8064,4069,3995
Tennessee,Perry County,1,507,264,243
Tennessee,Perry County,2,497,248,249
Tennessee,Perry County,3,489,241,248
Tennessee,Perry County,4,454,254,200
Tennessee,Perry County,5,458,245,213
Tennessee,Perry County,6,487,242,245
Tennessee,Perry County,7,430,230,200
Tennessee,Perry County,8,428,225,203
Tennessee,Perry County,9,469,218,251
Tennessee,Perry County,10,490,257,233
Tennessee,Perry County,11,520,266,254
Tennessee,Perry County,12,532,270,262
Tennessee,Perry County,13,598,304,294
Tennessee,Perry County,14,516,256,260
Tennessee,Perry County,15,473,238,235
Tennessee,Perry County,16,327,151,176
Tennessee,Perry County,17,183,86,97
Tennessee,Perry County,18,206,74,132
Tennessee,Pickett County,0,5082,2542,2540
Tennessee,Pickett County,1,234,113,121
Tennessee,Pickett County,2,213,112,101
Tennessee,Pickett County,3,282,143,139
Tennessee,Pickett County,4,282,170,112
Tennessee,Pickett County,5,226,113,113
Tennessee,Pickett County,6,219,103,116
Tennessee,Pickett County,7,196,109,87
Tennessee,Pickett County,8,257,130,127
Tennessee,Pickett County,9,275,128,147
Tennessee,Pickett County,10,281,138,143
Tennessee,Pickett County,11,405,201,204
Tennessee,Pickett County,12,412,210,202
Tennessee,Pickett County,13,398,190,208
Tennessee,Pickett County,14,438,228,210
Tennessee,Pickett County,15,362,178,184
Tennessee,Pickett County,16,272,132,140
Tennessee,Pickett County,17,201,96,105
Tennessee,Pickett County,18,129,48,81
Tennessee,Polk County,0,16898,8325,8573
Tennessee,Polk County,1,852,409,443
Tennessee,Polk County,2,824,397,427
Tennessee,Polk County,3,988,514,474
Tennessee,Polk County,4,993,523,470
Tennessee,Polk County,5,897,466,431
Tennessee,Polk County,6,940,493,447
Tennessee,Polk County,7,859,421,438
Tennessee,Polk County,8,897,446,451
Tennessee,Polk County,9,1052,495,557
Tennessee,Polk County,10,1238,629,609
Tennessee,Polk County,11,1286,626,660
Tennessee,Polk County,12,1294,654,640
Tennessee,Polk County,13,1234,579,655
Tennessee,Polk County,14,1117,567,550
Tennessee,Polk County,15,944,447,497
Tennessee,Polk County,16,695,352,343
Tennessee,Polk County,17,446,195,251
Tennessee,Polk County,18,342,112,230
Tennessee,Putnam County,0,78843,39227,39616
Tennessee,Putnam County,1,4524,2324,2200
Tennessee,Putnam County,2,4434,2238,2196
Tennessee,Putnam County,3,4668,2379,2289
Tennessee,Putnam County,4,5872,3201,2671
Tennessee,Putnam County,5,8380,4636,3744
Tennessee,Putnam County,6,5701,2939,2762
Tennessee,Putnam County,7,4567,2293,2274
Tennessee,Putnam County,8,4653,2362,2291
Tennessee,Putnam County,9,4183,2055,2128
Tennessee,Putnam County,10,4689,2315,2374
Tennessee,Putnam County,11,4653,2263,2390
Tennessee,Putnam County,12,4820,2258,2562
Tennessee,Putnam County,13,4565,2170,2395
Tennessee,Putnam County,14,4089,1868,2221
Tennessee,Putnam County,15,3519,1623,1896
Tennessee,Putnam County,16,2479,1101,1378
Tennessee,Putnam County,17,1551,662,889
Tennessee,Putnam County,18,1496,540,956
Tennessee,Rhea County,0,33044,16401,16643
Tennessee,Rhea County,1,1954,1019,935
Tennessee,Rhea County,2,1944,983,961
Tennessee,Rhea County,3,2255,1122,1133
Tennessee,Rhea County,4,2219,1144,1075
Tennessee,Rhea County,5,2098,1137,961
Tennessee,Rhea County,6,2030,1056,974
Tennessee,Rhea County,7,1842,897,945
Tennessee,Rhea County,8,1885,981,904
Tennessee,Rhea County,9,1845,889,956
Tennessee,Rhea County,10,2175,1088,1087
Tennessee,Rhea County,11,2237,1097,1140
Tennessee,Rhea County,12,2215,1093,1122
Tennessee,Rhea County,13,2196,1054,1142
Tennessee,Rhea County,14,2003,951,1052
Tennessee,Rhea County,15,1662,826,836
Tennessee,Rhea County,16,1187,535,652
Tennessee,Rhea County,17,684,293,391
Tennessee,Rhea County,18,613,236,377
Tennessee,Roane County,0,53140,25926,27214
Tennessee,Roane County,1,2379,1225,1154
Tennessee,Roane County,2,2629,1305,1324
Tennessee,Roane County,3,2985,1569,1416
Tennessee,Roane County,4,3041,1580,1461
Tennessee,Roane County,5,2718,1410,1308
Tennessee,Roane County,6,2922,1437,1485
Tennessee,Roane County,7,2614,1299,1315
Tennessee,Roane County,8,2735,1294,1441
Tennessee,Roane County,9,2938,1416,1522
Tennessee,Roane County,10,3641,1825,1816
Tennessee,Roane County,11,3804,1853,1951
Tennessee,Roane County,12,4228,2009,2219
Tennessee,Roane County,13,4398,2139,2259
Tennessee,Roane County,14,3741,1815,1926
Tennessee,Roane County,15,3287,1606,1681
Tennessee,Roane County,16,2264,1054,1210
Tennessee,Roane County,17,1376,578,798
Tennessee,Roane County,18,1440,512,928
Tennessee,Robertson County,0,71012,35082,35930
Tennessee,Robertson County,1,4422,2274,2148
Tennessee,Robertson County,2,4593,2355,2238
Tennessee,Robertson County,3,4955,2511,2444
Tennessee,Robertson County,4,4551,2283,2268
Tennessee,Robertson County,5,3864,1918,1946
Tennessee,Robertson County,6,4613,2347,2266
Tennessee,Robertson County,7,4465,2226,2239
Tennessee,Robertson County,8,4846,2422,2424
Tennessee,Robertson County,9,4382,2184,2198
Tennessee,Robertson County,10,4901,2461,2440
Tennessee,Robertson County,11,4972,2439,2533
Tennessee,Robertson County,12,5363,2646,2717
Tennessee,Robertson County,13,4565,2189,2376
Tennessee,Robertson County,14,3669,1768,1901
Tennessee,Robertson County,15,2784,1298,1486
Tennessee,Robertson County,16,1941,924,1017
Tennessee,Robertson County,17,1185,504,681
Tennessee,Robertson County,18,941,333,608
Tennessee,Rutherford County,0,324890,159916,164974
Tennessee,Rutherford County,1,21353,10993,10360
Tennessee,Rutherford County,2,21775,11039,10736
Tennessee,Rutherford County,3,23298,11893,11405
Tennessee,Rutherford County,4,23593,12037,11556
Tennessee,Rutherford County,5,29763,14799,14964
Tennessee,Rutherford County,6,25815,13322,12493
Tennessee,Rutherford County,7,22342,10934,11408
Tennessee,Rutherford County,8,24007,11734,12273
Tennessee,Rutherford County,9,21894,10709,11185
Tennessee,Rutherford County,10,22162,10891,11271
Tennessee,Rutherford County,11,19994,9733,10261
Tennessee,Rutherford County,12,18861,9149,9712
Tennessee,Rutherford County,13,16067,7668,8399
Tennessee,Rutherford County,14,12393,5811,6582
Tennessee,Rutherford County,15,8995,4100,4895
Tennessee,Rutherford County,16,5757,2563,3194
Tennessee,Rutherford County,17,3620,1439,2181
Tennessee,Rutherford County,18,3201,1102,2099
Tennessee,Scott County,0,22039,10821,11218
Tennessee,Scott County,1,1395,711,684
Tennessee,Scott County,2,1393,716,677
Tennessee,Scott County,3,1566,794,772
Tennessee,Scott County,4,1482,736,746
Tennessee,Scott County,5,1213,611,602
Tennessee,Scott County,6,1462,728,734
Tennessee,Scott County,7,1209,601,608
Tennessee,Scott County,8,1359,671,688
Tennessee,Scott County,9,1470,719,751
Tennessee,Scott County,10,1412,707,705
Tennessee,Scott County,11,1514,767,747
Tennessee,Scott County,12,1468,720,748
Tennessee,Scott County,13,1392,659,733
Tennessee,Scott County,14,1215,589,626
Tennessee,Scott County,15,1008,451,557
Tennessee,Scott County,16,738,331,407
Tennessee,Scott County,17,401,172,229
Tennessee,Scott County,18,342,138,204
Tennessee,Sequatchie County,0,14876,7363,7513
Tennessee,Sequatchie County,1,764,396,368
Tennessee,Sequatchie County,2,789,399,390
Tennessee,Sequatchie County,3,944,494,450
Tennessee,Sequatchie County,4,913,470,443
Tennessee,Sequatchie County,5,766,392,374
Tennessee,Sequatchie County,6,877,455,422
Tennessee,Sequatchie County,7,754,373,381
Tennessee,Sequatchie County,8,855,409,446
Tennessee,Sequatchie County,9,897,451,446
Tennessee,Sequatchie County,10,1012,522,490
Tennessee,Sequatchie County,11,1015,488,527
Tennessee,Sequatchie County,12,1099,538,561
Tennessee,Sequatchie County,13,1163,559,604
Tennessee,Sequatchie County,14,964,445,519
Tennessee,Sequatchie County,15,873,451,422
Tennessee,Sequatchie County,16,568,265,303
Tennessee,Sequatchie County,17,332,155,177
Tennessee,Sequatchie County,18,291,101,190
Tennessee,Sevier County,0,97892,47915,49977
Tennessee,Sevier County,1,5308,2734,2574
Tennessee,Sevier County,2,5455,2855,2600
Tennessee,Sevier County,3,5772,2996,2776
Tennessee,Sevier County,4,5573,2944,2629
Tennessee,Sevier County,5,5452,2783,2669
Tennessee,Sevier County,6,6360,3187,3173
Tennessee,Sevier County,7,5320,2675,2645
Tennessee,Sevier County,8,5572,2729,2843
Tennessee,Sevier County,9,5682,2758,2924
Tennessee,Sevier County,10,6712,3324,3388
Tennessee,Sevier County,11,6938,3331,3607
Tennessee,Sevier County,12,7263,3442,3821
Tennessee,Sevier County,13,7144,3321,3823
Tennessee,Sevier County,14,6542,3024,3518
Tennessee,Sevier County,15,5402,2589,2813
Tennessee,Sevier County,16,3663,1701,1962
Tennessee,Sevier County,17,2058,900,1158
Tennessee,Sevier County,18,1676,622,1054
Tennessee,Shelby County,0,935764,444522,491242
Tennessee,Shelby County,1,65125,32807,32318
Tennessee,Shelby County,2,65885,33669,32216
Tennessee,Shelby County,3,64077,32411,31666
Tennessee,Shelby County,4,61046,30812,30234
Tennessee,Shelby County,5,63337,31350,31987
Tennessee,Shelby County,6,74331,36125,38206
Tennessee,Shelby County,7,64653,30940,33713
Tennessee,Shelby County,8,61522,29326,32196
Tennessee,Shelby County,9,55504,26168,29336
Tennessee,Shelby County,10,59066,27746,31320
Tennessee,Shelby County,11,57453,26932,30521
Tennessee,Shelby County,12,60115,27710,32405
Tennessee,Shelby County,13,56551,25717,30834
Tennessee,Shelby County,14,45586,20321,25265
Tennessee,Shelby County,15,32499,14400,18099
Tennessee,Shelby County,16,20909,8682,12227
Tennessee,Shelby County,17,13451,4892,8559
Tennessee,Shelby County,18,14654,4514,10140
Tennessee,Smith County,0,19942,9921,10021
Tennessee,Smith County,1,1230,608,622
Tennessee,Smith County,2,1159,612,547
Tennessee,Smith County,3,1311,679,632
Tennessee,Smith County,4,1241,654,587
Tennessee,Smith County,5,1160,574,586
Tennessee,Smith County,6,1279,675,604
Tennessee,Smith County,7,1137,579,558
Tennessee,Smith County,8,1243,615,628
Tennessee,Smith County,9,1130,529,601
Tennessee,Smith County,10,1302,643,659
Tennessee,Smith County,11,1473,735,738
Tennessee,Smith County,12,1546,808,738
Tennessee,Smith County,13,1346,673,673
Tennessee,Smith County,14,1147,553,594
Tennessee,Smith County,15,959,448,511
Tennessee,Smith County,16,630,294,336
Tennessee,Smith County,17,358,157,201
Tennessee,Smith County,18,291,85,206
Tennessee,Stewart County,0,13561,6773,6788
Tennessee,Stewart County,1,744,373,371
Tennessee,Stewart County,2,714,349,365
Tennessee,Stewart County,3,830,435,395
Tennessee,Stewart County,4,839,451,388
Tennessee,Stewart County,5,700,350,350
Tennessee,Stewart County,6,760,417,343
Tennessee,Stewart County,7,665,325,340
Tennessee,Stewart County,8,780,414,366
Tennessee,Stewart County,9,784,388,396
Tennessee,Stewart County,10,888,449,439
Tennessee,Stewart County,11,1065,521,544
Tennessee,Stewart County,12,1008,544,464
Tennessee,Stewart County,13,1026,464,562
Tennessee,Stewart County,14,895,444,451
Tennessee,Stewart County,15,768,368,400
Tennessee,Stewart County,16,521,241,280
Tennessee,Stewart County,17,305,130,175
Tennessee,Stewart County,18,269,110,159
Tennessee,Sullivan County,0,157668,76687,80981
Tennessee,Sullivan County,1,7622,3915,3707
Tennessee,Sullivan County,2,8212,4228,3984
Tennessee,Sullivan County,3,8975,4579,4396
Tennessee,Sullivan County,4,8822,4522,4300
Tennessee,Sullivan County,5,8462,4351,4111
Tennessee,Sullivan County,6,9894,5035,4859
Tennessee,Sullivan County,7,8540,4245,4295
Tennessee,Sullivan County,8,8592,4188,4404
Tennessee,Sullivan County,9,9101,4523,4578
Tennessee,Sullivan County,10,10919,5319,5600
Tennessee,Sullivan County,11,11173,5495,5678
Tennessee,Sullivan County,12,11464,5535,5929
Tennessee,Sullivan County,13,11363,5400,5963
Tennessee,Sullivan County,14,10234,4805,5429
Tennessee,Sullivan County,15,9096,4250,4846
Tennessee,Sullivan County,16,6739,3000,3739
Tennessee,Sullivan County,17,4441,1897,2544
Tennessee,Sullivan County,18,4019,1400,2619
Tennessee,Sumner County,0,187149,91378,95771
Tennessee,Sumner County,1,11333,5773,5560
Tennessee,Sumner County,2,12018,6122,5896
Tennessee,Sumner County,3,12927,6647,6280
Tennessee,Sumner County,4,11734,6056,5678
Tennessee,Sumner County,5,10322,5304,5018
Tennessee,Sumner County,6,11772,5826,5946
Tennessee,Sumner County,7,11525,5530,5995
Tennessee,Sumner County,8,12663,6134,6529
Tennessee,Sumner County,9,12050,5938,6112
Tennessee,Sumner County,10,13358,6526,6832
Tennessee,Sumner County,11,12926,6289,6637
Tennessee,Sumner County,12,12991,6314,6677
Tennessee,Sumner County,13,11866,5727,6139
Tennessee,Sumner County,14,9899,4625,5274
Tennessee,Sumner County,15,8031,3766,4265
Tennessee,Sumner County,16,5449,2395,3054
Tennessee,Sumner County,17,3233,1350,1883
Tennessee,Sumner County,18,3052,1056,1996
Tennessee,Tipton County,0,61581,30396,31185
Tennessee,Tipton County,1,3699,1857,1842
Tennessee,Tipton County,2,4089,2125,1964
Tennessee,Tipton County,3,4527,2323,2204
Tennessee,Tipton County,4,4296,2250,2046
Tennessee,Tipton County,5,3707,1946,1761
Tennessee,Tipton County,6,4022,2065,1957
Tennessee,Tipton County,7,3833,1870,1963
Tennessee,Tipton County,8,3953,1911,2042
Tennessee,Tipton County,9,3790,1879,1911
Tennessee,Tipton County,10,4108,2021,2087
Tennessee,Tipton County,11,4286,2113,2173
Tennessee,Tipton County,12,4449,2130,2319
Tennessee,Tipton County,13,3918,1864,2054
Tennessee,Tipton County,14,3056,1460,1596
Tennessee,Tipton County,15,2412,1139,1273
Tennessee,Tipton County,16,1641,736,905
Tennessee,Tipton County,17,970,396,574
Tennessee,Tipton County,18,825,311,514
Tennessee,Trousdale County,0,11012,6521,4491
Tennessee,Trousdale County,1,545,277,268
Tennessee,Trousdale County,2,530,288,242
Tennessee,Trousdale County,3,562,283,279
Tennessee,Trousdale County,4,756,534,222
Tennessee,Trousdale County,5,765,538,227
Tennessee,Trousdale County,6,1154,859,295
Tennessee,Trousdale County,7,1207,746,461
Tennessee,Trousdale County,8,923,664,259
Tennessee,Trousdale County,9,511,253,258
Tennessee,Trousdale County,10,770,465,305
Tennessee,Trousdale County,11,694,379,315
Tennessee,Trousdale County,12,578,293,285
Tennessee,Trousdale County,13,591,273,318
Tennessee,Trousdale County,14,483,230,253
Tennessee,Trousdale County,15,390,198,192
Tennessee,Trousdale County,16,275,141,134
Tennessee,Trousdale County,17,146,55,91
Tennessee,Trousdale County,18,132,45,87
Tennessee,Unicoi County,0,17761,8724,9037
Tennessee,Unicoi County,1,799,389,410
Tennessee,Unicoi County,2,861,431,430
Tennessee,Unicoi County,3,1001,549,452
Tennessee,Unicoi County,4,1005,510,495
Tennessee,Unicoi County,5,915,449,466
Tennessee,Unicoi County,6,1010,527,483
Tennessee,Unicoi County,7,896,438,458
Tennessee,Unicoi County,8,984,503,481
Tennessee,Unicoi County,9,1010,499,511
Tennessee,Unicoi County,10,1176,593,583
Tennessee,Unicoi County,11,1240,614,626
Tennessee,Unicoi County,12,1374,660,714
Tennessee,Unicoi County,13,1367,684,683
Tennessee,Unicoi County,14,1283,623,660
Tennessee,Unicoi County,15,1021,474,547
Tennessee,Unicoi County,16,799,387,412
Tennessee,Unicoi County,17,533,239,294
Tennessee,Unicoi County,18,487,155,332
Tennessee,Union County,0,19688,9700,9988
Tennessee,Union County,1,1052,532,520
Tennessee,Union County,2,1188,588,600
Tennessee,Union County,3,1288,628,660
Tennessee,Union County,4,1134,622,512
Tennessee,Union County,5,1033,506,527
Tennessee,Union County,6,1224,607,617
Tennessee,Union County,7,1123,545,578
Tennessee,Union County,8,1110,539,571
Tennessee,Union County,9,1160,614,546
Tennessee,Union County,10,1274,623,651
Tennessee,Union County,11,1449,704,745
Tennessee,Union County,12,1630,818,812
Tennessee,Union County,13,1420,688,732
Tennessee,Union County,14,1253,641,612
Tennessee,Union County,15,981,486,495
Tennessee,Union County,16,691,327,364
Tennessee,Union County,17,349,129,220
Tennessee,Union County,18,329,103,226
Tennessee,Van Buren County,0,5765,2886,2879
Tennessee,Van Buren County,1,325,172,153
Tennessee,Van Buren County,2,292,147,145
Tennessee,Van Buren County,3,294,148,146
Tennessee,Van Buren County,4,297,154,143
Tennessee,Van Buren County,5,290,164,126
Tennessee,Van Buren County,6,325,172,153
Tennessee,Van Buren County,7,256,133,123
Tennessee,Van Buren County,8,286,143,143
Tennessee,Van Buren County,9,363,182,181
Tennessee,Van Buren County,10,377,180,197
Tennessee,Van Buren County,11,379,187,192
Tennessee,Van Buren County,12,430,223,207
Tennessee,Van Buren County,13,486,230,256
Tennessee,Van Buren County,14,503,247,256
Tennessee,Van Buren County,15,371,182,189
Tennessee,Van Buren County,16,230,110,120
Tennessee,Van Buren County,17,149,67,82
Tennessee,Van Buren County,18,112,45,67
Tennessee,Warren County,0,40878,20227,20651
Tennessee,Warren County,1,2443,1211,1232
Tennessee,Warren County,2,2586,1328,1258
Tennessee,Warren County,3,2772,1412,1360
Tennessee,Warren County,4,2704,1424,1280
Tennessee,Warren County,5,2205,1176,1029
Tennessee,Warren County,6,2568,1313,1255
Tennessee,Warren County,7,2316,1133,1183
Tennessee,Warren County,8,2599,1268,1331
Tennessee,Warren County,9,2614,1367,1247
Tennessee,Warren County,10,2674,1369,1305
Tennessee,Warren County,11,2653,1322,1331
Tennessee,Warren County,12,2820,1425,1395
Tennessee,Warren County,13,2694,1294,1400
Tennessee,Warren County,14,2224,1045,1179
Tennessee,Warren County,15,1953,880,1073
Tennessee,Warren County,16,1403,629,774
Tennessee,Warren County,17,876,368,508
Tennessee,Warren County,18,774,263,511
Tennessee,Washington County,0,128607,62829,65778
Tennessee,Washington County,1,6398,3284,3114
Tennessee,Washington County,2,6631,3329,3302
Tennessee,Washington County,3,7187,3700,3487
Tennessee,Washington County,4,8390,4060,4330
Tennessee,Washington County,5,11705,5693,6012
Tennessee,Washington County,6,8886,4445,4441
Tennessee,Washington County,7,7186,3616,3570
Tennessee,Washington County,8,7318,3572,3746
Tennessee,Washington County,9,7416,3716,3700
Tennessee,Washington County,10,8534,4269,4265
Tennessee,Washington County,11,8262,4183,4079
Tennessee,Washington County,12,8721,4194,4527
Tennessee,Washington County,13,8409,4051,4358
Tennessee,Washington County,14,7421,3615,3806
Tennessee,Washington County,15,6291,2904,3387
Tennessee,Washington County,16,4511,2104,2407
Tennessee,Washington County,17,2755,1169,1586
Tennessee,Washington County,18,2586,925,1661
Tennessee,Wayne County,0,16558,9144,7414
Tennessee,Wayne County,1,707,373,334
Tennessee,Wayne County,2,720,357,363
Tennessee,Wayne County,3,863,457,406
Tennessee,Wayne County,4,842,465,377
Tennessee,Wayne County,5,964,627,337
Tennessee,Wayne County,6,1293,845,448
Tennessee,Wayne County,7,1099,742,357
Tennessee,Wayne County,8,1085,675,410
Tennessee,Wayne County,9,1065,645,420
Tennessee,Wayne County,10,1193,698,495
Tennessee,Wayne County,11,1206,641,565
Tennessee,Wayne County,12,1199,610,589
Tennessee,Wayne County,13,1094,551,543
Tennessee,Wayne County,14,1011,491,520
Tennessee,Wayne County,15,843,404,439
Tennessee,Wayne County,16,579,259,320
Tennessee,Wayne County,17,403,177,226
Tennessee,Wayne County,18,392,127,265
Tennessee,Weakley County,0,33415,16382,17033
Tennessee,Weakley County,1,1699,879,820
Tennessee,Weakley County,2,1819,946,873
Tennessee,Weakley County,3,1795,939,856
Tennessee,Weakley County,4,2569,1229,1340
Tennessee,Weakley County,5,3891,1979,1912
Tennessee,Weakley County,6,2119,1108,1011
Tennessee,Weakley County,7,1635,855,780
Tennessee,Weakley County,8,1727,838,889
Tennessee,Weakley County,9,1690,836,854
Tennessee,Weakley County,10,1972,958,1014
Tennessee,Weakley County,11,2046,1007,1039
Tennessee,Weakley County,12,2167,1069,1098
Tennessee,Weakley County,13,2058,997,1061
Tennessee,Weakley County,14,1954,931,1023
Tennessee,Weakley County,15,1573,735,838
Tennessee,Weakley County,16,1114,489,625
Tennessee,Weakley County,17,779,317,462
Tennessee,Weakley County,18,808,270,538
Tennessee,White County,0,27107,13262,13845
Tennessee,White County,1,1605,812,793
Tennessee,White County,2,1584,821,763
Tennessee,White County,3,1721,874,847
Tennessee,White County,4,1574,813,761
Tennessee,White County,5,1378,700,678
Tennessee,White County,6,1722,878,844
Tennessee,White County,7,1546,793,753
Tennessee,White County,8,1526,744,782
Tennessee,White County,9,1578,786,792
Tennessee,White County,10,1726,834,892
Tennessee,White County,11,1909,944,965
Tennessee,White County,12,1826,893,933
Tennessee,White County,13,1918,894,1024
Tennessee,White County,14,1777,841,936
Tennessee,White County,15,1407,673,734
Tennessee,White County,16,1038,476,562
Tennessee,White County,17,616,254,362
Tennessee,White County,18,656,232,424
Tennessee,Williamson County,0,231729,113699,118030
Tennessee,Williamson County,1,13834,7072,6762
Tennessee,Williamson County,2,17088,8837,8251
Tennessee,Williamson County,3,20078,10103,9975
Tennessee,Williamson County,4,17992,9260,8732
Tennessee,Williamson County,5,11941,6027,5914
Tennessee,Williamson County,6,9778,4918,4860
Tennessee,Williamson County,7,11802,5559,6243
Tennessee,Williamson County,8,16177,7747,8430
Tennessee,Williamson County,9,17310,8361,8949
Tennessee,Williamson County,10,18671,9212,9459
Tennessee,Williamson County,11,16892,8252,8640
Tennessee,Williamson County,12,15847,7691,8156
Tennessee,Williamson County,13,13839,6677,7162
Tennessee,Williamson County,14,10740,5184,5556
Tennessee,Williamson County,15,8191,3892,4299
Tennessee,Williamson County,16,5011,2345,2666
Tennessee,Williamson County,17,3197,1311,1886
Tennessee,Williamson County,18,3341,1251,2090
Tennessee,Wilson County,0,140625,69171,71454
Tennessee,Wilson County,1,8454,4283,4171
Tennessee,Wilson County,2,9158,4727,4431
Tennessee,Wilson County,3,9746,5055,4691
Tennessee,Wilson County,4,9115,4796,4319
Tennessee,Wilson County,5,7194,3732,3462
Tennessee,Wilson County,6,8238,4024,4214
Tennessee,Wilson County,7,8635,4080,4555
Tennessee,Wilson County,8,9844,4816,5028
Tennessee,Wilson County,9,9487,4725,4762
Tennessee,Wilson County,10,10209,5029,5180
Tennessee,Wilson County,11,9704,4795,4909
Tennessee,Wilson County,12,10030,4874,5156
Tennessee,Wilson County,13,8746,4212,4534
Tennessee,Wilson County,14,7634,3575,4059
Tennessee,Wilson County,15,6129,2902,3227
Tennessee,Wilson County,16,4020,1841,2179
Tennessee,Wilson County,17,2399,1050,1349
Tennessee,Wilson County,18,1883,655,1228
Texas,Anderson County,0,58057,35546,22511
Texas,Anderson County,1,3016,1575,1441
Texas,Anderson County,2,3009,1554,1455
Texas,Anderson County,3,3140,1624,1516
Texas,Anderson County,4,3091,1712,1379
Texas,Anderson County,5,3410,2192,1218
Texas,Anderson County,6,4493,3140,1353
Texas,Anderson County,7,4836,3545,1291
Texas,Anderson County,8,4679,3379,1300
Texas,Anderson County,9,4599,3348,1251
Texas,Anderson County,10,4440,3076,1364
Texas,Anderson County,11,3896,2546,1350
Texas,Anderson County,12,3576,2122,1454
Texas,Anderson County,13,3281,1717,1564
Texas,Anderson County,14,2776,1412,1364
Texas,Anderson County,15,2246,1104,1142
Texas,Anderson County,16,1701,783,918
Texas,Anderson County,17,982,379,603
Texas,Anderson County,18,886,338,548
Texas,Andrews County,0,18128,9274,8854
Texas,Andrews County,1,1569,822,747
Texas,Andrews County,2,1571,794,777
Texas,Andrews County,3,1533,808,725
Texas,Andrews County,4,1363,686,677
Texas,Andrews County,5,1148,624,524
Texas,Andrews County,6,1378,759,619
Texas,Andrews County,7,1301,661,640
Texas,Andrews County,8,1351,720,631
Texas,Andrews County,9,1069,540,529
Texas,Andrews County,10,1043,515,528
Texas,Andrews County,11,1010,512,498
Texas,Andrews County,12,1034,545,489
Texas,Andrews County,13,880,444,436
Texas,Andrews County,14,610,304,306
Texas,Andrews County,15,472,222,250
Texas,Andrews County,16,316,133,183
Texas,Andrews County,17,243,88,155
Texas,Andrews County,18,237,97,140
Texas,Angelina County,0,87092,42488,44604
Texas,Angelina County,1,5951,3018,2933
Texas,Angelina County,2,6113,3087,3026
Texas,Angelina County,3,6508,3278,3230
Texas,Angelina County,4,5884,2974,2910
Texas,Angelina County,5,5380,2682,2698
Texas,Angelina County,6,5822,2845,2977
Texas,Angelina County,7,5352,2578,2774
Texas,Angelina County,8,5311,2551,2760
Texas,Angelina County,9,4987,2421,2566
Texas,Angelina County,10,5402,2691,2711
Texas,Angelina County,11,5375,2691,2684
Texas,Angelina County,12,5601,2837,2764
Texas,Angelina County,13,5188,2499,2689
Texas,Angelina County,14,4403,2076,2327
Texas,Angelina County,15,3659,1631,2028
Texas,Angelina County,16,2609,1182,1427
Texas,Angelina County,17,1818,781,1037
Texas,Angelina County,18,1729,666,1063
Texas,Aransas County,0,23792,11751,12041
Texas,Aransas County,1,1141,592,549
Texas,Aransas County,2,1116,560,556
Texas,Aransas County,3,1196,611,585
Texas,Aransas County,4,1161,617,544
Texas,Aransas County,5,1109,606,503
Texas,Aransas County,6,1108,546,562
Texas,Aransas County,7,1075,554,521
Texas,Aransas County,8,1141,579,562
Texas,Aransas County,9,1068,535,533
Texas,Aransas County,10,1318,645,673
Texas,Aransas County,11,1424,667,757
Texas,Aransas County,12,1929,929,1000
Texas,Aransas County,13,1957,920,1037
Texas,Aransas County,14,2018,967,1051
Texas,Aransas County,15,1925,934,991
Texas,Aransas County,16,1544,742,802
Texas,Aransas County,17,860,425,435
Texas,Aransas County,18,702,322,380
Texas,Archer County,0,8786,4326,4460
Texas,Archer County,1,461,208,253
Texas,Archer County,2,485,244,241
Texas,Archer County,3,613,316,297
Texas,Archer County,4,544,291,253
Texas,Archer County,5,450,247,203
Texas,Archer County,6,441,239,202
Texas,Archer County,7,487,229,258
Texas,Archer County,8,488,271,217
Texas,Archer County,9,491,224,267
Texas,Archer County,10,541,242,299
Texas,Archer County,11,608,318,290
Texas,Archer County,12,715,346,369
Texas,Archer County,13,704,333,371
Texas,Archer County,14,532,245,287
Texas,Archer County,15,424,204,220
Texas,Archer County,16,344,162,182
Texas,Archer County,17,247,113,134
Texas,Archer County,18,211,94,117
Texas,Armstrong County,0,1892,918,974
Texas,Armstrong County,1,108,49,59
Texas,Armstrong County,2,142,72,70
Texas,Armstrong County,3,121,57,64
Texas,Armstrong County,4,102,46,56
Texas,Armstrong County,5,77,43,34
Texas,Armstrong County,6,89,47,42
Texas,Armstrong County,7,87,39,48
Texas,Armstrong County,8,113,54,59
Texas,Armstrong County,9,111,61,50
Texas,Armstrong County,10,112,60,52
Texas,Armstrong County,11,82,44,38
Texas,Armstrong County,12,146,63,83
Texas,Armstrong County,13,149,77,72
Texas,Armstrong County,14,135,69,66
Texas,Armstrong County,15,122,63,59
Texas,Armstrong County,16,84,37,47
Texas,Armstrong County,17,68,25,43
Texas,Armstrong County,18,44,12,32
Texas,Atascosa County,0,50310,25084,25226
Texas,Atascosa County,1,3671,1880,1791
Texas,Atascosa County,2,3841,1950,1891
Texas,Atascosa County,3,3904,2026,1878
Texas,Atascosa County,4,3654,1878,1776
Texas,Atascosa County,5,3159,1575,1584
Texas,Atascosa County,6,3230,1642,1588
Texas,Atascosa County,7,3255,1705,1550
Texas,Atascosa County,8,3334,1640,1694
Texas,Atascosa County,9,2980,1516,1464
Texas,Atascosa County,10,3093,1526,1567
Texas,Atascosa County,11,2905,1469,1436
Texas,Atascosa County,12,3124,1513,1611
Texas,Atascosa County,13,2775,1367,1408
Texas,Atascosa County,14,2388,1147,1241
Texas,Atascosa County,15,1950,943,1007
Texas,Atascosa County,16,1355,636,719
Texas,Atascosa County,17,863,378,485
Texas,Atascosa County,18,829,293,536
Texas,Austin County,0,29989,14954,15035
Texas,Austin County,1,1768,898,870
Texas,Austin County,2,2041,1028,1013
Texas,Austin County,3,2065,1071,994
Texas,Austin County,4,1989,992,997
Texas,Austin County,5,1660,854,806
Texas,Austin County,6,1748,888,860
Texas,Austin County,7,1647,839,808
Texas,Austin County,8,1662,796,866
Texas,Austin County,9,1677,855,822
Texas,Austin County,10,1749,853,896
Texas,Austin County,11,1917,969,948
Texas,Austin County,12,2104,1070,1034
Texas,Austin County,13,2263,1131,1132
Texas,Austin County,14,1836,929,907
Texas,Austin County,15,1529,733,796
Texas,Austin County,16,1114,551,563
Texas,Austin County,17,601,271,330
Texas,Austin County,18,619,226,393
Texas,Bailey County,0,7027,3499,3528
Texas,Bailey County,1,577,278,299
Texas,Bailey County,2,574,290,284
Texas,Bailey County,3,669,331,338
Texas,Bailey County,4,602,296,306
Texas,Bailey County,5,439,229,210
Texas,Bailey County,6,384,187,197
Texas,Bailey County,7,422,211,211
Texas,Bailey County,8,397,202,195
Texas,Bailey County,9,451,232,219
Texas,Bailey County,10,340,168,172
Texas,Bailey County,11,370,181,189
Texas,Bailey County,12,400,206,194
Texas,Bailey County,13,377,205,172
Texas,Bailey County,14,313,152,161
Texas,Bailey County,15,232,118,114
Texas,Bailey County,16,190,89,101
Texas,Bailey County,17,158,66,92
Texas,Bailey County,18,132,58,74
Texas,Bandera County,0,22824,11327,11497
Texas,Bandera County,1,949,522,427
Texas,Bandera County,2,1043,529,514
Texas,Bandera County,3,1138,554,584
Texas,Bandera County,4,1066,560,506
Texas,Bandera County,5,1001,513,488
Texas,Bandera County,6,957,511,446
Texas,Bandera County,7,1045,529,516
Texas,Bandera County,8,1087,537,550
Texas,Bandera County,9,1055,511,544
Texas,Bandera County,10,1308,648,660
Texas,Bandera County,11,1584,752,832
Texas,Bandera County,12,2196,1005,1191
Texas,Bandera County,13,2238,1075,1163
Texas,Bandera County,14,2098,1029,1069
Texas,Bandera County,15,1733,892,841
Texas,Bandera County,16,1156,592,564
Texas,Bandera County,17,627,322,305
Texas,Bandera County,18,543,246,297
Texas,Bastrop County,0,86976,44296,42680
Texas,Bastrop County,1,5922,3000,2922
Texas,Bastrop County,2,5812,2897,2915
Texas,Bastrop County,3,6498,3308,3190
Texas,Bastrop County,4,6098,3207,2891
Texas,Bastrop County,5,5075,2682,2393
Texas,Bastrop County,6,5245,2834,2411
Texas,Bastrop County,7,5315,2815,2500
Texas,Bastrop County,8,5317,2789,2528
Texas,Bastrop County,9,5203,2735,2468
Texas,Bastrop County,10,5494,2817,2677
Texas,Bastrop County,11,5657,2897,2760
Texas,Bastrop County,12,6203,3152,3051
Texas,Bastrop County,13,5926,2941,2985
Texas,Bastrop County,14,4864,2429,2435
Texas,Bastrop County,15,3666,1771,1895
Texas,Bastrop County,16,2129,989,1140
Texas,Bastrop County,17,1374,587,787
Texas,Bastrop County,18,1178,446,732
Texas,Baylor County,0,3582,1744,1838
Texas,Baylor County,1,212,103,109
Texas,Baylor County,2,242,124,118
Texas,Baylor County,3,234,124,110
Texas,Baylor County,4,205,110,95
Texas,Baylor County,5,161,96,65
Texas,Baylor County,6,201,89,112
Texas,Baylor County,7,177,80,97
Texas,Baylor County,8,211,114,97
Texas,Baylor County,9,183,94,89
Texas,Baylor County,10,192,92,100
Texas,Baylor County,11,220,97,123
Texas,Baylor County,12,234,130,104
Texas,Baylor County,13,257,126,131
Texas,Baylor County,14,229,111,118
Texas,Baylor County,15,183,76,107
Texas,Baylor County,16,182,80,102
Texas,Baylor County,17,119,53,66
Texas,Baylor County,18,140,45,95
Texas,Bee County,0,32587,19819,12768
Texas,Bee County,1,1895,974,921
Texas,Bee County,2,1868,951,917
Texas,Bee County,3,1956,990,966
Texas,Bee County,4,2124,1164,960
Texas,Bee County,5,2704,1915,789
Texas,Bee County,6,2919,2078,841
Texas,Bee County,7,2769,1964,805
Texas,Bee County,8,2688,1909,779
Texas,Bee County,9,2256,1565,691
Texas,Bee County,10,2180,1504,676
Texas,Bee County,11,1889,1173,716
Texas,Bee County,12,1771,980,791
Texas,Bee County,13,1556,813,743
Texas,Bee County,14,1264,623,641
Texas,Bee County,15,1059,517,542
Texas,Bee County,16,716,313,403
Texas,Bee County,17,530,232,298
Texas,Bee County,18,443,154,289
Texas,Bell County,0,355642,176710,178932
Texas,Bell County,1,30043,15119,14924
Texas,Bell County,2,27667,14008,13659
Texas,Bell County,3,26126,13431,12695
Texas,Bell County,4,24702,12744,11958
Texas,Bell County,5,30052,16574,13478
Texas,Bell County,6,31798,16553,15245
Texas,Bell County,7,27481,13693,13788
Texas,Bell County,8,25400,12513,12887
Texas,Bell County,9,20889,10191,10698
Texas,Bell County,10,19568,9466,10102
Texas,Bell County,11,18490,9017,9473
Texas,Bell County,12,18501,8574,9927
Texas,Bell County,13,16340,7621,8719
Texas,Bell County,14,13048,6018,7030
Texas,Bell County,15,10224,4706,5518
Texas,Bell County,16,6729,3042,3687
Texas,Bell County,17,4248,1812,2436
Texas,Bell County,18,4336,1628,2708
Texas,Bexar County,0,1986049,980516,1005533
Texas,Bexar County,1,141698,72331,69367
Texas,Bexar County,2,139902,71357,68545
Texas,Bexar County,3,142368,72375,69993
Texas,Bexar County,4,142291,73114,69177
Texas,Bexar County,5,145553,75084,70469
Texas,Bexar County,6,162541,83586,78955
Texas,Bexar County,7,155306,79198,76108
Texas,Bexar County,8,143331,72174,71157
Texas,Bexar County,9,125203,61764,63439
Texas,Bexar County,10,124305,60705,63600
Texas,Bexar County,11,113056,55249,57807
Texas,Bexar County,12,112088,53875,58213
Texas,Bexar County,13,97786,45484,52302
Texas,Bexar County,14,81756,37231,44525
Texas,Bexar County,15,62057,28018,34039
Texas,Bexar County,16,40861,17719,23142
Texas,Bexar County,17,27410,11050,16360
Texas,Bexar County,18,28537,10202,18335
Texas,Blanco County,0,11702,5872,5830
Texas,Blanco County,1,511,246,265
Texas,Blanco County,2,507,270,237
Texas,Blanco County,3,695,344,351
Texas,Blanco County,4,681,403,278
Texas,Blanco County,5,549,299,250
Texas,Blanco County,6,496,259,237
Texas,Blanco County,7,517,248,269
Texas,Blanco County,8,583,331,252
Texas,Blanco County,9,625,319,306
Texas,Blanco County,10,721,350,371
Texas,Blanco County,11,808,378,430
Texas,Blanco County,12,1063,524,539
Texas,Blanco County,13,1105,543,562
Texas,Blanco County,14,963,444,519
Texas,Blanco County,15,818,406,412
Texas,Blanco County,16,522,254,268
Texas,Blanco County,17,304,148,156
Texas,Blanco County,18,234,106,128
Texas,Borden County,0,648,337,311
Texas,Borden County,1,33,17,16
Texas,Borden County,2,35,23,12
Texas,Borden County,3,38,14,24
Texas,Borden County,4,35,21,14
Texas,Borden County,5,29,16,13
Texas,Borden County,6,20,11,9
Texas,Borden County,7,27,13,14
Texas,Borden County,8,34,18,16
Texas,Borden County,9,33,15,18
Texas,Borden County,10,65,39,26
Texas,Borden County,11,48,21,27
Texas,Borden County,12,47,29,18
Texas,Borden County,13,44,19,25
Texas,Borden County,14,42,22,20
Texas,Borden County,15,35,19,16
Texas,Borden County,16,25,16,9
Texas,Borden County,17,31,16,15
Texas,Borden County,18,27,8,19
Texas,Bosque County,0,18691,9248,9443
Texas,Bosque County,1,1033,545,488
Texas,Bosque County,2,1118,581,537
Texas,Bosque County,3,1198,627,571
Texas,Bosque County,4,1086,563,523
Texas,Bosque County,5,867,468,399
Texas,Bosque County,6,955,455,500
Texas,Bosque County,7,857,402,455
Texas,Bosque County,8,1028,515,513
Texas,Bosque County,9,905,436,469
Texas,Bosque County,10,1035,496,539
Texas,Bosque County,11,1168,581,587
Texas,Bosque County,12,1371,665,706
Texas,Bosque County,13,1463,712,751
Texas,Bosque County,14,1339,683,656
Texas,Bosque County,15,1257,605,652
Texas,Bosque County,16,893,429,464
Texas,Bosque County,17,547,234,313
Texas,Bosque County,18,571,251,320
Texas,Bowie County,0,94324,47473,46851
Texas,Bowie County,1,6117,3130,2987
Texas,Bowie County,2,6206,3140,3066
Texas,Bowie County,3,6312,3238,3074
Texas,Bowie County,4,5891,3100,2791
Texas,Bowie County,5,5827,3155,2672
Texas,Bowie County,6,6812,3731,3081
Texas,Bowie County,7,6178,3311,2867
Texas,Bowie County,8,6311,3236,3075
Texas,Bowie County,9,5765,3050,2715
Texas,Bowie County,10,5827,3069,2758
Texas,Bowie County,11,5707,2831,2876
Texas,Bowie County,12,6108,2989,3119
Texas,Bowie County,13,5658,2725,2933
Texas,Bowie County,14,4878,2279,2599
Texas,Bowie County,15,4097,1863,2234
Texas,Bowie County,16,2841,1241,1600
Texas,Bowie County,17,1752,728,1024
Texas,Bowie County,18,2037,657,1380
Texas,Brazoria County,0,370200,187001,183199
Texas,Brazoria County,1,25765,13183,12582
Texas,Brazoria County,2,27589,14110,13479
Texas,Brazoria County,3,28074,14423,13651
Texas,Brazoria County,4,25434,13246,12188
Texas,Brazoria County,5,21202,11035,10167
Texas,Brazoria County,6,24993,12805,12188
Texas,Brazoria County,7,27250,13850,13400
Texas,Brazoria County,8,28597,14533,14064
Texas,Brazoria County,9,25951,13271,12680
Texas,Brazoria County,10,25757,13230,12527
Texas,Brazoria County,11,23208,11968,11240
Texas,Brazoria County,12,22605,11302,11303
Texas,Brazoria County,13,20097,9975,10122
Texas,Brazoria County,14,15573,7579,7994
Texas,Brazoria County,15,11639,5495,6144
Texas,Brazoria County,16,7452,3359,4093
Texas,Brazoria County,17,4705,2102,2603
Texas,Brazoria County,18,4309,1535,2774
Texas,Brazos County,0,226758,114626,112132
Texas,Brazos County,1,13916,7125,6791
Texas,Brazos County,2,12910,6534,6376
Texas,Brazos County,3,12527,6376,6151
Texas,Brazos County,4,21466,10647,10819
Texas,Brazos County,5,44070,23700,20370
Texas,Brazos County,6,20574,10805,9769
Texas,Brazos County,7,15767,8011,7756
Texas,Brazos County,8,14127,7231,6896
Texas,Brazos County,9,11246,5711,5535
Texas,Brazos County,10,10685,5191,5494
Texas,Brazos County,11,9801,4844,4957
Texas,Brazos County,12,9792,4726,5066
Texas,Brazos County,13,9115,4336,4779
Texas,Brazos County,14,7034,3404,3630
Texas,Brazos County,15,5274,2411,2863
Texas,Brazos County,16,3593,1597,1996
Texas,Brazos County,17,2423,1025,1398
Texas,Brazos County,18,2438,952,1486
Texas,Brewster County,0,9267,4684,4583
Texas,Brewster County,1,488,234,254
Texas,Brewster County,2,499,264,235
Texas,Brewster County,3,475,248,227
Texas,Brewster County,4,458,246,212
Texas,Brewster County,5,488,236,252
Texas,Brewster County,6,600,308,292
Texas,Brewster County,7,621,329,292
Texas,Brewster County,8,637,333,304
Texas,Brewster County,9,528,254,274
Texas,Brewster County,10,493,255,238
Texas,Brewster County,11,534,257,277
Texas,Brewster County,12,611,318,293
Texas,Brewster County,13,691,333,358
Texas,Brewster County,14,713,350,363
Texas,Brewster County,15,566,319,247
Texas,Brewster County,16,393,202,191
Texas,Brewster County,17,242,130,112
Texas,Brewster County,18,230,68,162
Texas,Briscoe County,0,1516,749,767
Texas,Briscoe County,1,65,29,36
Texas,Briscoe County,2,85,40,45
Texas,Briscoe County,3,90,53,37
Texas,Briscoe County,4,82,38,44
Texas,Briscoe County,5,76,42,34
Texas,Briscoe County,6,69,32,37
Texas,Briscoe County,7,92,50,42
Texas,Briscoe County,8,82,36,46
Texas,Briscoe County,9,96,47,49
Texas,Briscoe County,10,84,41,43
Texas,Briscoe County,11,97,43,54
Texas,Briscoe County,12,111,61,50
Texas,Briscoe County,13,90,36,54
Texas,Briscoe County,14,102,60,42
Texas,Briscoe County,15,112,56,56
Texas,Briscoe County,16,74,36,38
Texas,Briscoe County,17,62,30,32
Texas,Briscoe County,18,47,19,28
Texas,Brooks County,0,7114,3595,3519
Texas,Brooks County,1,590,296,294
Texas,Brooks County,2,607,322,285
Texas,Brooks County,3,532,286,246
Texas,Brooks County,4,475,253,222
Texas,Brooks County,5,457,276,181
Texas,Brooks County,6,489,268,221
Texas,Brooks County,7,402,233,169
Texas,Brooks County,8,424,216,208
Texas,Brooks County,9,344,177,167
Texas,Brooks County,10,313,138,175
Texas,Brooks County,11,361,176,185
Texas,Brooks County,12,418,204,214
Texas,Brooks County,13,399,197,202
Texas,Brooks County,14,381,158,223
Texas,Brooks County,15,331,160,171
Texas,Brooks County,16,258,115,143
Texas,Brooks County,17,187,75,112
Texas,Brooks County,18,146,45,101
Texas,Brown County,0,37924,18764,19160
Texas,Brown County,1,2048,1041,1007
Texas,Brown County,2,2178,1126,1052
Texas,Brown County,3,2396,1227,1169
Texas,Brown County,4,2861,1450,1411
Texas,Brown County,5,2244,1173,1071
Texas,Brown County,6,2262,1177,1085
Texas,Brown County,7,2252,1110,1142
Texas,Brown County,8,2277,1136,1141
Texas,Brown County,9,2056,1027,1029
Texas,Brown County,10,2309,1156,1153
Texas,Brown County,11,2303,1155,1148
Texas,Brown County,12,2687,1326,1361
Texas,Brown County,13,2495,1171,1324
Texas,Brown County,14,2293,1100,1193
Texas,Brown County,15,1930,948,982
Texas,Brown County,16,1468,668,800
Texas,Brown County,17,929,413,516
Texas,Brown County,18,936,360,576
Texas,Burleson County,0,18389,9045,9344
Texas,Burleson County,1,1138,551,587
Texas,Burleson County,2,1082,561,521
Texas,Burleson County,3,1157,585,572
Texas,Burleson County,4,1105,594,511
Texas,Burleson County,5,930,429,501
Texas,Burleson County,6,1090,512,578
Texas,Burleson County,7,1003,499,504
Texas,Burleson County,8,1013,480,533
Texas,Burleson County,9,918,448,470
Texas,Burleson County,10,1056,520,536
Texas,Burleson County,11,1252,643,609
Texas,Burleson County,12,1427,716,711
Texas,Burleson County,13,1463,686,777
Texas,Burleson County,14,1210,607,603
Texas,Burleson County,15,971,498,473
Texas,Burleson County,16,583,299,284
Texas,Burleson County,17,466,203,263
Texas,Burleson County,18,525,214,311
Texas,Burnet County,0,47542,23296,24246
Texas,Burnet County,1,2662,1361,1301
Texas,Burnet County,2,2752,1424,1328
Texas,Burnet County,3,2936,1502,1434
Texas,Burnet County,4,2841,1456,1385
Texas,Burnet County,5,2516,1276,1240
Texas,Burnet County,6,2648,1292,1356
Texas,Burnet County,7,2517,1273,1244
Texas,Burnet County,8,2645,1274,1371
Texas,Burnet County,9,2560,1215,1345
Texas,Burnet County,10,2710,1349,1361
Texas,Burnet County,11,2845,1382,1463
Texas,Burnet County,12,3597,1740,1857
Texas,Burnet County,13,3688,1738,1950
Texas,Burnet County,14,3491,1688,1803
Texas,Burnet County,15,2885,1421,1464
Texas,Burnet County,16,1890,892,998
Texas,Burnet County,17,1258,555,703
Texas,Burnet County,18,1101,458,643
Texas,Caldwell County,0,43247,21822,21425
Texas,Caldwell County,1,2759,1347,1412
Texas,Caldwell County,2,2671,1346,1325
Texas,Caldwell County,3,2909,1518,1391
Texas,Caldwell County,4,3494,1935,1559
Texas,Caldwell County,5,3388,1934,1454
Texas,Caldwell County,6,2932,1514,1418
Texas,Caldwell County,7,2886,1426,1460
Texas,Caldwell County,8,2789,1412,1377
Texas,Caldwell County,9,2565,1252,1313
Texas,Caldwell County,10,2711,1345,1366
Texas,Caldwell County,11,2625,1324,1301
Texas,Caldwell County,12,2725,1371,1354
Texas,Caldwell County,13,2583,1266,1317
Texas,Caldwell County,14,2120,1039,1081
Texas,Caldwell County,15,1581,752,829
Texas,Caldwell County,16,1068,470,598
Texas,Caldwell County,17,718,315,403
Texas,Caldwell County,18,723,256,467
Texas,Calhoun County,0,21561,11078,10483
Texas,Calhoun County,1,1426,745,681
Texas,Calhoun County,2,1390,687,703
Texas,Calhoun County,3,1484,764,720
Texas,Calhoun County,4,1487,791,696
Texas,Calhoun County,5,1286,682,604
Texas,Calhoun County,6,1433,792,641
Texas,Calhoun County,7,1287,700,587
Texas,Calhoun County,8,1333,663,670
Texas,Calhoun County,9,1158,591,567
Texas,Calhoun County,10,1232,628,604
Texas,Calhoun County,11,1334,691,643
Texas,Calhoun County,12,1461,765,696
Texas,Calhoun County,13,1380,670,710
Texas,Calhoun County,14,1262,652,610
Texas,Calhoun County,15,1004,522,482
Texas,Calhoun County,16,690,342,348
Texas,Calhoun County,17,471,213,258
Texas,Calhoun County,18,443,180,263
Texas,Callahan County,0,13994,6930,7064
Texas,Callahan County,1,840,451,389
Texas,Callahan County,2,814,413,401
Texas,Callahan County,3,918,485,433
Texas,Callahan County,4,854,426,428
Texas,Callahan County,5,642,317,325
Texas,Callahan County,6,769,389,380
Texas,Callahan County,7,803,393,410
Texas,Callahan County,8,833,420,413
Texas,Callahan County,9,814,392,422
Texas,Callahan County,10,816,379,437
Texas,Callahan County,11,858,443,415
Texas,Callahan County,12,1107,546,561
Texas,Callahan County,13,1057,498,559
Texas,Callahan County,14,899,437,462
Texas,Callahan County,15,745,388,357
Texas,Callahan County,16,507,240,267
Texas,Callahan County,17,367,177,190
Texas,Callahan County,18,351,136,215
Texas,Cameron County,0,423908,206353,217555
Texas,Cameron County,1,34371,17515,16856
Texas,Cameron County,2,35426,18068,17358
Texas,Cameron County,3,35980,18336,17644
Texas,Cameron County,4,36570,18650,17920
Texas,Cameron County,5,31189,16063,15126
Texas,Cameron County,6,28319,14422,13897
Texas,Cameron County,7,24326,12104,12222
Texas,Cameron County,8,25283,12370,12913
Texas,Cameron County,9,26243,12728,13515
Texas,Cameron County,10,25209,11658,13551
Texas,Cameron County,11,22288,10265,12023
Texas,Cameron County,12,21424,9859,11565
Texas,Cameron County,13,19865,8944,10921
Texas,Cameron County,14,17620,8126,9494
Texas,Cameron County,15,14679,6713,7966
Texas,Cameron County,16,10322,4537,5785
Texas,Cameron County,17,7479,3164,4315
Texas,Cameron County,18,7315,2831,4484
Texas,Camp County,0,13033,6329,6704
Texas,Camp County,1,975,497,478
Texas,Camp County,2,945,456,489
Texas,Camp County,3,1002,495,507
Texas,Camp County,4,861,411,450
Texas,Camp County,5,854,454,400
Texas,Camp County,6,755,360,395
Texas,Camp County,7,671,320,351
Texas,Camp County,8,718,327,391
Texas,Camp County,9,642,320,322
Texas,Camp County,10,728,319,409
Texas,Camp County,11,802,386,416
Texas,Camp County,12,832,416,416
Texas,Camp County,13,834,390,444
Texas,Camp County,14,825,418,407
Texas,Camp County,15,599,297,302
Texas,Camp County,16,434,207,227
Texas,Camp County,17,319,156,163
Texas,Camp County,18,237,100,137
Texas,Carson County,0,6005,3010,2995
Texas,Carson County,1,324,156,168
Texas,Carson County,2,391,214,177
Texas,Carson County,3,449,224,225
Texas,Carson County,4,418,214,204
Texas,Carson County,5,309,149,160
Texas,Carson County,6,315,162,153
Texas,Carson County,7,333,171,162
Texas,Carson County,8,377,191,186
Texas,Carson County,9,358,174,184
Texas,Carson County,10,317,162,155
Texas,Carson County,11,373,184,189
Texas,Carson County,12,421,219,202
Texas,Carson County,13,447,228,219
Texas,Carson County,14,367,187,180
Texas,Carson County,15,295,147,148
Texas,Carson County,16,221,103,118
Texas,Carson County,17,165,79,86
Texas,Carson County,18,125,46,79
Texas,Cass County,0,30119,14581,15538
Texas,Cass County,1,1800,958,842
Texas,Cass County,2,1822,921,901
Texas,Cass County,3,1958,985,973
Texas,Cass County,4,1873,994,879
Texas,Cass County,5,1549,802,747
Texas,Cass County,6,1577,769,808
Texas,Cass County,7,1492,679,813
Texas,Cass County,8,1656,786,870
Texas,Cass County,9,1617,750,867
Texas,Cass County,10,1874,895,979
Texas,Cass County,11,1954,957,997
Texas,Cass County,12,2115,1001,1114
Texas,Cass County,13,2172,1036,1136
Texas,Cass County,14,1917,944,973
Texas,Cass County,15,1775,848,927
Texas,Cass County,16,1362,635,727
Texas,Cass County,17,812,331,481
Texas,Cass County,18,794,290,504
Texas,Castro County,0,7665,3945,3720
Texas,Castro County,1,558,318,240
Texas,Castro County,2,617,330,287
Texas,Castro County,3,642,335,307
Texas,Castro County,4,580,287,293
Texas,Castro County,5,593,296,297
Texas,Castro County,6,451,218,233
Texas,Castro County,7,409,202,207
Texas,Castro County,8,453,238,215
Texas,Castro County,9,417,221,196
Texas,Castro County,10,391,218,173
Texas,Castro County,11,374,194,180
Texas,Castro County,12,473,246,227
Texas,Castro County,13,495,261,234
Texas,Castro County,14,358,185,173
Texas,Castro County,15,264,137,127
Texas,Castro County,16,224,106,118
Texas,Castro County,17,200,89,111
Texas,Castro County,18,166,64,102
Texas,Chambers County,0,42454,21505,20949
Texas,Chambers County,1,3004,1542,1462
Texas,Chambers County,2,3352,1697,1655
Texas,Chambers County,3,3436,1804,1632
Texas,Chambers County,4,3232,1719,1513
Texas,Chambers County,5,2532,1290,1242
Texas,Chambers County,6,2745,1407,1338
Texas,Chambers County,7,2889,1404,1485
Texas,Chambers County,8,3173,1665,1508
Texas,Chambers County,9,2870,1413,1457
Texas,Chambers County,10,2878,1439,1439
Texas,Chambers County,11,2585,1324,1261
Texas,Chambers County,12,2482,1286,1196
Texas,Chambers County,13,2266,1162,1104
Texas,Chambers County,14,1821,919,902
Texas,Chambers County,15,1425,664,761
Texas,Chambers County,16,820,389,431
Texas,Chambers County,17,515,225,290
Texas,Chambers County,18,429,156,273
Texas,Cherokee County,0,52592,26822,25770
Texas,Cherokee County,1,3744,1892,1852
Texas,Cherokee County,2,3619,1876,1743
Texas,Cherokee County,3,3729,1953,1776
Texas,Cherokee County,4,3869,2103,1766
Texas,Cherokee County,5,3322,1861,1461
Texas,Cherokee County,6,3250,1700,1550
Texas,Cherokee County,7,3035,1550,1485
Texas,Cherokee County,8,2899,1462,1437
Texas,Cherokee County,9,3095,1644,1451
Texas,Cherokee County,10,3245,1740,1505
Texas,Cherokee County,11,3114,1635,1479
Texas,Cherokee County,12,3260,1616,1644
Texas,Cherokee County,13,3180,1571,1609
Texas,Cherokee County,14,2928,1403,1525
Texas,Cherokee County,15,2424,1108,1316
Texas,Cherokee County,16,1734,823,911
Texas,Cherokee County,17,1094,516,578
Texas,Cherokee County,18,1051,369,682
Texas,Childress County,0,7291,4434,2857
Texas,Childress County,1,353,197,156
Texas,Childress County,2,398,202,196
Texas,Childress County,3,431,220,211
Texas,Childress County,4,419,254,165
Texas,Childress County,5,782,620,162
Texas,Childress County,6,879,716,163
Texas,Childress County,7,593,439,154
Texas,Childress County,8,495,322,173
Texas,Childress County,9,410,242,168
Texas,Childress County,10,339,194,145
Texas,Childress County,11,322,161,161
Texas,Childress County,12,379,184,195
Texas,Childress County,13,368,190,178
Texas,Childress County,14,323,159,164
Texas,Childress County,15,284,116,168
Texas,Childress County,16,232,109,123
Texas,Childress County,17,142,56,86
Texas,Childress County,18,142,53,89
Texas,Clay County,0,10456,5209,5247
Texas,Clay County,1,485,252,233
Texas,Clay County,2,556,266,290
Texas,Clay County,3,652,330,322
Texas,Clay County,4,619,314,305
Texas,Clay County,5,493,270,223
Texas,Clay County,6,505,242,263
Texas,Clay County,7,472,248,224
Texas,Clay County,8,598,290,308
Texas,Clay County,9,587,293,294
Texas,Clay County,10,622,297,325
Texas,Clay County,11,699,348,351
Texas,Clay County,12,911,453,458
Texas,Clay County,13,882,448,434
Texas,Clay County,14,760,376,384
Texas,Clay County,15,609,311,298
Texas,Clay County,16,434,207,227
Texas,Clay County,17,294,148,146
Texas,Clay County,18,278,116,162
Texas,Cochran County,0,2836,1423,1413
Texas,Cochran County,1,205,99,106
Texas,Cochran County,2,206,119,87
Texas,Cochran County,3,225,112,113
Texas,Cochran County,4,217,102,115
Texas,Cochran County,5,143,72,71
Texas,Cochran County,6,196,107,89
Texas,Cochran County,7,191,88,103
Texas,Cochran County,8,165,95,70
Texas,Cochran County,9,132,65,67
Texas,Cochran County,10,154,77,77
Texas,Cochran County,11,174,93,81
Texas,Cochran County,12,197,99,98
Texas,Cochran County,13,168,77,91
Texas,Cochran County,14,131,59,72
Texas,Cochran County,15,107,60,47
Texas,Cochran County,16,84,40,44
Texas,Cochran County,17,89,37,52
Texas,Cochran County,18,52,22,30
Texas,Coke County,0,3370,1666,1704
Texas,Coke County,1,197,114,83
Texas,Coke County,2,198,93,105
Texas,Coke County,3,175,90,85
Texas,Coke County,4,223,99,124
Texas,Coke County,5,153,73,80
Texas,Coke County,6,178,97,81
Texas,Coke County,7,170,96,74
Texas,Coke County,8,170,76,94
Texas,Coke County,9,146,76,70
Texas,Coke County,10,157,69,88
Texas,Coke County,11,208,98,110
Texas,Coke County,12,259,132,127
Texas,Coke County,13,217,112,105
Texas,Coke County,14,271,133,138
Texas,Coke County,15,219,99,120
Texas,Coke County,16,191,97,94
Texas,Coke County,17,140,74,66
Texas,Coke County,18,98,38,60
Texas,Coleman County,0,8397,4240,4157
Texas,Coleman County,1,436,238,198
Texas,Coleman County,2,481,224,257
Texas,Coleman County,3,521,265,256
Texas,Coleman County,4,512,263,249
Texas,Coleman County,5,375,221,154
Texas,Coleman County,6,393,187,206
Texas,Coleman County,7,383,192,191
Texas,Coleman County,8,421,212,209
Texas,Coleman County,9,450,219,231
Texas,Coleman County,10,474,235,239
Texas,Coleman County,11,492,273,219
Texas,Coleman County,12,692,338,354
Texas,Coleman County,13,671,351,320
Texas,Coleman County,14,626,285,341
Texas,Coleman County,15,576,304,272
Texas,Coleman County,16,361,185,176
Texas,Coleman County,17,300,144,156
Texas,Coleman County,18,233,104,129
Texas,Collin County,0,1005146,494802,510344
Texas,Collin County,1,62230,31716,30514
Texas,Collin County,2,71730,36597,35133
Texas,Collin County,3,79017,40191,38826
Texas,Collin County,4,72529,37541,34988
Texas,Collin County,5,57820,29284,28536
Texas,Collin County,6,60152,30020,30132
Texas,Collin County,7,68182,32878,35304
Texas,Collin County,8,78940,38102,40838
Texas,Collin County,9,80268,39064,41204
Texas,Collin County,10,81916,40900,41016
Texas,Collin County,11,69752,34855,34897
Texas,Collin County,12,63003,31664,31339
Texas,Collin County,13,48952,23461,25491
Texas,Collin County,14,38604,17301,21303
Texas,Collin County,15,30764,13950,16814
Texas,Collin County,16,19697,8673,11024
Texas,Collin County,17,11542,4942,6600
Texas,Collin County,18,10048,3663,6385
Texas,Collingsworth County,0,2962,1449,1513
Texas,Collingsworth County,1,179,85,94
Texas,Collingsworth County,2,253,125,128
Texas,Collingsworth County,3,220,111,109
Texas,Collingsworth County,4,211,113,98
Texas,Collingsworth County,5,179,94,85
Texas,Collingsworth County,6,159,80,79
Texas,Collingsworth County,7,169,78,91
Texas,Collingsworth County,8,180,97,83
Texas,Collingsworth County,9,145,71,74
Texas,Collingsworth County,10,157,75,82
Texas,Collingsworth County,11,170,85,85
Texas,Collingsworth County,12,196,101,95
Texas,Collingsworth County,13,185,86,99
Texas,Collingsworth County,14,173,83,90
Texas,Collingsworth County,15,137,63,74
Texas,Collingsworth County,16,99,40,59
Texas,Collingsworth County,17,76,35,41
Texas,Collingsworth County,18,74,27,47
Texas,Colorado County,0,21217,10665,10552
Texas,Colorado County,1,1366,683,683
Texas,Colorado County,2,1360,708,652
Texas,Colorado County,3,1299,679,620
Texas,Colorado County,4,1298,650,648
Texas,Colorado County,5,1206,626,580
Texas,Colorado County,6,1223,687,536
Texas,Colorado County,7,1051,562,489
Texas,Colorado County,8,1128,570,558
Texas,Colorado County,9,1050,534,516
Texas,Colorado County,10,1128,567,561
Texas,Colorado County,11,1278,641,637
Texas,Colorado County,12,1548,789,759
Texas,Colorado County,13,1584,782,802
Texas,Colorado County,14,1452,701,751
Texas,Colorado County,15,1143,567,576
Texas,Colorado County,16,898,429,469
Texas,Colorado County,17,558,269,289
Texas,Colorado County,18,647,221,426
Texas,Comal County,0,148373,73333,75040
Texas,Comal County,1,8630,4489,4141
Texas,Comal County,2,9133,4644,4489
Texas,Comal County,3,9863,4999,4864
Texas,Comal County,4,9318,4831,4487
Texas,Comal County,5,7949,4040,3909
Texas,Comal County,6,8252,4113,4139
Texas,Comal County,7,8786,4307,4479
Texas,Comal County,8,9258,4588,4670
Texas,Comal County,9,8706,4423,4283
Texas,Comal County,10,9891,4869,5022
Texas,Comal County,11,9954,4906,5048
Texas,Comal County,12,10952,5296,5656
Texas,Comal County,13,10852,5221,5631
Texas,Comal County,14,9387,4524,4863
Texas,Comal County,15,7381,3601,3780
Texas,Comal County,16,4555,2235,2320
Texas,Comal County,17,2866,1299,1567
Texas,Comal County,18,2640,948,1692
Texas,Comanche County,0,13534,6738,6796
Texas,Comanche County,1,757,386,371
Texas,Comanche County,2,845,449,396
Texas,Comanche County,3,906,443,463
Texas,Comanche County,4,795,411,384
Texas,Comanche County,5,709,388,321
Texas,Comanche County,6,683,336,347
Texas,Comanche County,7,653,342,311
Texas,Comanche County,8,683,338,345
Texas,Comanche County,9,681,329,352
Texas,Comanche County,10,787,375,412
Texas,Comanche County,11,912,471,441
Texas,Comanche County,12,919,465,454
Texas,Comanche County,13,915,450,465
Texas,Comanche County,14,953,477,476
Texas,Comanche County,15,854,400,454
Texas,Comanche County,16,666,315,351
Texas,Comanche County,17,449,216,233
Texas,Comanche County,18,367,147,220
Texas,Concho County,0,4276,3020,1256
Texas,Concho County,1,117,59,58
Texas,Concho County,2,111,70,41
Texas,Concho County,3,182,85,97
Texas,Concho County,4,160,98,62
Texas,Concho County,5,249,189,60
Texas,Concho County,6,372,316,56
Texas,Concho County,7,352,300,52
Texas,Concho County,8,404,344,60
Texas,Concho County,9,446,380,66
Texas,Concho County,10,368,306,62
Texas,Concho County,11,265,191,74
Texas,Concho County,12,258,167,91
Texas,Concho County,13,236,123,113
Texas,Concho County,14,235,121,114
Texas,Concho County,15,198,105,93
Texas,Concho County,16,142,79,63
Texas,Concho County,17,101,47,54
Texas,Concho County,18,80,40,40
Texas,Cooke County,0,40574,20262,20312
Texas,Cooke County,1,2779,1468,1311
Texas,Cooke County,2,2553,1292,1261
Texas,Cooke County,3,2625,1327,1298
Texas,Cooke County,4,2639,1474,1165
Texas,Cooke County,5,2510,1355,1155
Texas,Cooke County,6,2620,1327,1293
Texas,Cooke County,7,2311,1150,1161
Texas,Cooke County,8,2294,1128,1166
Texas,Cooke County,9,2148,1037,1111
Texas,Cooke County,10,2279,1102,1177
Texas,Cooke County,11,2524,1228,1296
Texas,Cooke County,12,2906,1426,1480
Texas,Cooke County,13,2866,1418,1448
Texas,Cooke County,14,2481,1237,1244
Texas,Cooke County,15,1935,907,1028
Texas,Cooke County,16,1395,670,725
Texas,Cooke County,17,890,377,513
Texas,Cooke County,18,819,339,480
Texas,Coryell County,0,74808,37143,37665
Texas,Coryell County,1,5108,2539,2569
Texas,Coryell County,2,4985,2512,2473
Texas,Coryell County,3,4454,2303,2151
Texas,Coryell County,4,4326,2313,2013
Texas,Coryell County,5,7580,4570,3010
Texas,Coryell County,6,7748,3982,3766
Texas,Coryell County,7,6769,3416,3353
Texas,Coryell County,8,5983,2922,3061
Texas,Coryell County,9,5118,2350,2768
Texas,Coryell County,10,4628,2133,2495
Texas,Coryell County,11,3797,1765,2032
Texas,Coryell County,12,3480,1617,1863
Texas,Coryell County,13,3163,1419,1744
Texas,Coryell County,14,2509,1151,1358
Texas,Coryell County,15,2081,883,1198
Texas,Coryell County,16,1458,625,833
Texas,Coryell County,17,935,369,566
Texas,Coryell County,18,686,274,412
Texas,Cottle County,0,1389,674,715
Texas,Cottle County,1,75,42,33
Texas,Cottle County,2,84,41,43
Texas,Cottle County,3,89,47,42
Texas,Cottle County,4,97,57,40
Texas,Cottle County,5,56,32,24
Texas,Cottle County,6,60,32,28
Texas,Cottle County,7,75,38,37
Texas,Cottle County,8,84,37,47
Texas,Cottle County,9,68,32,36
Texas,Cottle County,10,63,26,37
Texas,Cottle County,11,79,34,45
Texas,Cottle County,12,115,59,56
Texas,Cottle County,13,106,51,55
Texas,Cottle County,14,96,41,55
Texas,Cottle County,15,83,47,36
Texas,Cottle County,16,75,29,46
Texas,Cottle County,17,42,19,23
Texas,Cottle County,18,42,10,32
Texas,Crane County,0,4794,2415,2379
Texas,Crane County,1,382,211,171
Texas,Crane County,2,404,186,218
Texas,Crane County,3,398,202,196
Texas,Crane County,4,362,185,177
Texas,Crane County,5,316,159,157
Texas,Crane County,6,325,173,152
Texas,Crane County,7,299,169,130
Texas,Crane County,8,311,148,163
Texas,Crane County,9,294,153,141
Texas,Crane County,10,272,125,147
Texas,Crane County,11,281,149,132
Texas,Crane County,12,318,168,150
Texas,Crane County,13,260,130,130
Texas,Crane County,14,177,95,82
Texas,Crane County,15,131,57,74
Texas,Crane County,16,101,44,57
Texas,Crane County,17,83,32,51
Texas,Crane County,18,80,29,51
Texas,Crockett County,0,3499,1747,1752
Texas,Crockett County,1,235,120,115
Texas,Crockett County,2,248,125,123
Texas,Crockett County,3,248,115,133
Texas,Crockett County,4,209,103,106
Texas,Crockett County,5,188,83,105
Texas,Crockett County,6,192,93,99
Texas,Crockett County,7,193,107,86
Texas,Crockett County,8,235,110,125
Texas,Crockett County,9,203,112,91
Texas,Crockett County,10,217,118,99
Texas,Crockett County,11,228,109,119
Texas,Crockett County,12,225,124,101
Texas,Crockett County,13,258,138,120
Texas,Crockett County,14,188,87,101
Texas,Crockett County,15,168,79,89
Texas,Crockett County,16,127,50,77
Texas,Crockett County,17,74,46,28
Texas,Crockett County,18,63,28,35
Texas,Crosby County,0,5779,2857,2922
Texas,Crosby County,1,385,190,195
Texas,Crosby County,2,423,218,205
Texas,Crosby County,3,463,234,229
Texas,Crosby County,4,419,210,209
Texas,Crosby County,5,318,152,166
Texas,Crosby County,6,342,177,165
Texas,Crosby County,7,319,179,140
Texas,Crosby County,8,361,184,177
Texas,Crosby County,9,306,154,152
Texas,Crosby County,10,294,137,157
Texas,Crosby County,11,324,153,171
Texas,Crosby County,12,376,190,186
Texas,Crosby County,13,368,185,183
Texas,Crosby County,14,315,167,148
Texas,Crosby County,15,252,114,138
Texas,Crosby County,16,233,108,125
Texas,Crosby County,17,143,57,86
Texas,Crosby County,18,138,48,90
Texas,Culberson County,0,2204,1089,1115
Texas,Culberson County,1,155,87,68
Texas,Culberson County,2,115,56,59
Texas,Culberson County,3,138,66,72
Texas,Culberson County,4,138,71,67
Texas,Culberson County,5,143,80,63
Texas,Culberson County,6,141,78,63
Texas,Culberson County,7,115,57,58
Texas,Culberson County,8,118,65,53
Texas,Culberson County,9,93,44,49
Texas,Culberson County,10,123,56,67
Texas,Culberson County,11,149,68,81
Texas,Culberson County,12,151,77,74
Texas,Culberson County,13,152,71,81
Texas,Culberson County,14,145,65,80
Texas,Culberson County,15,120,57,63
Texas,Culberson County,16,74,36,38
Texas,Culberson County,17,65,20,45
Texas,Culberson County,18,69,35,34
Texas,Dallam County,0,7200,3754,3446
Texas,Dallam County,1,697,372,325
Texas,Dallam County,2,565,283,282
Texas,Dallam County,3,631,330,301
Texas,Dallam County,4,563,305,258
Texas,Dallam County,5,427,222,205
Texas,Dallam County,6,525,295,230
Texas,Dallam County,7,510,264,246
Texas,Dallam County,8,443,231,212
Texas,Dallam County,9,360,169,191
Texas,Dallam County,10,488,257,231
Texas,Dallam County,11,433,225,208
Texas,Dallam County,12,408,222,186
Texas,Dallam County,13,326,173,153
Texas,Dallam County,14,299,166,133
Texas,Dallam County,15,204,97,107
Texas,Dallam County,16,143,71,72
Texas,Dallam County,17,88,39,49
Texas,Dallam County,18,90,33,57
Texas,Dallas County,0,2637772,1301788,1335984
Texas,Dallas County,1,196910,100949,95961
Texas,Dallas County,2,189846,96801,93045
Texas,Dallas County,3,191891,97971,93920
Texas,Dallas County,4,178970,90759,88211
Texas,Dallas County,5,183602,92693,90909
Texas,Dallas County,6,228091,113757,114334
Texas,Dallas County,7,208358,105151,103207
Texas,Dallas County,8,190748,95597,95151
Texas,Dallas County,9,171293,84122,87171
Texas,Dallas County,10,168584,82708,85876
Texas,Dallas County,11,158615,79315,79300
Texas,Dallas County,12,155945,76737,79208
Texas,Dallas County,13,131765,63212,68553
Texas,Dallas County,14,100502,46201,54301
Texas,Dallas County,15,72903,32556,40347
Texas,Dallas County,16,47522,20340,27182
Texas,Dallas County,17,30392,12232,18160
Texas,Dallas County,18,31835,10687,21148
Texas,Dawson County,0,12619,6922,5697
Texas,Dawson County,1,875,447,428
Texas,Dawson County,2,907,456,451
Texas,Dawson County,3,935,502,433
Texas,Dawson County,4,866,470,396
Texas,Dawson County,5,917,609,308
Texas,Dawson County,6,1089,720,369
Texas,Dawson County,7,927,605,322
Texas,Dawson County,8,843,517,326
Texas,Dawson County,9,728,408,320
Texas,Dawson County,10,639,343,296
Texas,Dawson County,11,615,318,297
Texas,Dawson County,12,734,372,362
Texas,Dawson County,13,660,324,336
Texas,Dawson County,14,540,259,281
Texas,Dawson County,15,473,207,266
Texas,Dawson County,16,369,157,212
Texas,Dawson County,17,265,109,156
Texas,Dawson County,18,237,99,138
Texas,Deaf Smith County,0,18760,9369,9391
Texas,Deaf Smith County,1,1614,819,795
Texas,Deaf Smith County,2,1608,813,795
Texas,Deaf Smith County,3,1664,852,812
Texas,Deaf Smith County,4,1505,759,746
Texas,Deaf Smith County,5,1335,684,651
Texas,Deaf Smith County,6,1325,689,636
Texas,Deaf Smith County,7,1148,580,568
Texas,Deaf Smith County,8,1092,563,529
Texas,Deaf Smith County,9,1109,555,554
Texas,Deaf Smith County,10,1035,512,523
Texas,Deaf Smith County,11,1027,510,517
Texas,Deaf Smith County,12,962,495,467
Texas,Deaf Smith County,13,959,453,506
Texas,Deaf Smith County,14,834,415,419
Texas,Deaf Smith County,15,522,223,299
Texas,Deaf Smith County,16,388,202,186
Texas,Deaf Smith County,17,288,110,178
Texas,Deaf Smith County,18,345,135,210
Texas,Delta County,0,5349,2661,2688
Texas,Delta County,1,366,178,188
Texas,Delta County,2,334,151,183
Texas,Delta County,3,340,163,177
Texas,Delta County,4,328,183,145
Texas,Delta County,5,250,129,121
Texas,Delta County,6,316,154,162
Texas,Delta County,7,266,130,136
Texas,Delta County,8,330,168,162
Texas,Delta County,9,277,158,119
Texas,Delta County,10,317,149,168
Texas,Delta County,11,352,163,189
Texas,Delta County,12,339,177,162
Texas,Delta County,13,420,212,208
Texas,Delta County,14,345,158,187
Texas,Delta County,15,292,151,141
Texas,Delta County,16,254,135,119
Texas,Delta County,17,128,69,59
Texas,Delta County,18,95,33,62
Texas,Denton County,0,859064,422725,436339
Texas,Denton County,1,53959,27601,26358
Texas,Denton County,2,57574,29381,28193
Texas,Denton County,3,62873,32059,30814
Texas,Denton County,4,61150,30709,30441
Texas,Denton County,5,56181,27853,28328
Texas,Denton County,6,62402,30918,31484
Texas,Denton County,7,64566,31860,32706
Texas,Denton County,8,67065,32685,34380
Texas,Denton County,9,65056,31788,33268
Texas,Denton County,10,66831,33089,33742
Texas,Denton County,11,57573,28954,28619
Texas,Denton County,12,54102,26654,27448
Texas,Denton County,13,42318,20188,22130
Texas,Denton County,14,31809,14713,17096
Texas,Denton County,15,24579,11241,13338
Texas,Denton County,16,15080,6816,8264
Texas,Denton County,17,8529,3601,4928
Texas,Denton County,18,7417,2615,4802
Texas,DeWitt County,0,20187,10602,9585
Texas,DeWitt County,1,1275,655,620
Texas,DeWitt County,2,1257,664,593
Texas,DeWitt County,3,1235,657,578
Texas,DeWitt County,4,1182,617,565
Texas,DeWitt County,5,956,502,454
Texas,DeWitt County,6,1162,635,527
Texas,DeWitt County,7,1249,724,525
Texas,DeWitt County,8,1318,778,540
Texas,DeWitt County,9,1249,762,487
Texas,DeWitt County,10,1225,713,512
Texas,DeWitt County,11,1284,725,559
Texas,DeWitt County,12,1442,764,678
Texas,DeWitt County,13,1330,680,650
Texas,DeWitt County,14,1197,557,640
Texas,DeWitt County,15,979,460,519
Texas,DeWitt County,16,713,308,405
Texas,DeWitt County,17,562,223,339
Texas,DeWitt County,18,572,178,394
Texas,Dickens County,0,2249,1245,1004
Texas,Dickens County,1,116,47,69
Texas,Dickens County,2,106,56,50
Texas,Dickens County,3,122,63,59
Texas,Dickens County,4,145,85,60
Texas,Dickens County,5,124,86,38
Texas,Dickens County,6,162,127,35
Texas,Dickens County,7,147,108,39
Texas,Dickens County,8,133,73,60
Texas,Dickens County,9,158,92,66
Texas,Dickens County,10,122,73,49
Texas,Dickens County,11,97,47,50
Texas,Dickens County,12,148,79,69
Texas,Dickens County,13,156,85,71
Texas,Dickens County,14,136,52,84
Texas,Dickens County,15,132,59,73
Texas,Dickens County,16,119,53,66
Texas,Dickens County,17,70,32,38
Texas,Dickens County,18,56,28,28
Texas,Dimmit County,0,10308,5071,5237
Texas,Dimmit County,1,775,409,366
Texas,Dimmit County,2,868,467,401
Texas,Dimmit County,3,876,435,441
Texas,Dimmit County,4,766,372,394
Texas,Dimmit County,5,637,314,323
Texas,Dimmit County,6,638,327,311
Texas,Dimmit County,7,626,326,300
Texas,Dimmit County,8,613,305,308
Texas,Dimmit County,9,603,291,312
Texas,Dimmit County,10,525,252,273
Texas,Dimmit County,11,544,253,291
Texas,Dimmit County,12,575,293,282
Texas,Dimmit County,13,533,262,271
Texas,Dimmit County,14,525,226,299
Texas,Dimmit County,15,441,218,223
Texas,Dimmit County,16,296,125,171
Texas,Dimmit County,17,204,86,118
Texas,Dimmit County,18,263,110,153
Texas,Donley County,0,3319,1630,1689
Texas,Donley County,1,171,93,78
Texas,Donley County,2,177,89,88
Texas,Donley County,3,185,89,96
Texas,Donley County,4,326,169,157
Texas,Donley County,5,245,140,105
Texas,Donley County,6,149,72,77
Texas,Donley County,7,127,69,58
Texas,Donley County,8,197,96,101
Texas,Donley County,9,166,75,91
Texas,Donley County,10,139,71,68
Texas,Donley County,11,177,80,97
Texas,Donley County,12,219,116,103
Texas,Donley County,13,245,111,134
Texas,Donley County,14,242,120,122
Texas,Donley County,15,191,74,117
Texas,Donley County,16,160,77,83
Texas,Donley County,17,120,56,64
Texas,Donley County,18,83,33,50
Texas,Duval County,0,11212,5780,5432
Texas,Duval County,1,784,392,392
Texas,Duval County,2,817,414,403
Texas,Duval County,3,763,375,388
Texas,Duval County,4,746,387,359
Texas,Duval County,5,834,478,356
Texas,Duval County,6,767,476,291
Texas,Duval County,7,661,354,307
Texas,Duval County,8,665,360,305
Texas,Duval County,9,640,344,296
Texas,Duval County,10,631,335,296
Texas,Duval County,11,637,324,313
Texas,Duval County,12,672,340,332
Texas,Duval County,13,584,277,307
Texas,Duval County,14,509,258,251
Texas,Duval County,15,549,257,292
Texas,Duval County,16,440,206,234
Texas,Duval County,17,252,102,150
Texas,Duval County,18,261,101,160
Texas,Eastland County,0,18322,9149,9173
Texas,Eastland County,1,1112,571,541
Texas,Eastland County,2,983,505,478
Texas,Eastland County,3,1127,550,577
Texas,Eastland County,4,1402,782,620
Texas,Eastland County,5,1142,618,524
Texas,Eastland County,6,993,530,463
Texas,Eastland County,7,904,464,440
Texas,Eastland County,8,1045,515,530
Texas,Eastland County,9,917,468,449
Texas,Eastland County,10,951,455,496
Texas,Eastland County,11,1060,511,549
Texas,Eastland County,12,1358,667,691
Texas,Eastland County,13,1325,671,654
Texas,Eastland County,14,1137,564,573
Texas,Eastland County,15,1060,480,580
Texas,Eastland County,16,769,362,407
Texas,Eastland County,17,532,250,282
Texas,Eastland County,18,505,186,319
Texas,Ector County,0,162124,82485,79639
Texas,Ector County,1,14541,7450,7091
Texas,Ector County,2,14157,7207,6950
Texas,Ector County,3,12939,6628,6311
Texas,Ector County,4,11905,6031,5874
Texas,Ector County,5,11701,6145,5556
Texas,Ector County,6,14345,7636,6709
Texas,Ector County,7,13044,6983,6061
Texas,Ector County,8,11517,6140,5377
Texas,Ector County,9,9587,4989,4598
Texas,Ector County,10,8664,4365,4299
Texas,Ector County,11,8248,4143,4105
Texas,Ector County,12,8411,4141,4270
Texas,Ector County,13,7305,3631,3674
Texas,Ector County,14,5417,2650,2767
Texas,Ector County,15,3939,1824,2115
Texas,Ector County,16,2690,1116,1574
Texas,Ector County,17,1940,798,1142
Texas,Ector County,18,1774,608,1166
Texas,Edwards County,0,1928,1019,909
Texas,Edwards County,1,125,69,56
Texas,Edwards County,2,135,71,64
Texas,Edwards County,3,114,67,47
Texas,Edwards County,4,99,60,39
Texas,Edwards County,5,77,37,40
Texas,Edwards County,6,97,54,43
Texas,Edwards County,7,75,38,37
Texas,Edwards County,8,98,50,48
Texas,Edwards County,9,80,43,37
Texas,Edwards County,10,96,48,48
Texas,Edwards County,11,103,56,47
Texas,Edwards County,12,128,56,72
Texas,Edwards County,13,140,71,69
Texas,Edwards County,14,181,91,90
Texas,Edwards County,15,159,97,62
Texas,Edwards County,16,106,52,54
Texas,Edwards County,17,59,34,25
Texas,Edwards County,18,56,25,31
Texas,Ellis County,0,179436,88513,90923
Texas,Ellis County,1,12202,6247,5955
Texas,Ellis County,2,13039,6711,6328
Texas,Ellis County,3,14123,7275,6848
Texas,Ellis County,4,13291,6857,6434
Texas,Ellis County,5,11136,5795,5341
Texas,Ellis County,6,11415,5629,5786
Texas,Ellis County,7,11864,5715,6149
Texas,Ellis County,8,12158,5962,6196
Texas,Ellis County,9,11505,5472,6033
Texas,Ellis County,10,12258,6078,6180
Texas,Ellis County,11,11452,5721,5731
Texas,Ellis County,12,11640,5738,5902
Texas,Ellis County,13,10372,5075,5297
Texas,Ellis County,14,8151,3802,4349
Texas,Ellis County,15,6148,2843,3305
Texas,Ellis County,16,4095,1853,2242
Texas,Ellis County,17,2382,984,1398
Texas,Ellis County,18,2205,756,1449
Texas,El Paso County,0,840758,414214,426544
Texas,El Paso County,1,63036,32110,30926
Texas,El Paso County,2,62962,31897,31065
Texas,El Paso County,3,63413,31945,31468
Texas,El Paso County,4,63775,32780,30995
Texas,El Paso County,5,69248,37320,31928
Texas,El Paso County,6,68106,35971,32135
Texas,El Paso County,7,58209,30184,28025
Texas,El Paso County,8,53847,27046,26801
Texas,El Paso County,9,50841,24899,25942
Texas,El Paso County,10,50158,23884,26274
Texas,El Paso County,11,46191,21807,24384
Texas,El Paso County,12,46778,21610,25168
Texas,El Paso County,13,41102,18798,22304
Texas,El Paso County,14,32891,14917,17974
Texas,El Paso County,15,25584,11591,13993
Texas,El Paso County,16,17943,7489,10454
Texas,El Paso County,17,12958,5131,7827
Texas,El Paso County,18,13716,4835,8881
Texas,Erath County,0,42446,20784,21662
Texas,Erath County,1,2415,1219,1196
Texas,Erath County,2,2349,1208,1141
Texas,Erath County,3,2460,1282,1178
Texas,Erath County,4,4714,2158,2556
Texas,Erath County,5,5770,2828,2942
Texas,Erath County,6,2962,1488,1474
Texas,Erath County,7,2447,1245,1202
Texas,Erath County,8,2264,1092,1172
Texas,Erath County,9,2085,1046,1039
Texas,Erath County,10,2106,1026,1080
Texas,Erath County,11,2157,1077,1080
Texas,Erath County,12,2469,1253,1216
Texas,Erath County,13,2233,1119,1114
Texas,Erath County,14,1935,917,1018
Texas,Erath County,15,1568,750,818
Texas,Erath County,16,1002,472,530
Texas,Erath County,17,751,340,411
Texas,Erath County,18,759,264,495
Texas,Falls County,0,17335,8230,9105
Texas,Falls County,1,1047,520,527
Texas,Falls County,2,1015,517,498
Texas,Falls County,3,974,507,467
Texas,Falls County,4,932,498,434
Texas,Falls County,5,1129,582,547
Texas,Falls County,6,1282,582,700
Texas,Falls County,7,1225,537,688
Texas,Falls County,8,1127,466,661
Texas,Falls County,9,964,406,558
Texas,Falls County,10,1033,463,570
Texas,Falls County,11,1153,537,616
Texas,Falls County,12,1202,557,645
Texas,Falls County,13,1105,566,539
Texas,Falls County,14,985,488,497
Texas,Falls County,15,759,360,399
Texas,Falls County,16,595,284,311
Texas,Falls County,17,419,191,228
Texas,Falls County,18,389,169,220
Texas,Fannin County,0,35286,18731,16555
Texas,Fannin County,1,1874,1015,859
Texas,Fannin County,2,2066,1059,1007
Texas,Fannin County,3,2301,1199,1102
Texas,Fannin County,4,2097,1094,1003
Texas,Fannin County,5,2116,1294,822
Texas,Fannin County,6,2376,1402,974
Texas,Fannin County,7,2125,1226,899
Texas,Fannin County,8,2242,1270,972
Texas,Fannin County,9,2109,1141,968
Texas,Fannin County,10,2297,1217,1080
Texas,Fannin County,11,2299,1248,1051
Texas,Fannin County,12,2521,1261,1260
Texas,Fannin County,13,2331,1197,1134
Texas,Fannin County,14,2030,999,1031
Texas,Fannin County,15,1721,846,875
Texas,Fannin County,16,1217,553,664
Texas,Fannin County,17,853,415,438
Texas,Fannin County,18,711,295,416
Texas,Fayette County,0,25349,12456,12893
Texas,Fayette County,1,1270,623,647
Texas,Fayette County,2,1390,680,710
Texas,Fayette County,3,1559,826,733
Texas,Fayette County,4,1395,678,717
Texas,Fayette County,5,1291,665,626
Texas,Fayette County,6,1240,623,617
Texas,Fayette County,7,1185,560,625
Texas,Fayette County,8,1390,690,700
Texas,Fayette County,9,1268,641,627
Texas,Fayette County,10,1340,696,644
Texas,Fayette County,11,1515,737,778
Texas,Fayette County,12,2015,965,1050
Texas,Fayette County,13,2060,1047,1013
Texas,Fayette County,14,1919,946,973
Texas,Fayette County,15,1579,791,788
Texas,Fayette County,16,1216,585,631
Texas,Fayette County,17,823,391,432
Texas,Fayette County,18,894,312,582
Texas,Fisher County,0,3839,1903,1936
Texas,Fisher County,1,211,115,96
Texas,Fisher County,2,235,101,134
Texas,Fisher County,3,246,124,122
Texas,Fisher County,4,202,114,88
Texas,Fisher County,5,186,95,91
Texas,Fisher County,6,215,109,106
Texas,Fisher County,7,211,105,106
Texas,Fisher County,8,189,100,89
Texas,Fisher County,9,183,89,94
Texas,Fisher County,10,220,108,112
Texas,Fisher County,11,229,123,106
Texas,Fisher County,12,276,146,130
Texas,Fisher County,13,293,145,148
Texas,Fisher County,14,276,128,148
Texas,Fisher County,15,201,115,86
Texas,Fisher County,16,170,63,107
Texas,Fisher County,17,159,69,90
Texas,Fisher County,18,137,54,83
Texas,Floyd County,0,5837,2942,2895
Texas,Floyd County,1,378,193,185
Texas,Floyd County,2,450,225,225
Texas,Floyd County,3,482,261,221
Texas,Floyd County,4,419,232,187
Texas,Floyd County,5,360,178,182
Texas,Floyd County,6,360,185,175
Texas,Floyd County,7,289,156,133
Texas,Floyd County,8,352,171,181
Texas,Floyd County,9,303,153,150
Texas,Floyd County,10,336,175,161
Texas,Floyd County,11,317,162,155
Texas,Floyd County,12,367,167,200
Texas,Floyd County,13,332,179,153
Texas,Floyd County,14,308,151,157
Texas,Floyd County,15,242,113,129
Texas,Floyd County,16,232,100,132
Texas,Floyd County,17,148,65,83
Texas,Floyd County,18,162,76,86
Texas,Foard County,0,1200,583,617
Texas,Foard County,1,45,24,21
Texas,Foard County,2,77,32,45
Texas,Foard County,3,70,40,30
Texas,Foard County,4,75,37,38
Texas,Foard County,5,63,27,36
Texas,Foard County,6,50,25,25
Texas,Foard County,7,59,27,32
Texas,Foard County,8,57,30,27
Texas,Foard County,9,47,20,27
Texas,Foard County,10,69,34,35
Texas,Foard County,11,97,51,46
Texas,Foard County,12,97,55,42
Texas,Foard County,13,78,38,40
Texas,Foard County,14,79,45,34
Texas,Foard County,15,73,27,46
Texas,Foard County,16,68,37,31
Texas,Foard County,17,49,17,32
Texas,Foard County,18,47,17,30
Texas,Fort Bend County,0,787858,386599,401259
Texas,Fort Bend County,1,54653,27615,27038
Texas,Fort Bend County,2,60354,31056,29298
Texas,Fort Bend County,3,63286,32274,31012
Texas,Fort Bend County,4,58250,29695,28555
Texas,Fort Bend County,5,45005,22794,22211
Texas,Fort Bend County,6,44605,21948,22657
Texas,Fort Bend County,7,50284,23614,26670
Texas,Fort Bend County,8,60224,28642,31582
Texas,Fort Bend County,9,60045,29033,31012
Texas,Fort Bend County,10,59787,29297,30490
Texas,Fort Bend County,11,50884,25144,25740
Texas,Fort Bend County,12,49016,24004,25012
Texas,Fort Bend County,13,44337,21521,22816
Texas,Fort Bend County,14,34339,16354,17985
Texas,Fort Bend County,15,23511,11091,12420
Texas,Fort Bend County,16,13780,6397,7383
Texas,Fort Bend County,17,7889,3366,4523
Texas,Fort Bend County,18,7609,2754,4855
Texas,Franklin County,0,10766,5350,5416
Texas,Franklin County,1,579,298,281
Texas,Franklin County,2,667,334,333
Texas,Franklin County,3,808,409,399
Texas,Franklin County,4,695,353,342
Texas,Franklin County,5,527,265,262
Texas,Franklin County,6,552,293,259
Texas,Franklin County,7,617,298,319
Texas,Franklin County,8,587,287,300
Texas,Franklin County,9,541,273,268
Texas,Franklin County,10,622,326,296
Texas,Franklin County,11,677,319,358
Texas,Franklin County,12,805,416,389
Texas,Franklin County,13,737,376,361
Texas,Franklin County,14,703,338,365
Texas,Franklin County,15,629,294,335
Texas,Franklin County,16,454,221,233
Texas,Franklin County,17,292,144,148
Texas,Franklin County,18,274,106,168
Texas,Freestone County,0,19808,10281,9527
Texas,Freestone County,1,1139,546,593
Texas,Freestone County,2,1220,611,609
Texas,Freestone County,3,1319,689,630
Texas,Freestone County,4,1306,686,620
Texas,Freestone County,5,907,472,435
Texas,Freestone County,6,1036,580,456
Texas,Freestone County,7,1168,643,525
Texas,Freestone County,8,1287,732,555
Texas,Freestone County,9,1344,783,561
Texas,Freestone County,10,1326,759,567
Texas,Freestone County,11,1195,638,557
Texas,Freestone County,12,1294,695,599
Texas,Freestone County,13,1329,647,682
Texas,Freestone County,14,1225,594,631
Texas,Freestone County,15,999,466,533
Texas,Freestone County,16,727,349,378
Texas,Freestone County,17,499,225,274
Texas,Freestone County,18,488,166,322
Texas,Frio County,0,19816,11753,8063
Texas,Frio County,1,1263,620,643
Texas,Frio County,2,1282,657,625
Texas,Frio County,3,1238,646,592
Texas,Frio County,4,1451,800,651
Texas,Frio County,5,2008,1491,517
Texas,Frio County,6,2058,1537,521
Texas,Frio County,7,1693,1220,473
Texas,Frio County,8,1394,917,477
Texas,Frio County,9,1129,681,448
Texas,Frio County,10,1040,602,438
Texas,Frio County,11,1063,575,488
Texas,Frio County,12,928,489,439
Texas,Frio County,13,834,421,413
Texas,Frio County,14,777,374,403
Texas,Frio County,15,658,315,343
Texas,Frio County,16,419,190,229
Texas,Frio County,17,311,130,181
Texas,Frio County,18,270,88,182
Texas,Gaines County,0,20901,10598,10303
Texas,Gaines County,1,2163,1081,1082
Texas,Gaines County,2,2069,1064,1005
Texas,Gaines County,3,2090,1004,1086
Texas,Gaines County,4,1781,889,892
Texas,Gaines County,5,1352,693,659
Texas,Gaines County,6,1442,764,678
Texas,Gaines County,7,1444,777,667
Texas,Gaines County,8,1281,663,618
Texas,Gaines County,9,1222,617,605
Texas,Gaines County,10,1073,540,533
Texas,Gaines County,11,1092,571,521
Texas,Gaines County,12,1177,595,582
Texas,Gaines County,13,862,469,393
Texas,Gaines County,14,615,299,316
Texas,Gaines County,15,441,225,216
Texas,Gaines County,16,302,133,169
Texas,Gaines County,17,279,126,153
Texas,Gaines County,18,216,88,128
Texas,Galveston County,0,337890,166132,171758
Texas,Galveston County,1,21536,10960,10576
Texas,Galveston County,2,22521,11489,11032
Texas,Galveston County,3,23749,12140,11609
Texas,Galveston County,4,22631,11660,10971
Texas,Galveston County,5,19759,10104,9655
Texas,Galveston County,6,22503,11197,11306
Texas,Galveston County,7,22696,11122,11574
Texas,Galveston County,8,23214,11388,11826
Texas,Galveston County,9,21339,10386,10953
Texas,Galveston County,10,22078,10789,11289
Texas,Galveston County,11,21817,10546,11271
Texas,Galveston County,12,23907,11648,12259
Texas,Galveston County,13,21535,10630,10905
Texas,Galveston County,14,17265,8271,8994
Texas,Galveston County,15,12774,6111,6663
Texas,Galveston County,16,8230,3678,4552
Texas,Galveston County,17,5259,2190,3069
Texas,Galveston County,18,5077,1823,3254
Texas,Garza County,0,6578,4355,2223
Texas,Garza County,1,302,146,156
Texas,Garza County,2,294,157,137
Texas,Garza County,3,310,152,158
Texas,Garza County,4,441,311,130
Texas,Garza County,5,688,572,116
Texas,Garza County,6,848,659,189
Texas,Garza County,7,560,417,143
Texas,Garza County,8,356,246,110
Texas,Garza County,9,400,260,140
Texas,Garza County,10,564,409,155
Texas,Garza County,11,352,220,132
Texas,Garza County,12,470,325,145
Texas,Garza County,13,264,152,112
Texas,Garza County,14,192,76,116
Texas,Garza County,15,178,82,96
Texas,Garza County,16,147,71,76
Texas,Garza County,17,125,68,57
Texas,Garza County,18,87,32,55
Texas,Gillespie County,0,26804,13054,13750
Texas,Gillespie County,1,1341,694,647
Texas,Gillespie County,2,1481,748,733
Texas,Gillespie County,3,1556,813,743
Texas,Gillespie County,4,1490,780,710
Texas,Gillespie County,5,1249,651,598
Texas,Gillespie County,6,1175,594,581
Texas,Gillespie County,7,1183,594,589
Texas,Gillespie County,8,1338,654,684
Texas,Gillespie County,9,1219,573,646
Texas,Gillespie County,10,1340,639,701
Texas,Gillespie County,11,1452,702,750
Texas,Gillespie County,12,1917,905,1012
Texas,Gillespie County,13,2096,958,1138
Texas,Gillespie County,14,2195,1029,1166
Texas,Gillespie County,15,2003,967,1036
Texas,Gillespie County,16,1566,768,798
Texas,Gillespie County,17,1064,541,523
Texas,Gillespie County,18,1139,444,695
Texas,Glasscock County,0,1388,765,623
Texas,Glasscock County,1,90,44,46
Texas,Glasscock County,2,104,62,42
Texas,Glasscock County,3,101,52,49
Texas,Glasscock County,4,104,61,43
Texas,Glasscock County,5,88,52,36
Texas,Glasscock County,6,83,43,40
Texas,Glasscock County,7,84,62,22
Texas,Glasscock County,8,97,46,51
Texas,Glasscock County,9,88,48,40
Texas,Glasscock County,10,95,51,44
Texas,Glasscock County,11,77,42,35
Texas,Glasscock County,12,88,44,44
Texas,Glasscock County,13,78,43,35
Texas,Glasscock County,14,73,41,32
Texas,Glasscock County,15,47,27,20
Texas,Glasscock County,16,40,19,21
Texas,Glasscock County,17,32,18,14
Texas,Glasscock County,18,19,10,9
Texas,Goliad County,0,7584,3756,3828
Texas,Goliad County,1,425,214,211
Texas,Goliad County,2,409,190,219
Texas,Goliad County,3,466,251,215
Texas,Goliad County,4,477,245,232
Texas,Goliad County,5,377,202,175
Texas,Goliad County,6,382,196,186
Texas,Goliad County,7,396,195,201
Texas,Goliad County,8,412,210,202
Texas,Goliad County,9,405,190,215
Texas,Goliad County,10,443,225,218
Texas,Goliad County,11,465,224,241
Texas,Goliad County,12,569,279,290
Texas,Goliad County,13,620,303,317
Texas,Goliad County,14,571,291,280
Texas,Goliad County,15,453,231,222
Texas,Goliad County,16,298,133,165
Texas,Goliad County,17,201,97,104
Texas,Goliad County,18,215,80,135
Texas,Gonzales County,0,20826,10517,10309
Texas,Gonzales County,1,1525,763,762
Texas,Gonzales County,2,1504,815,689
Texas,Gonzales County,3,1620,856,764
Texas,Gonzales County,4,1545,792,753
Texas,Gonzales County,5,1188,652,536
Texas,Gonzales County,6,1312,671,641
Texas,Gonzales County,7,1214,599,615
Texas,Gonzales County,8,1212,624,588
Texas,Gonzales County,9,1120,556,564
Texas,Gonzales County,10,1195,563,632
Texas,Gonzales County,11,1201,617,584
Texas,Gonzales County,12,1410,705,705
Texas,Gonzales County,13,1297,667,630
Texas,Gonzales County,14,1020,527,493
Texas,Gonzales County,15,872,403,469
Texas,Gonzales County,16,701,334,367
Texas,Gonzales County,17,480,216,264
Texas,Gonzales County,18,410,157,253
Texas,Gray County,0,21895,11615,10280
Texas,Gray County,1,1508,799,709
Texas,Gray County,2,1606,838,768
Texas,Gray County,3,1624,803,821
Texas,Gray County,4,1373,710,663
Texas,Gray County,5,1194,646,548
Texas,Gray County,6,1481,855,626
Texas,Gray County,7,1433,793,640
Texas,Gray County,8,1500,850,650
Texas,Gray County,9,1357,801,556
Texas,Gray County,10,1388,831,557
Texas,Gray County,11,1267,743,524
Texas,Gray County,12,1386,721,665
Texas,Gray County,13,1227,614,613
Texas,Gray County,14,1050,529,521
Texas,Gray County,15,841,393,448
Texas,Gray County,16,693,299,394
Texas,Gray County,17,470,190,280
Texas,Gray County,18,497,200,297
Texas,Grayson County,0,133991,65368,68623
Texas,Grayson County,1,8595,4337,4258
Texas,Grayson County,2,8796,4580,4216
Texas,Grayson County,3,9168,4675,4493
Texas,Grayson County,4,8737,4440,4297
Texas,Grayson County,5,7837,3961,3876
Texas,Grayson County,6,8624,4278,4346
Texas,Grayson County,7,7984,3889,4095
Texas,Grayson County,8,8182,3991,4191
Texas,Grayson County,9,7398,3643,3755
Texas,Grayson County,10,8124,3969,4155
Texas,Grayson County,11,8362,4056,4306
Texas,Grayson County,12,9427,4558,4869
Texas,Grayson County,13,9140,4357,4783
Texas,Grayson County,14,7501,3549,3952
Texas,Grayson County,15,6334,2982,3352
Texas,Grayson County,16,4293,1975,2318
Texas,Grayson County,17,2786,1174,1612
Texas,Grayson County,18,2703,954,1749
Texas,Gregg County,0,123707,60112,63595
Texas,Gregg County,1,8835,4568,4267
Texas,Gregg County,2,9031,4567,4464
Texas,Gregg County,3,8979,4612,4367
Texas,Gregg County,4,8377,4407,3970
Texas,Gregg County,5,8295,4200,4095
Texas,Gregg County,6,8872,4341,4531
Texas,Gregg County,7,8132,4013,4119
Texas,Gregg County,8,7931,3949,3982
Texas,Gregg County,9,6933,3436,3497
Texas,Gregg County,10,7213,3371,3842
Texas,Gregg County,11,6937,3326,3611
Texas,Gregg County,12,7752,3684,4068
Texas,Gregg County,13,7404,3563,3841
Texas,Gregg County,14,5946,2768,3178
Texas,Gregg County,15,4654,2056,2598
Texas,Gregg County,16,3399,1426,1973
Texas,Gregg County,17,2436,939,1497
Texas,Gregg County,18,2581,886,1695
Texas,Grimes County,0,28360,15432,12928
Texas,Grimes County,1,1698,835,863
Texas,Grimes County,2,1667,884,783
Texas,Grimes County,3,1837,963,874
Texas,Grimes County,4,1781,913,868
Texas,Grimes County,5,1621,985,636
Texas,Grimes County,6,1885,1152,733
Texas,Grimes County,7,1774,1019,755
Texas,Grimes County,8,1744,1003,741
Texas,Grimes County,9,1683,967,716
Texas,Grimes County,10,1797,1062,735
Texas,Grimes County,11,1898,1054,844
Texas,Grimes County,12,2062,1114,948
Texas,Grimes County,13,1984,1055,929
Texas,Grimes County,14,1670,882,788
Texas,Grimes County,15,1357,690,667
Texas,Grimes County,16,868,442,426
Texas,Grimes County,17,522,230,292
Texas,Grimes County,18,512,182,330
Texas,Guadalupe County,0,163694,81018,82676
Texas,Guadalupe County,1,10259,5209,5050
Texas,Guadalupe County,2,11448,5875,5573
Texas,Guadalupe County,3,11906,6092,5814
Texas,Guadalupe County,4,11959,6082,5877
Texas,Guadalupe County,5,9969,5146,4823
Texas,Guadalupe County,6,9976,4977,4999
Texas,Guadalupe County,7,11169,5600,5569
Texas,Guadalupe County,8,12223,6154,6069
Texas,Guadalupe County,9,11177,5564,5613
Texas,Guadalupe County,10,11175,5544,5631
Texas,Guadalupe County,11,10628,5315,5313
Texas,Guadalupe County,12,10380,5014,5366
Texas,Guadalupe County,13,8814,4161,4653
Texas,Guadalupe County,14,7491,3548,3943
Texas,Guadalupe County,15,6060,2869,3191
Texas,Guadalupe County,16,4045,1839,2206
Texas,Guadalupe County,17,2619,1113,1506
Texas,Guadalupe County,18,2396,916,1480
Texas,Hale County,0,33830,17658,16172
Texas,Hale County,1,2258,1177,1081
Texas,Hale County,2,2677,1304,1373
Texas,Hale County,3,2674,1370,1304
Texas,Hale County,4,2670,1377,1293
Texas,Hale County,5,2723,1612,1111
Texas,Hale County,6,2450,1412,1038
Texas,Hale County,7,2281,1286,995
Texas,Hale County,8,2178,1178,1000
Texas,Hale County,9,1817,955,862
Texas,Hale County,10,1919,1025,894
Texas,Hale County,11,1924,999,925
Texas,Hale County,12,1931,982,949
Texas,Hale County,13,1783,879,904
Texas,Hale County,14,1377,683,694
Texas,Hale County,15,1097,517,580
Texas,Hale County,16,875,394,481
Texas,Hale County,17,598,257,341
Texas,Hale County,18,598,251,347
Texas,Hall County,0,3028,1499,1529
Texas,Hall County,1,143,74,69
Texas,Hall County,2,200,88,112
Texas,Hall County,3,205,111,94
Texas,Hall County,4,229,126,103
Texas,Hall County,5,166,86,80
Texas,Hall County,6,168,91,77
Texas,Hall County,7,134,70,64
Texas,Hall County,8,167,82,85
Texas,Hall County,9,142,55,87
Texas,Hall County,10,161,70,91
Texas,Hall County,11,179,98,81
Texas,Hall County,12,220,112,108
Texas,Hall County,13,213,106,107
Texas,Hall County,14,184,83,101
Texas,Hall County,15,173,86,87
Texas,Hall County,16,143,65,78
Texas,Hall County,17,105,50,55
Texas,Hall County,18,96,46,50
Texas,Hamilton County,0,8484,4218,4266
Texas,Hamilton County,1,514,260,254
Texas,Hamilton County,2,534,281,253
Texas,Hamilton County,3,493,264,229
Texas,Hamilton County,4,499,261,238
Texas,Hamilton County,5,393,217,176
Texas,Hamilton County,6,489,240,249
Texas,Hamilton County,7,453,242,211
Texas,Hamilton County,8,421,226,195
Texas,Hamilton County,9,419,205,214
Texas,Hamilton County,10,445,212,233
Texas,Hamilton County,11,471,243,228
Texas,Hamilton County,12,632,307,325
Texas,Hamilton County,13,609,302,307
Texas,Hamilton County,14,571,281,290
Texas,Hamilton County,15,493,226,267
Texas,Hamilton County,16,432,213,219
Texas,Hamilton County,17,289,134,155
Texas,Hamilton County,18,327,104,223
Texas,Hansford County,0,5463,2785,2678
Texas,Hansford County,1,416,223,193
Texas,Hansford County,2,404,221,183
Texas,Hansford County,3,495,269,226
Texas,Hansford County,4,441,229,212
Texas,Hansford County,5,313,150,163
Texas,Hansford County,6,383,194,189
Texas,Hansford County,7,311,173,138
Texas,Hansford County,8,293,133,160
Texas,Hansford County,9,320,160,160
Texas,Hansford County,10,309,165,144
Texas,Hansford County,11,329,175,154
Texas,Hansford County,12,343,186,157
Texas,Hansford County,13,299,155,144
Texas,Hansford County,14,244,129,115
Texas,Hansford County,15,183,84,99
Texas,Hansford County,16,149,67,82
Texas,Hansford County,17,116,40,76
Texas,Hansford County,18,115,32,83
Texas,Hardeman County,0,3922,1984,1938
Texas,Hardeman County,1,200,116,84
Texas,Hardeman County,2,228,117,111
Texas,Hardeman County,3,262,144,118
Texas,Hardeman County,4,239,125,114
Texas,Hardeman County,5,202,116,86
Texas,Hardeman County,6,197,94,103
Texas,Hardeman County,7,210,116,94
Texas,Hardeman County,8,244,122,122
Texas,Hardeman County,9,223,106,117
Texas,Hardeman County,10,257,135,122
Texas,Hardeman County,11,240,118,122
Texas,Hardeman County,12,247,123,124
Texas,Hardeman County,13,291,145,146
Texas,Hardeman County,14,269,138,131
Texas,Hardeman County,15,214,80,134
Texas,Hardeman County,16,174,91,83
Texas,Hardeman County,17,108,53,55
Texas,Hardeman County,18,117,45,72
Texas,Hardin County,0,57207,28188,29019
Texas,Hardin County,1,3725,1917,1808
Texas,Hardin County,2,3919,2035,1884
Texas,Hardin County,3,4044,2085,1959
Texas,Hardin County,4,3613,1859,1754
Texas,Hardin County,5,3062,1587,1475
Texas,Hardin County,6,3645,1831,1814
Texas,Hardin County,7,3554,1729,1825
Texas,Hardin County,8,3782,1902,1880
Texas,Hardin County,9,3344,1602,1742
Texas,Hardin County,10,3610,1797,1813
Texas,Hardin County,11,3580,1758,1822
Texas,Hardin County,12,3986,1972,2014
Texas,Hardin County,13,3815,1866,1949
Texas,Hardin County,14,3102,1477,1625
Texas,Hardin County,15,2486,1150,1336
Texas,Hardin County,16,1759,769,990
Texas,Hardin County,17,1112,455,657
Texas,Hardin County,18,1069,397,672
Texas,Harris County,0,4698619,2333866,2364753
Texas,Harris County,1,354882,180819,174063
Texas,Harris County,2,347924,176270,171654
Texas,Harris County,3,347033,177043,169990
Texas,Harris County,4,322735,165763,156972
Texas,Harris County,5,315119,159372,155747
Texas,Harris County,6,383316,192775,190541
Texas,Harris County,7,373203,189332,183871
Texas,Harris County,8,354961,179746,175215
Texas,Harris County,9,316139,158759,157380
Texas,Harris County,10,307728,152681,155047
Texas,Harris County,11,276851,136998,139853
Texas,Harris County,12,268462,131507,136955
Texas,Harris County,13,236002,114037,121965
Texas,Harris County,14,180600,84360,96240
Texas,Harris County,15,128764,59216,69548
Texas,Harris County,16,82124,36077,46047
Texas,Harris County,17,51445,20917,30528
Texas,Harris County,18,51331,18194,33137
Texas,Harrison County,0,66726,32660,34066
Texas,Harrison County,1,4301,2181,2120
Texas,Harrison County,2,4651,2366,2285
Texas,Harrison County,3,4997,2534,2463
Texas,Harrison County,4,4634,2385,2249
Texas,Harrison County,5,3997,2038,1959
Texas,Harrison County,6,3963,1964,1999
Texas,Harrison County,7,4004,1903,2101
Texas,Harrison County,8,4185,2021,2164
Texas,Harrison County,9,3739,1854,1885
Texas,Harrison County,10,4065,2010,2055
Texas,Harrison County,11,4009,1892,2117
Texas,Harrison County,12,4508,2238,2270
Texas,Harrison County,13,4396,2197,2199
Texas,Harrison County,14,3703,1736,1967
Texas,Harrison County,15,3003,1425,1578
Texas,Harrison County,16,1998,939,1059
Texas,Harrison County,17,1328,538,790
Texas,Harrison County,18,1245,439,806
Texas,Hartley County,0,5619,3365,2254
Texas,Hartley County,1,301,161,140
Texas,Hartley County,2,338,169,169
Texas,Hartley County,3,343,175,168
Texas,Hartley County,4,327,167,160
Texas,Hartley County,5,264,135,129
Texas,Hartley County,6,401,264,137
Texas,Hartley County,7,410,301,109
Texas,Hartley County,8,418,302,116
Texas,Hartley County,9,476,344,132
Texas,Hartley County,10,491,341,150
Texas,Hartley County,11,381,271,110
Texas,Hartley County,12,352,195,157
Texas,Hartley County,13,263,146,117
Texas,Hartley County,14,209,105,104
Texas,Hartley County,15,217,102,115
Texas,Hartley County,16,197,94,103
Texas,Hartley County,17,106,44,62
Texas,Hartley County,18,125,49,76
Texas,Haskell County,0,5813,3108,2705
Texas,Haskell County,1,224,109,115
Texas,Haskell County,2,305,154,151
Texas,Haskell County,3,318,161,157
Texas,Haskell County,4,388,221,167
Texas,Haskell County,5,411,264,147
Texas,Haskell County,6,402,247,155
Texas,Haskell County,7,410,242,168
Texas,Haskell County,8,355,222,133
Texas,Haskell County,9,310,168,142
Texas,Haskell County,10,287,161,126
Texas,Haskell County,11,317,159,158
Texas,Haskell County,12,415,207,208
Texas,Haskell County,13,394,193,201
Texas,Haskell County,14,377,196,181
Texas,Haskell County,15,323,154,169
Texas,Haskell County,16,227,105,122
Texas,Haskell County,17,170,82,88
Texas,Haskell County,18,180,63,117
Texas,Hays County,0,222631,110756,111875
Texas,Hays County,1,13905,7176,6729
Texas,Hays County,2,14098,7094,7004
Texas,Hays County,3,14687,7514,7173
Texas,Hays County,4,18003,8853,9150
Texas,Hays County,5,27291,13384,13907
Texas,Hays County,6,16432,8669,7763
Texas,Hays County,7,15674,8124,7550
Texas,Hays County,8,16184,8145,8039
Texas,Hays County,9,13931,7095,6836
Texas,Hays County,10,13381,6714,6667
Texas,Hays County,11,11789,5828,5961
Texas,Hays County,12,11901,5824,6077
Texas,Hays County,13,10891,5106,5785
Texas,Hays County,14,9268,4457,4811
Texas,Hays County,15,6787,3220,3567
Texas,Hays County,16,3905,1770,2135
Texas,Hays County,17,2410,1050,1360
Texas,Hays County,18,2094,733,1361
Texas,Hemphill County,0,3825,1920,1905
Texas,Hemphill County,1,258,136,122
Texas,Hemphill County,2,295,169,126
Texas,Hemphill County,3,384,187,197
Texas,Hemphill County,4,361,170,191
Texas,Hemphill County,5,169,82,87
Texas,Hemphill County,6,183,96,87
Texas,Hemphill County,7,223,115,108
Texas,Hemphill County,8,249,120,129
Texas,Hemphill County,9,278,132,146
Texas,Hemphill County,10,225,120,105
Texas,Hemphill County,11,203,106,97
Texas,Hemphill County,12,243,125,118
Texas,Hemphill County,13,201,106,95
Texas,Hemphill County,14,186,89,97
Texas,Hemphill County,15,149,69,80
Texas,Hemphill County,16,93,41,52
Texas,Hemphill County,17,58,22,36
Texas,Hemphill County,18,67,35,32
Texas,Henderson County,0,82299,40249,42050
Texas,Henderson County,1,4636,2436,2200
Texas,Henderson County,2,4826,2474,2352
Texas,Henderson County,3,5143,2639,2504
Texas,Henderson County,4,5027,2662,2365
Texas,Henderson County,5,4461,2278,2183
Texas,Henderson County,6,4657,2350,2307
Texas,Henderson County,7,4473,2168,2305
Texas,Henderson County,8,4432,2144,2288
Texas,Henderson County,9,4245,2074,2171
Texas,Henderson County,10,4906,2286,2620
Texas,Henderson County,11,5115,2532,2583
Texas,Henderson County,12,6108,2908,3200
Texas,Henderson County,13,6188,2934,3254
Texas,Henderson County,14,5529,2657,2872
Texas,Henderson County,15,4806,2255,2551
Texas,Henderson County,16,3599,1667,1932
Texas,Henderson County,17,2261,1050,1211
Texas,Henderson County,18,1887,735,1152
Texas,Hidalgo County,0,865939,424482,441457
Texas,Hidalgo County,1,77329,39621,37708
Texas,Hidalgo County,2,79561,40774,38787
Texas,Hidalgo County,3,77819,39320,38499
Texas,Hidalgo County,4,75972,38224,37748
Texas,Hidalgo County,5,66007,33111,32896
Texas,Hidalgo County,6,62433,31742,30691
Texas,Hidalgo County,7,54118,27183,26935
Texas,Hidalgo County,8,54903,26865,28038
Texas,Hidalgo County,9,54575,26416,28159
Texas,Hidalgo County,10,51492,24426,27066
Texas,Hidalgo County,11,43557,20564,22993
Texas,Hidalgo County,12,38596,18258,20338
Texas,Hidalgo County,13,33552,15383,18169
Texas,Hidalgo County,14,29324,13304,16020
Texas,Hidalgo County,15,24462,11083,13379
Texas,Hidalgo County,16,17600,7849,9751
Texas,Hidalgo County,17,12486,5397,7089
Texas,Hidalgo County,18,12153,4962,7191
Texas,Hill County,0,36354,18114,18240
Texas,Hill County,1,2152,1143,1009
Texas,Hill County,2,2362,1217,1145
Texas,Hill County,3,2456,1241,1215
Texas,Hill County,4,2458,1256,1202
Texas,Hill County,5,2003,1088,915
Texas,Hill County,6,2005,1015,990
Texas,Hill County,7,2098,990,1108
Texas,Hill County,8,2085,1062,1023
Texas,Hill County,9,1850,931,919
Texas,Hill County,10,2097,1034,1063
Texas,Hill County,11,2216,1096,1120
Texas,Hill County,12,2525,1222,1303
Texas,Hill County,13,2505,1229,1276
Texas,Hill County,14,2267,1131,1136
Texas,Hill County,15,1994,990,1004
Texas,Hill County,16,1447,691,756
Texas,Hill County,17,930,455,475
Texas,Hill County,18,904,323,581
Texas,Hockley County,0,22980,11458,11522
Texas,Hockley County,1,1526,780,746
Texas,Hockley County,2,1678,874,804
Texas,Hockley County,3,1673,829,844
Texas,Hockley County,4,2047,1027,1020
Texas,Hockley County,5,1627,875,752
Texas,Hockley County,6,1630,862,768
Texas,Hockley County,7,1504,769,735
Texas,Hockley County,8,1515,787,728
Texas,Hockley County,9,1199,602,597
Texas,Hockley County,10,1211,555,656
Texas,Hockley County,11,1270,611,659
Texas,Hockley County,12,1406,673,733
Texas,Hockley County,13,1322,674,648
Texas,Hockley County,14,1072,537,535
Texas,Hockley County,15,826,366,460
Texas,Hockley County,16,609,270,339
Texas,Hockley County,17,482,207,275
Texas,Hockley County,18,383,160,223
Texas,Hood County,0,60537,29601,30936
Texas,Hood County,1,3416,1815,1601
Texas,Hood County,2,3551,1810,1741
Texas,Hood County,3,3749,1896,1853
Texas,Hood County,4,3311,1704,1607
Texas,Hood County,5,2764,1419,1345
Texas,Hood County,6,3194,1580,1614
Texas,Hood County,7,3228,1598,1630
Texas,Hood County,8,3355,1670,1685
Texas,Hood County,9,2945,1450,1495
Texas,Hood County,10,3273,1565,1708
Texas,Hood County,11,3702,1787,1915
Texas,Hood County,12,4437,2135,2302
Texas,Hood County,13,4742,2260,2482
Texas,Hood County,14,4558,2131,2427
Texas,Hood County,15,3992,1915,2077
Texas,Hood County,16,2825,1375,1450
Texas,Hood County,17,1834,864,970
Texas,Hood County,18,1661,627,1034
Texas,Hopkins County,0,36810,18124,18686
Texas,Hopkins County,1,2383,1215,1168
Texas,Hopkins County,2,2442,1269,1173
Texas,Hopkins County,3,2613,1334,1279
Texas,Hopkins County,4,2469,1270,1199
Texas,Hopkins County,5,2158,1105,1053
Texas,Hopkins County,6,2248,1123,1125
Texas,Hopkins County,7,2235,1122,1113
Texas,Hopkins County,8,2058,1019,1039
Texas,Hopkins County,9,2056,989,1067
Texas,Hopkins County,10,2281,1111,1170
Texas,Hopkins County,11,2275,1110,1165
Texas,Hopkins County,12,2531,1276,1255
Texas,Hopkins County,13,2341,1146,1195
Texas,Hopkins County,14,2109,987,1122
Texas,Hopkins County,15,1716,797,919
Texas,Hopkins County,16,1284,615,669
Texas,Hopkins County,17,852,376,476
Texas,Hopkins County,18,759,260,499
Texas,Houston County,0,23169,12385,10784
Texas,Houston County,1,1214,625,589
Texas,Houston County,2,1281,644,637
Texas,Houston County,3,1365,713,652
Texas,Houston County,4,1164,585,579
Texas,Houston County,5,1108,622,486
Texas,Houston County,6,1398,768,630
Texas,Houston County,7,1311,799,512
Texas,Houston County,8,1515,922,593
Texas,Houston County,9,1457,894,563
Texas,Houston County,10,1513,947,566
Texas,Houston County,11,1554,895,659
Texas,Houston County,12,1591,836,755
Texas,Houston County,13,1599,759,840
Texas,Houston County,14,1478,701,777
Texas,Houston County,15,1290,622,668
Texas,Houston County,16,946,462,484
Texas,Houston County,17,736,333,403
Texas,Houston County,18,649,258,391
Texas,Howard County,0,36459,20966,15493
Texas,Howard County,1,2262,1200,1062
Texas,Howard County,2,2155,1089,1066
Texas,Howard County,3,2117,1080,1037
Texas,Howard County,4,2359,1378,981
Texas,Howard County,5,2432,1534,898
Texas,Howard County,6,2915,1737,1178
Texas,Howard County,7,2961,1842,1119
Texas,Howard County,8,2364,1329,1035
Texas,Howard County,9,2380,1493,887
Texas,Howard County,10,2721,1798,923
Texas,Howard County,11,2838,1957,881
Texas,Howard County,12,2332,1348,984
Texas,Howard County,13,1930,988,942
Texas,Howard County,14,1602,820,782
Texas,Howard County,15,1048,495,553
Texas,Howard County,16,806,346,460
Texas,Howard County,17,625,280,345
Texas,Howard County,18,612,252,360
Texas,Hudspeth County,0,4795,2541,2254
Texas,Hudspeth County,1,287,125,162
Texas,Hudspeth County,2,297,154,143
Texas,Hudspeth County,3,275,139,136
Texas,Hudspeth County,4,262,132,130
Texas,Hudspeth County,5,363,212,151
Texas,Hudspeth County,6,486,268,218
Texas,Hudspeth County,7,464,243,221
Texas,Hudspeth County,8,369,218,151
Texas,Hudspeth County,9,349,217,132
Texas,Hudspeth County,10,235,125,110
Texas,Hudspeth County,11,198,98,100
Texas,Hudspeth County,12,241,120,121
Texas,Hudspeth County,13,232,106,126
Texas,Hudspeth County,14,225,108,117
Texas,Hudspeth County,15,207,118,89
Texas,Hudspeth County,16,145,79,66
Texas,Hudspeth County,17,73,40,33
Texas,Hudspeth County,18,87,39,48
Texas,Hunt County,0,96493,47593,48900
Texas,Hunt County,1,6224,3176,3048
Texas,Hunt County,2,6218,3157,3061
Texas,Hunt County,3,6629,3437,3192
Texas,Hunt County,4,7024,3518,3506
Texas,Hunt County,5,6505,3325,3180
Texas,Hunt County,6,6305,3182,3123
Texas,Hunt County,7,5796,2807,2989
Texas,Hunt County,8,5891,2928,2963
Texas,Hunt County,9,5414,2644,2770
Texas,Hunt County,10,6076,2986,3090
Texas,Hunt County,11,6359,3146,3213
Texas,Hunt County,12,6686,3304,3382
Texas,Hunt County,13,6084,2997,3087
Texas,Hunt County,14,4890,2320,2570
Texas,Hunt County,15,4017,1912,2105
Texas,Hunt County,16,2865,1316,1549
Texas,Hunt County,17,1902,825,1077
Texas,Hunt County,18,1608,613,995
Texas,Hutchinson County,0,21198,10663,10535
Texas,Hutchinson County,1,1435,737,698
Texas,Hutchinson County,2,1486,745,741
Texas,Hutchinson County,3,1552,758,794
Texas,Hutchinson County,4,1499,756,743
Texas,Hutchinson County,5,1198,604,594
Texas,Hutchinson County,6,1335,711,624
Texas,Hutchinson County,7,1305,660,645
Texas,Hutchinson County,8,1346,687,659
Texas,Hutchinson County,9,1325,665,660
Texas,Hutchinson County,10,1257,636,621
Texas,Hutchinson County,11,1109,576,533
Texas,Hutchinson County,12,1424,719,705
Texas,Hutchinson County,13,1420,735,685
Texas,Hutchinson County,14,1170,583,587
Texas,Hutchinson County,15,845,413,432
Texas,Hutchinson County,16,607,303,304
Texas,Hutchinson County,17,434,183,251
Texas,Hutchinson County,18,451,192,259
Texas,Irion County,0,1522,781,741
Texas,Irion County,1,84,35,49
Texas,Irion County,2,94,50,44
Texas,Irion County,3,95,46,49
Texas,Irion County,4,93,55,38
Texas,Irion County,5,74,40,34
Texas,Irion County,6,92,55,37
Texas,Irion County,7,95,50,45
Texas,Irion County,8,67,37,30
Texas,Irion County,9,80,45,35
Texas,Irion County,10,95,47,48
Texas,Irion County,11,86,47,39
Texas,Irion County,12,124,68,56
Texas,Irion County,13,116,45,71
Texas,Irion County,14,95,50,45
Texas,Irion County,15,87,43,44
Texas,Irion County,16,76,38,38
Texas,Irion County,17,28,14,14
Texas,Irion County,18,41,16,25
Texas,Jack County,0,8843,4988,3855
Texas,Jack County,1,484,256,228
Texas,Jack County,2,555,264,291
Texas,Jack County,3,544,302,242
Texas,Jack County,4,583,323,260
Texas,Jack County,5,601,403,198
Texas,Jack County,6,649,448,201
Texas,Jack County,7,585,369,216
Texas,Jack County,8,545,339,206
Texas,Jack County,9,516,276,240
Texas,Jack County,10,555,329,226
Texas,Jack County,11,606,357,249
Texas,Jack County,12,602,329,273
Texas,Jack County,13,504,266,238
Texas,Jack County,14,472,240,232
Texas,Jack County,15,410,191,219
Texas,Jack County,16,284,140,144
Texas,Jack County,17,206,95,111
Texas,Jack County,18,142,61,81
Texas,Jackson County,0,14874,7400,7474
Texas,Jackson County,1,1022,493,529
Texas,Jackson County,2,1015,495,520
Texas,Jackson County,3,1113,538,575
Texas,Jackson County,4,992,541,451
Texas,Jackson County,5,799,403,396
Texas,Jackson County,6,912,450,462
Texas,Jackson County,7,943,528,415
Texas,Jackson County,8,989,487,502
Texas,Jackson County,9,782,391,391
Texas,Jackson County,10,825,425,400
Texas,Jackson County,11,849,421,428
Texas,Jackson County,12,948,491,457
Texas,Jackson County,13,1000,486,514
Texas,Jackson County,14,832,438,394
Texas,Jackson County,15,597,291,306
Texas,Jackson County,16,517,236,281
Texas,Jackson County,17,362,149,213
Texas,Jackson County,18,377,137,240
Texas,Jasper County,0,35872,17762,18110
Texas,Jasper County,1,2209,1071,1138
Texas,Jasper County,2,2411,1235,1176
Texas,Jasper County,3,2521,1306,1215
Texas,Jasper County,4,2205,1176,1029
Texas,Jasper County,5,1949,1016,933
Texas,Jasper County,6,2157,1125,1032
Texas,Jasper County,7,1980,969,1011
Texas,Jasper County,8,2106,1091,1015
Texas,Jasper County,9,1855,920,935
Texas,Jasper County,10,2111,1019,1092
Texas,Jasper County,11,2263,1130,1133
Texas,Jasper County,12,2587,1277,1310
Texas,Jasper County,13,2497,1198,1299
Texas,Jasper County,14,2234,1047,1187
Texas,Jasper County,15,1842,871,971
Texas,Jasper County,16,1397,659,738
Texas,Jasper County,17,847,377,470
Texas,Jasper County,18,701,275,426
Texas,Jeff Davis County,0,2252,1154,1098
Texas,Jeff Davis County,1,35,17,18
Texas,Jeff Davis County,2,27,14,13
Texas,Jeff Davis County,3,29,13,16
Texas,Jeff Davis County,4,109,72,37
Texas,Jeff Davis County,5,78,41,37
Texas,Jeff Davis County,6,101,57,44
Texas,Jeff Davis County,7,112,55,57
Texas,Jeff Davis County,8,94,50,44
Texas,Jeff Davis County,9,112,53,59
Texas,Jeff Davis County,10,150,69,81
Texas,Jeff Davis County,11,137,68,69
Texas,Jeff Davis County,12,213,107,106
Texas,Jeff Davis County,13,270,137,133
Texas,Jeff Davis County,14,257,128,129
Texas,Jeff Davis County,15,225,126,99
Texas,Jeff Davis County,16,145,80,65
Texas,Jeff Davis County,17,69,39,30
Texas,Jeff Davis County,18,89,28,61
Texas,Jefferson County,0,255001,130778,124223
Texas,Jefferson County,1,17728,9170,8558
Texas,Jefferson County,2,16978,8717,8261
Texas,Jefferson County,3,16836,8501,8335
Texas,Jefferson County,4,16438,8379,8059
Texas,Jefferson County,5,17382,9171,8211
Texas,Jefferson County,6,19233,10560,8673
Texas,Jefferson County,7,18184,10114,8070
Texas,Jefferson County,8,17497,9668,7829
Texas,Jefferson County,9,15300,8289,7011
Texas,Jefferson County,10,15260,8139,7121
Texas,Jefferson County,11,15163,7852,7311
Texas,Jefferson County,12,16791,8513,8278
Texas,Jefferson County,13,15402,7482,7920
Texas,Jefferson County,14,12039,5781,6258
Texas,Jefferson County,15,9001,4167,4834
Texas,Jefferson County,16,6236,2630,3606
Texas,Jefferson County,17,4536,1851,2685
Texas,Jefferson County,18,4997,1794,3203
Texas,Jim Hogg County,0,5248,2694,2554
Texas,Jim Hogg County,1,423,223,200
Texas,Jim Hogg County,2,418,208,210
Texas,Jim Hogg County,3,493,266,227
Texas,Jim Hogg County,4,427,259,168
Texas,Jim Hogg County,5,287,141,146
Texas,Jim Hogg County,6,280,154,126
Texas,Jim Hogg County,7,322,176,146
Texas,Jim Hogg County,8,301,167,134
Texas,Jim Hogg County,9,320,169,151
Texas,Jim Hogg County,10,236,116,120
Texas,Jim Hogg County,11,286,150,136
Texas,Jim Hogg County,12,289,143,146
Texas,Jim Hogg County,13,243,123,120
Texas,Jim Hogg County,14,271,113,158
Texas,Jim Hogg County,15,258,126,132
Texas,Jim Hogg County,16,185,79,106
Texas,Jim Hogg County,17,130,53,77
Texas,Jim Hogg County,18,79,28,51
Texas,Jim Wells County,0,40822,20244,20578
Texas,Jim Wells County,1,3068,1545,1523
Texas,Jim Wells County,2,3158,1612,1546
Texas,Jim Wells County,3,3317,1745,1572
Texas,Jim Wells County,4,2971,1580,1391
Texas,Jim Wells County,5,2582,1336,1246
Texas,Jim Wells County,6,2763,1389,1374
Texas,Jim Wells County,7,2579,1305,1274
Texas,Jim Wells County,8,2666,1370,1296
Texas,Jim Wells County,9,2258,1103,1155
Texas,Jim Wells County,10,2313,1121,1192
Texas,Jim Wells County,11,2269,1064,1205
Texas,Jim Wells County,12,2404,1156,1248
Texas,Jim Wells County,13,2208,1050,1158
Texas,Jim Wells County,14,1994,1001,993
Texas,Jim Wells County,15,1636,776,860
Texas,Jim Wells County,16,1064,472,592
Texas,Jim Wells County,17,815,351,464
Texas,Jim Wells County,18,757,268,489
Texas,Johnson County,0,171361,85449,85912
Texas,Johnson County,1,11436,5894,5542
Texas,Johnson County,2,12281,6386,5895
Texas,Johnson County,3,13164,6766,6398
Texas,Johnson County,4,11900,6086,5814
Texas,Johnson County,5,10386,5334,5052
Texas,Johnson County,6,11154,5670,5484
Texas,Johnson County,7,11287,5650,5637
Texas,Johnson County,8,11559,5825,5734
Texas,Johnson County,9,10503,5222,5281
Texas,Johnson County,10,11228,5627,5601
Texas,Johnson County,11,10956,5564,5392
Texas,Johnson County,12,11302,5658,5644
Texas,Johnson County,13,9986,4875,5111
Texas,Johnson County,14,8053,3745,4308
Texas,Johnson County,15,6714,3071,3643
Texas,Johnson County,16,4412,2021,2391
Texas,Johnson County,17,2874,1255,1619
Texas,Johnson County,18,2166,800,1366
Texas,Jones County,0,19817,12433,7384
Texas,Jones County,1,869,412,457
Texas,Jones County,2,931,488,443
Texas,Jones County,3,993,521,472
Texas,Jones County,4,1036,575,461
Texas,Jones County,5,1538,1163,375
Texas,Jones County,6,1724,1339,385
Texas,Jones County,7,1652,1234,418
Texas,Jones County,8,1545,1149,396
Texas,Jones County,9,1408,1025,383
Texas,Jones County,10,1441,982,459
Texas,Jones County,11,1227,789,438
Texas,Jones County,12,1244,692,552
Texas,Jones County,13,1118,583,535
Texas,Jones County,14,934,483,451
Texas,Jones County,15,807,395,412
Texas,Jones County,16,568,263,305
Texas,Jones County,17,407,180,227
Texas,Jones County,18,375,160,215
Texas,Karnes County,0,15650,9209,6441
Texas,Karnes County,1,941,485,456
Texas,Karnes County,2,898,457,441
Texas,Karnes County,3,948,503,445
Texas,Karnes County,4,946,491,455
Texas,Karnes County,5,1253,873,380
Texas,Karnes County,6,1492,1075,417
Texas,Karnes County,7,1334,938,396
Texas,Karnes County,8,1196,807,389
Texas,Karnes County,9,997,648,349
Texas,Karnes County,10,901,579,322
Texas,Karnes County,11,799,431,368
Texas,Karnes County,12,883,504,379
Texas,Karnes County,13,857,438,419
Texas,Karnes County,14,658,318,340
Texas,Karnes County,15,524,241,283
Texas,Karnes County,16,372,177,195
Texas,Karnes County,17,330,126,204
Texas,Karnes County,18,321,118,203
Texas,Kaufman County,0,128622,63360,65262
Texas,Kaufman County,1,9470,4870,4600
Texas,Kaufman County,2,9764,4889,4875
Texas,Kaufman County,3,10359,5214,5145
Texas,Kaufman County,4,9208,4796,4412
Texas,Kaufman County,5,7165,3642,3523
Texas,Kaufman County,6,8249,3935,4314
Texas,Kaufman County,7,9296,4533,4763
Texas,Kaufman County,8,9443,4649,4794
Texas,Kaufman County,9,8706,4330,4376
Texas,Kaufman County,10,8610,4217,4393
Texas,Kaufman County,11,7981,3890,4091
Texas,Kaufman County,12,7921,3970,3951
Texas,Kaufman County,13,7083,3462,3621
Texas,Kaufman County,14,5451,2609,2842
Texas,Kaufman County,15,4054,1874,2180
Texas,Kaufman County,16,2784,1285,1499
Texas,Kaufman County,17,1649,714,935
Texas,Kaufman County,18,1429,481,948
Texas,Kendall County,0,45641,22350,23291
Texas,Kendall County,1,2319,1186,1133
Texas,Kendall County,2,2833,1376,1457
Texas,Kendall County,3,3282,1681,1601
Texas,Kendall County,4,3186,1648,1538
Texas,Kendall County,5,2430,1265,1165
Texas,Kendall County,6,2119,1054,1065
Texas,Kendall County,7,2412,1198,1214
Texas,Kendall County,8,2713,1326,1387
Texas,Kendall County,9,2977,1486,1491
Texas,Kendall County,10,3079,1531,1548
Texas,Kendall County,11,3070,1486,1584
Texas,Kendall County,12,3335,1593,1742
Texas,Kendall County,13,3183,1530,1653
Texas,Kendall County,14,2766,1332,1434
Texas,Kendall County,15,2295,1119,1176
Texas,Kendall County,16,1582,738,844
Texas,Kendall County,17,985,446,539
Texas,Kendall County,18,1075,355,720
Texas,Kenedy County,0,442,228,214
Texas,Kenedy County,1,17,11,6
Texas,Kenedy County,2,37,21,16
Texas,Kenedy County,3,39,21,18
Texas,Kenedy County,4,49,30,19
Texas,Kenedy County,5,23,11,12
Texas,Kenedy County,6,18,5,13
Texas,Kenedy County,7,32,17,15
Texas,Kenedy County,8,27,12,15
Texas,Kenedy County,9,17,8,9
Texas,Kenedy County,10,30,13,17
Texas,Kenedy County,11,28,13,15
Texas,Kenedy County,12,24,15,9
Texas,Kenedy County,13,32,17,15
Texas,Kenedy County,14,11,9,2
Texas,Kenedy County,15,27,12,15
Texas,Kenedy County,16,11,7,4
Texas,Kenedy County,17,7,3,4
Texas,Kenedy County,18,13,3,10
Texas,Kent County,0,726,361,365
Texas,Kent County,1,37,21,16
Texas,Kent County,2,42,27,15
Texas,Kent County,3,49,27,22
Texas,Kent County,4,41,21,20
Texas,Kent County,5,25,11,14
Texas,Kent County,6,21,12,9
Texas,Kent County,7,38,26,12
Texas,Kent County,8,44,20,24
Texas,Kent County,9,23,11,12
Texas,Kent County,10,42,25,17
Texas,Kent County,11,49,24,25
Texas,Kent County,12,52,27,25
Texas,Kent County,13,66,39,27
Texas,Kent County,14,40,20,20
Texas,Kent County,15,50,19,31
Texas,Kent County,16,43,16,27
Texas,Kent County,17,34,8,26
Texas,Kent County,18,30,7,23
Texas,Kerr County,0,52405,25219,27186
Texas,Kerr County,1,2734,1351,1383
Texas,Kerr County,2,2655,1312,1343
Texas,Kerr County,3,2896,1506,1390
Texas,Kerr County,4,3128,1598,1530
Texas,Kerr County,5,2847,1465,1382
Texas,Kerr County,6,2861,1394,1467
Texas,Kerr County,7,2672,1307,1365
Texas,Kerr County,8,2465,1185,1280
Texas,Kerr County,9,2337,1172,1165
Texas,Kerr County,10,2667,1227,1440
Texas,Kerr County,11,3046,1461,1585
Texas,Kerr County,12,3717,1710,2007
Texas,Kerr County,13,3864,1825,2039
Texas,Kerr County,14,4009,1872,2137
Texas,Kerr County,15,3797,1768,2029
Texas,Kerr County,16,2850,1351,1499
Texas,Kerr County,17,1953,911,1042
Texas,Kerr County,18,1907,804,1103
Texas,Kimble County,0,4362,2134,2228
Texas,Kimble County,1,190,92,98
Texas,Kimble County,2,189,109,80
Texas,Kimble County,3,237,118,119
Texas,Kimble County,4,239,121,118
Texas,Kimble County,5,198,88,110
Texas,Kimble County,6,187,104,83
Texas,Kimble County,7,210,120,90
Texas,Kimble County,8,212,102,110
Texas,Kimble County,9,199,88,111
Texas,Kimble County,10,248,111,137
Texas,Kimble County,11,248,129,119
Texas,Kimble County,12,337,155,182
Texas,Kimble County,13,388,199,189
Texas,Kimble County,14,363,170,193
Texas,Kimble County,15,355,167,188
Texas,Kimble County,16,251,125,126
Texas,Kimble County,17,173,87,86
Texas,Kimble County,18,138,49,89
Texas,King County,0,277,140,137
Texas,King County,1,13,11,2
Texas,King County,2,24,10,14
Texas,King County,3,26,10,16
Texas,King County,4,11,2,9
Texas,King County,5,11,7,4
Texas,King County,6,17,9,8
Texas,King County,7,14,6,8
Texas,King County,8,23,12,11
Texas,King County,9,7,6,1
Texas,King County,10,19,12,7
Texas,King County,11,22,9,13
Texas,King County,12,17,7,10
Texas,King County,13,24,15,9
Texas,King County,14,14,8,6
Texas,King County,15,9,5,4
Texas,King County,16,8,5,3
Texas,King County,17,13,2,11
Texas,King County,18,5,4,1
Texas,Kinney County,0,3767,2074,1693
Texas,Kinney County,1,152,78,74
Texas,Kinney County,2,194,96,98
Texas,Kinney County,3,229,138,91
Texas,Kinney County,4,221,126,95
Texas,Kinney County,5,260,164,96
Texas,Kinney County,6,240,164,76
Texas,Kinney County,7,225,160,65
Texas,Kinney County,8,235,143,92
Texas,Kinney County,9,249,126,123
Texas,Kinney County,10,211,110,101
Texas,Kinney County,11,212,116,96
Texas,Kinney County,12,183,86,97
Texas,Kinney County,13,252,130,122
Texas,Kinney County,14,216,105,111
Texas,Kinney County,15,223,112,111
Texas,Kinney County,16,194,90,104
Texas,Kinney County,17,156,64,92
Texas,Kinney County,18,115,66,49
Texas,Kleberg County,0,31129,15939,15190
Texas,Kleberg County,1,2116,1103,1013
Texas,Kleberg County,2,2048,1036,1012
Texas,Kleberg County,3,2046,1054,992
Texas,Kleberg County,4,2935,1553,1382
Texas,Kleberg County,5,4723,2472,2251
Texas,Kleberg County,6,2473,1406,1067
Texas,Kleberg County,7,1919,1067,852
Texas,Kleberg County,8,1820,979,841
Texas,Kleberg County,9,1406,705,701
Texas,Kleberg County,10,1515,760,755
Texas,Kleberg County,11,1371,658,713
Texas,Kleberg County,12,1337,675,662
Texas,Kleberg County,13,1391,657,734
Texas,Kleberg County,14,1150,548,602
Texas,Kleberg County,15,1099,502,597
Texas,Kleberg County,16,748,351,397
Texas,Kleberg County,17,528,218,310
Texas,Kleberg County,18,504,195,309
Texas,Knox County,0,3653,1809,1844
Texas,Knox County,1,256,136,120
Texas,Knox County,2,297,149,148
Texas,Knox County,3,258,122,136
Texas,Knox County,4,240,128,112
Texas,Knox County,5,178,99,79
Texas,Knox County,6,229,95,134
Texas,Knox County,7,214,115,99
Texas,Knox County,8,189,91,98
Texas,Knox County,9,190,114,76
Texas,Knox County,10,170,75,95
Texas,Knox County,11,218,111,107
Texas,Knox County,12,233,126,107
Texas,Knox County,13,255,143,112
Texas,Knox County,14,208,107,101
Texas,Knox County,15,186,88,98
Texas,Knox County,16,122,46,76
Texas,Knox County,17,114,34,80
Texas,Knox County,18,96,30,66
Texas,Lamar County,0,49728,23970,25758
Texas,Lamar County,1,3352,1731,1621
Texas,Lamar County,2,3244,1687,1557
Texas,Lamar County,3,3220,1630,1590
Texas,Lamar County,4,3179,1623,1556
Texas,Lamar County,5,2796,1383,1413
Texas,Lamar County,6,3345,1635,1710
Texas,Lamar County,7,2847,1408,1439
Texas,Lamar County,8,2781,1303,1478
Texas,Lamar County,9,2684,1289,1395
Texas,Lamar County,10,3055,1440,1615
Texas,Lamar County,11,3171,1550,1621
Texas,Lamar County,12,3363,1604,1759
Texas,Lamar County,13,3144,1514,1630
Texas,Lamar County,14,2877,1327,1550
Texas,Lamar County,15,2516,1182,1334
Texas,Lamar County,16,1842,812,1030
Texas,Lamar County,17,1155,473,682
Texas,Lamar County,18,1157,379,778
Texas,Lamb County,0,13158,6523,6635
Texas,Lamb County,1,972,475,497
Texas,Lamb County,2,1058,549,509
Texas,Lamb County,3,1028,526,502
Texas,Lamb County,4,978,485,493
Texas,Lamb County,5,760,414,346
Texas,Lamb County,6,789,409,380
Texas,Lamb County,7,767,382,385
Texas,Lamb County,8,799,401,398
Texas,Lamb County,9,730,360,370
Texas,Lamb County,10,646,325,321
Texas,Lamb County,11,776,386,390
Texas,Lamb County,12,834,398,436
Texas,Lamb County,13,805,419,386
Texas,Lamb County,14,644,316,328
Texas,Lamb County,15,471,223,248
Texas,Lamb County,16,417,186,231
Texas,Lamb County,17,365,157,208
Texas,Lamb County,18,319,112,207
Texas,Lampasas County,0,21229,10461,10768
Texas,Lampasas County,1,1152,584,568
Texas,Lampasas County,2,1291,643,648
Texas,Lampasas County,3,1369,671,698
Texas,Lampasas County,4,1382,713,669
Texas,Lampasas County,5,1056,556,500
Texas,Lampasas County,6,1082,562,520
Texas,Lampasas County,7,1132,565,567
Texas,Lampasas County,8,1276,637,639
Texas,Lampasas County,9,1287,637,650
Texas,Lampasas County,10,1350,673,677
Texas,Lampasas County,11,1571,791,780
Texas,Lampasas County,12,1592,818,774
Texas,Lampasas County,13,1524,718,806
Texas,Lampasas County,14,1296,590,706
Texas,Lampasas County,15,1132,542,590
Texas,Lampasas County,16,770,351,419
Texas,Lampasas County,17,496,218,278
Texas,Lampasas County,18,471,192,279
Texas,La Salle County,0,7531,4457,3074
Texas,La Salle County,1,418,230,188
Texas,La Salle County,2,416,222,194
Texas,La Salle County,3,397,215,182
Texas,La Salle County,4,459,249,210
Texas,La Salle County,5,1077,857,220
Texas,La Salle County,6,858,634,224
Texas,La Salle County,7,518,291,227
Texas,La Salle County,8,454,271,183
Texas,La Salle County,9,470,282,188
Texas,La Salle County,10,411,227,184
Texas,La Salle County,11,411,210,201
Texas,La Salle County,12,321,164,157
Texas,La Salle County,13,288,127,161
Texas,La Salle County,14,298,146,152
Texas,La Salle County,15,293,131,162
Texas,La Salle County,16,190,94,96
Texas,La Salle County,17,139,58,81
Texas,La Salle County,18,113,49,64
Texas,Lavaca County,0,20110,9822,10288
Texas,Lavaca County,1,1196,606,590
Texas,Lavaca County,2,1254,624,630
Texas,Lavaca County,3,1486,757,729
Texas,Lavaca County,4,1268,638,630
Texas,Lavaca County,5,1030,538,492
Texas,Lavaca County,6,1053,536,517
Texas,Lavaca County,7,996,474,522
Texas,Lavaca County,8,1095,527,568
Texas,Lavaca County,9,975,495,480
Texas,Lavaca County,10,1104,537,567
Texas,Lavaca County,11,1181,626,555
Texas,Lavaca County,12,1401,720,681
Texas,Lavaca County,13,1388,630,758
Texas,Lavaca County,14,1431,711,720
Texas,Lavaca County,15,1109,510,599
Texas,Lavaca County,16,803,380,423
Texas,Lavaca County,17,612,267,345
Texas,Lavaca County,18,728,246,482
Texas,Lee County,0,17144,8609,8535
Texas,Lee County,1,990,489,501
Texas,Lee County,2,1009,515,494
Texas,Lee County,3,1032,486,546
Texas,Lee County,4,1151,721,430
Texas,Lee County,5,929,487,442
Texas,Lee County,6,982,489,493
Texas,Lee County,7,1002,491,511
Texas,Lee County,8,1061,549,512
Texas,Lee County,9,984,476,508
Texas,Lee County,10,1010,497,513
Texas,Lee County,11,1104,529,575
Texas,Lee County,12,1379,694,685
Texas,Lee County,13,1341,682,659
Texas,Lee County,14,1010,514,496
Texas,Lee County,15,783,398,385
Texas,Lee County,16,618,290,328
Texas,Lee County,17,409,171,238
Texas,Lee County,18,350,131,219
Texas,Leon County,0,17270,8587,8683
Texas,Leon County,1,1055,587,468
Texas,Leon County,2,1079,541,538
Texas,Leon County,3,1084,572,512
Texas,Leon County,4,1028,513,515
Texas,Leon County,5,807,429,378
Texas,Leon County,6,846,417,429
Texas,Leon County,7,811,402,409
Texas,Leon County,8,907,439,468
Texas,Leon County,9,920,462,458
Texas,Leon County,10,894,462,432
Texas,Leon County,11,988,477,511
Texas,Leon County,12,1281,632,649
Texas,Leon County,13,1344,657,687
Texas,Leon County,14,1248,606,642
Texas,Leon County,15,1128,537,591
Texas,Leon County,16,884,428,456
Texas,Leon County,17,519,250,269
Texas,Leon County,18,447,176,271
Texas,Liberty County,0,86323,42794,43529
Texas,Liberty County,1,6223,3183,3040
Texas,Liberty County,2,6473,3337,3136
Texas,Liberty County,3,6418,3302,3116
Texas,Liberty County,4,5891,2979,2912
Texas,Liberty County,5,5645,2869,2776
Texas,Liberty County,6,6414,3184,3230
Texas,Liberty County,7,5880,2888,2992
Texas,Liberty County,8,5560,2706,2854
Texas,Liberty County,9,5315,2496,2819
Texas,Liberty County,10,5723,2799,2924
Texas,Liberty County,11,5340,2734,2606
Texas,Liberty County,12,5576,2791,2785
Texas,Liberty County,13,4813,2391,2422
Texas,Liberty County,14,3999,1964,2035
Texas,Liberty County,15,3004,1454,1550
Texas,Liberty County,16,1965,901,1064
Texas,Liberty County,17,1083,456,627
Texas,Liberty County,18,1001,360,641
Texas,Limestone County,0,23519,12143,11376
Texas,Limestone County,1,1475,741,734
Texas,Limestone County,2,1451,742,709
Texas,Limestone County,3,1408,725,683
Texas,Limestone County,4,1517,869,648
Texas,Limestone County,5,1415,831,584
Texas,Limestone County,6,1554,888,666
Texas,Limestone County,7,1428,810,618
Texas,Limestone County,8,1396,768,628
Texas,Limestone County,9,1331,706,625
Texas,Limestone County,10,1327,670,657
Texas,Limestone County,11,1381,691,690
Texas,Limestone County,12,1613,792,821
Texas,Limestone County,13,1642,800,842
Texas,Limestone County,14,1443,673,770
Texas,Limestone County,15,1230,609,621
Texas,Limestone County,16,835,378,457
Texas,Limestone County,17,508,225,283
Texas,Limestone County,18,565,225,340
Texas,Lipscomb County,0,3355,1734,1621
Texas,Lipscomb County,1,199,109,90
Texas,Lipscomb County,2,237,112,125
Texas,Lipscomb County,3,273,139,134
Texas,Lipscomb County,4,232,123,109
Texas,Lipscomb County,5,176,93,83
Texas,Lipscomb County,6,175,100,75
Texas,Lipscomb County,7,231,133,98
Texas,Lipscomb County,8,248,159,89
Texas,Lipscomb County,9,161,67,94
Texas,Lipscomb County,10,160,87,73
Texas,Lipscomb County,11,191,97,94
Texas,Lipscomb County,12,244,122,122
Texas,Lipscomb County,13,220,107,113
Texas,Lipscomb County,14,203,114,89
Texas,Lipscomb County,15,116,57,59
Texas,Lipscomb County,16,112,45,67
Texas,Lipscomb County,17,83,38,45
Texas,Lipscomb County,18,94,32,62
Texas,Live Oak County,0,12166,6667,5499
Texas,Live Oak County,1,656,338,318
Texas,Live Oak County,2,675,348,327
Texas,Live Oak County,3,666,354,312
Texas,Live Oak County,4,670,346,324
Texas,Live Oak County,5,673,405,268
Texas,Live Oak County,6,852,531,321
Texas,Live Oak County,7,890,599,291
Texas,Live Oak County,8,812,510,302
Texas,Live Oak County,9,703,416,287
Texas,Live Oak County,10,642,363,279
Texas,Live Oak County,11,700,366,334
Texas,Live Oak County,12,908,469,439
Texas,Live Oak County,13,814,398,416
Texas,Live Oak County,14,733,364,369
Texas,Live Oak County,15,643,318,325
Texas,Live Oak County,16,490,268,222
Texas,Live Oak County,17,338,162,176
Texas,Live Oak County,18,301,112,189
Texas,Llano County,0,21646,10482,11164
Texas,Llano County,1,953,501,452
Texas,Llano County,2,830,423,407
Texas,Llano County,3,973,500,473
Texas,Llano County,4,914,470,444
Texas,Llano County,5,831,418,413
Texas,Llano County,6,883,443,440
Texas,Llano County,7,815,410,405
Texas,Llano County,8,858,447,411
Texas,Llano County,9,810,389,421
Texas,Llano County,10,1065,506,559
Texas,Llano County,11,1210,560,650
Texas,Llano County,12,1646,768,878
Texas,Llano County,13,2040,939,1101
Texas,Llano County,14,2238,1041,1197
Texas,Llano County,15,2041,978,1063
Texas,Llano County,16,1512,766,746
Texas,Llano County,17,1077,531,546
Texas,Llano County,18,950,392,558
Texas,Loving County,0,152,85,67
Texas,Loving County,1,11,7,4
Texas,Loving County,2,17,8,9
Texas,Loving County,3,11,6,5
Texas,Loving County,4,17,9,8
Texas,Loving County,5,10,6,4
Texas,Loving County,6,14,9,5
Texas,Loving County,7,13,5,8
Texas,Loving County,8,13,6,7
Texas,Loving County,9,2,1,1
Texas,Loving County,10,2,1,1
Texas,Loving County,11,7,4,3
Texas,Loving County,12,7,4,3
Texas,Loving County,13,13,10,3
Texas,Loving County,14,7,4,3
Texas,Loving County,15,5,4,1
Texas,Loving County,16,3,1,2
Texas,Loving County,17,0,0,0
Texas,Loving County,18,0,0,0
Texas,Lubbock County,0,307412,151464,155948
Texas,Lubbock County,1,20651,10503,10148
Texas,Lubbock County,2,20199,10388,9811
Texas,Lubbock County,3,20547,10326,10221
Texas,Lubbock County,4,25551,12781,12770
Texas,Lubbock County,5,37729,19519,18210
Texas,Lubbock County,6,24809,12704,12105
Texas,Lubbock County,7,20446,10334,10112
Texas,Lubbock County,8,19975,10016,9959
Texas,Lubbock County,9,16452,8107,8345
Texas,Lubbock County,10,15588,7469,8119
Texas,Lubbock County,11,15208,7376,7832
Texas,Lubbock County,12,16411,7887,8524
Texas,Lubbock County,13,15646,7378,8268
Texas,Lubbock County,14,12387,5815,6572
Texas,Lubbock County,15,9512,4340,5172
Texas,Lubbock County,16,6705,2846,3859
Texas,Lubbock County,17,4878,2010,2868
Texas,Lubbock County,18,4718,1665,3053
Texas,Lynn County,0,5877,2997,2880
Texas,Lynn County,1,412,209,203
Texas,Lynn County,2,440,226,214
Texas,Lynn County,3,481,246,235
Texas,Lynn County,4,394,211,183
Texas,Lynn County,5,303,152,151
Texas,Lynn County,6,356,202,154
Texas,Lynn County,7,358,192,166
Texas,Lynn County,8,368,184,184
Texas,Lynn County,9,349,184,165
Texas,Lynn County,10,269,131,138
Texas,Lynn County,11,385,183,202
Texas,Lynn County,12,404,213,191
Texas,Lynn County,13,368,197,171
Texas,Lynn County,14,273,147,126
Texas,Lynn County,15,236,115,121
Texas,Lynn County,16,201,86,115
Texas,Lynn County,17,170,74,96
Texas,Lynn County,18,110,45,65
Texas,McCulloch County,0,7987,4012,3975
Texas,McCulloch County,1,422,213,209
Texas,McCulloch County,2,522,311,211
Texas,McCulloch County,3,508,258,250
Texas,McCulloch County,4,521,282,239
Texas,McCulloch County,5,445,226,219
Texas,McCulloch County,6,451,233,218
Texas,McCulloch County,7,418,225,193
Texas,McCulloch County,8,424,219,205
Texas,McCulloch County,9,450,233,217
Texas,McCulloch County,10,407,199,208
Texas,McCulloch County,11,514,241,273
Texas,McCulloch County,12,514,254,260
Texas,McCulloch County,13,613,283,330
Texas,McCulloch County,14,514,251,263
Texas,McCulloch County,15,493,243,250
Texas,McCulloch County,16,324,152,172
Texas,McCulloch County,17,219,94,125
Texas,McCulloch County,18,228,95,133
Texas,McLennan County,0,254607,124464,130143
Texas,McLennan County,1,17733,9032,8701
Texas,McLennan County,2,17297,8941,8356
Texas,McLennan County,3,17215,8872,8343
Texas,McLennan County,4,20949,10558,10391
Texas,McLennan County,5,26179,13193,12986
Texas,McLennan County,6,17682,8912,8770
Texas,McLennan County,7,15931,7877,8054
Texas,McLennan County,8,15556,7537,8019
Texas,McLennan County,9,13606,6689,6917
Texas,McLennan County,10,13703,6692,7011
Texas,McLennan County,11,13581,6395,7186
Texas,McLennan County,12,14729,7187,7542
Texas,McLennan County,13,13831,6590,7241
Texas,McLennan County,14,11748,5511,6237
Texas,McLennan County,15,9047,4091,4956
Texas,McLennan County,16,6282,2780,3502
Texas,McLennan County,17,4573,1898,2675
Texas,McLennan County,18,4965,1709,3256
Texas,McMullen County,0,749,411,338
Texas,McMullen County,1,33,15,18
Texas,McMullen County,2,36,19,17
Texas,McMullen County,3,47,26,21
Texas,McMullen County,4,38,19,19
Texas,McMullen County,5,40,27,13
Texas,McMullen County,6,56,41,15
Texas,McMullen County,7,39,19,20
Texas,McMullen County,8,35,15,20
Texas,McMullen County,9,32,18,14
Texas,McMullen County,10,51,29,22
Texas,McMullen County,11,58,33,25
Texas,McMullen County,12,44,19,25
Texas,McMullen County,13,60,34,26
Texas,McMullen County,14,40,24,16
Texas,McMullen County,15,43,22,21
Texas,McMullen County,16,36,24,12
Texas,McMullen County,17,32,12,20
Texas,McMullen County,18,29,15,14
Texas,Madison County,0,14422,8283,6139
Texas,Madison County,1,780,387,393
Texas,Madison County,2,861,416,445
Texas,Madison County,3,869,437,432
Texas,Madison County,4,924,510,414
Texas,Madison County,5,1280,916,364
Texas,Madison County,6,1398,1006,392
Texas,Madison County,7,1172,833,339
Texas,Madison County,8,978,629,349
Texas,Madison County,9,865,539,326
Texas,Madison County,10,794,440,354
Texas,Madison County,11,755,384,371
Texas,Madison County,12,738,352,386
Texas,Madison County,13,757,390,367
Texas,Madison County,14,682,316,366
Texas,Madison County,15,557,281,276
Texas,Madison County,16,451,216,235
Texas,Madison County,17,286,129,157
Texas,Madison County,18,275,102,173
Texas,Marion County,0,9928,4842,5086
Texas,Marion County,1,447,231,216
Texas,Marion County,2,505,233,272
Texas,Marion County,3,521,271,250
Texas,Marion County,4,497,260,237
Texas,Marion County,5,437,235,202
Texas,Marion County,6,451,242,209
Texas,Marion County,7,478,230,248
Texas,Marion County,8,499,227,272
Texas,Marion County,9,476,246,230
Texas,Marion County,10,563,257,306
Texas,Marion County,11,696,322,374
Texas,Marion County,12,893,413,480
Texas,Marion County,13,847,408,439
Texas,Marion County,14,812,403,409
Texas,Marion County,15,709,340,369
Texas,Marion County,16,537,265,272
Texas,Marion County,17,305,151,154
Texas,Marion County,18,255,108,147
Texas,Martin County,0,5753,2911,2842
Texas,Martin County,1,508,261,247
Texas,Martin County,2,521,269,252
Texas,Martin County,3,487,254,233
Texas,Martin County,4,432,203,229
Texas,Martin County,5,323,163,160
Texas,Martin County,6,377,191,186
Texas,Martin County,7,438,223,215
Texas,Martin County,8,359,195,164
Texas,Martin County,9,295,164,131
Texas,Martin County,10,359,186,173
Texas,Martin County,11,332,161,171
Texas,Martin County,12,355,179,176
Texas,Martin County,13,319,156,163
Texas,Martin County,14,194,97,97
Texas,Martin County,15,185,86,99
Texas,Martin County,16,108,46,62
Texas,Martin County,17,85,43,42
Texas,Martin County,18,76,34,42
Texas,Mason County,0,4280,2143,2137
Texas,Mason County,1,246,143,103
Texas,Mason County,2,218,110,108
Texas,Mason County,3,273,150,123
Texas,Mason County,4,253,125,128
Texas,Mason County,5,185,92,93
Texas,Mason County,6,177,101,76
Texas,Mason County,7,190,106,84
Texas,Mason County,8,223,101,122
Texas,Mason County,9,193,89,104
Texas,Mason County,10,214,95,119
Texas,Mason County,11,261,129,132
Texas,Mason County,12,299,169,130
Texas,Mason County,13,328,162,166
Texas,Mason County,14,333,152,181
Texas,Mason County,15,330,162,168
Texas,Mason County,16,258,123,135
Texas,Mason County,17,172,78,94
Texas,Mason County,18,127,56,71
Texas,Matagorda County,0,36552,18415,18137
Texas,Matagorda County,1,2623,1364,1259
Texas,Matagorda County,2,2587,1297,1290
Texas,Matagorda County,3,2614,1326,1288
Texas,Matagorda County,4,2359,1235,1124
Texas,Matagorda County,5,2161,1146,1015
Texas,Matagorda County,6,2383,1249,1134
Texas,Matagorda County,7,2228,1125,1103
Texas,Matagorda County,8,2262,1199,1063
Texas,Matagorda County,9,1894,933,961
Texas,Matagorda County,10,1969,933,1036
Texas,Matagorda County,11,2184,1095,1089
Texas,Matagorda County,12,2615,1279,1336
Texas,Matagorda County,13,2452,1279,1173
Texas,Matagorda County,14,2122,1099,1023
Texas,Matagorda County,15,1542,745,797
Texas,Matagorda County,16,1091,529,562
Texas,Matagorda County,17,762,351,411
Texas,Matagorda County,18,704,231,473
Texas,Maverick County,0,58485,29178,29307
Texas,Maverick County,1,5396,2716,2680
Texas,Maverick County,2,4861,2461,2400
Texas,Maverick County,3,4859,2443,2416
Texas,Maverick County,4,5195,2670,2525
Texas,Maverick County,5,4786,2673,2113
Texas,Maverick County,6,4338,2343,1995
Texas,Maverick County,7,3657,1979,1678
Texas,Maverick County,8,3368,1681,1687
Texas,Maverick County,9,3365,1636,1729
Texas,Maverick County,10,3418,1586,1832
Texas,Maverick County,11,3039,1463,1576
Texas,Maverick County,12,2750,1300,1450
Texas,Maverick County,13,2537,1156,1381
Texas,Maverick County,14,2262,1059,1203
Texas,Maverick County,15,1732,765,967
Texas,Maverick County,16,1232,525,707
Texas,Maverick County,17,939,409,530
Texas,Maverick County,18,751,313,438
Texas,Medina County,0,50921,26276,24645
Texas,Medina County,1,3065,1535,1530
Texas,Medina County,2,3101,1619,1482
Texas,Medina County,3,3384,1703,1681
Texas,Medina County,4,3690,2001,1689
Texas,Medina County,5,3459,2121,1338
Texas,Medina County,6,3220,1788,1432
Texas,Medina County,7,3062,1637,1425
Texas,Medina County,8,2967,1509,1458
Texas,Medina County,9,2915,1524,1391
Texas,Medina County,10,3377,1729,1648
Texas,Medina County,11,3337,1675,1662
Texas,Medina County,12,3612,1848,1764
Texas,Medina County,13,3243,1576,1667
Texas,Medina County,14,2782,1375,1407
Texas,Medina County,15,2298,1150,1148
Texas,Medina County,16,1451,686,765
Texas,Medina County,17,988,443,545
Texas,Medina County,18,970,357,613
Texas,Menard County,0,2139,1062,1077
Texas,Menard County,1,91,50,41
Texas,Menard County,2,107,54,53
Texas,Menard County,3,120,69,51
Texas,Menard County,4,103,45,58
Texas,Menard County,5,87,49,38
Texas,Menard County,6,103,57,46
Texas,Menard County,7,81,45,36
Texas,Menard County,8,97,41,56
Texas,Menard County,9,87,33,54
Texas,Menard County,10,106,42,64
Texas,Menard County,11,113,59,54
Texas,Menard County,12,183,81,102
Texas,Menard County,13,182,90,92
Texas,Menard County,14,170,83,87
Texas,Menard County,15,181,105,76
Texas,Menard County,16,139,70,69
Texas,Menard County,17,81,37,44
Texas,Menard County,18,108,52,56
Texas,Midland County,0,172578,87103,85475
Texas,Midland County,1,15256,7802,7454
Texas,Midland County,2,14242,7248,6994
Texas,Midland County,3,12751,6521,6230
Texas,Midland County,4,10997,5609,5388
Texas,Midland County,5,10999,5602,5397
Texas,Midland County,6,15687,8183,7504
Texas,Midland County,7,15487,8228,7259
Texas,Midland County,8,13108,6960,6148
Texas,Midland County,9,10196,5328,4868
Texas,Midland County,10,9192,4660,4532
Texas,Midland County,11,8546,4229,4317
Texas,Midland County,12,9624,4615,5009
Texas,Midland County,13,8694,4315,4379
Texas,Midland County,14,5976,2861,3115
Texas,Midland County,15,4058,1884,2174
Texas,Midland County,16,2832,1197,1635
Texas,Midland County,17,2294,905,1389
Texas,Midland County,18,2639,956,1683
Texas,Milam County,0,25131,12385,12746
Texas,Milam County,1,1579,795,784
Texas,Milam County,2,1621,824,797
Texas,Milam County,3,1815,936,879
Texas,Milam County,4,1747,962,785
Texas,Milam County,5,1362,728,634
Texas,Milam County,6,1328,630,698
Texas,Milam County,7,1366,713,653
Texas,Milam County,8,1439,676,763
Texas,Milam County,9,1326,637,689
Texas,Milam County,10,1436,687,749
Texas,Milam County,11,1485,709,776
Texas,Milam County,12,1769,877,892
Texas,Milam County,13,1760,859,901
Texas,Milam County,14,1598,753,845
Texas,Milam County,15,1301,658,643
Texas,Milam County,16,880,433,447
Texas,Milam County,17,643,273,370
Texas,Milam County,18,676,235,441
Texas,Mills County,0,4921,2456,2465
Texas,Mills County,1,223,133,90
Texas,Mills County,2,235,143,92
Texas,Mills County,3,367,179,188
Texas,Mills County,4,295,148,147
Texas,Mills County,5,223,111,112
Texas,Mills County,6,213,119,94
Texas,Mills County,7,189,91,98
Texas,Mills County,8,231,103,128
Texas,Mills County,9,233,111,122
Texas,Mills County,10,270,125,145
Texas,Mills County,11,319,166,153
Texas,Mills County,12,358,167,191
Texas,Mills County,13,359,178,181
Texas,Mills County,14,415,202,213
Texas,Mills County,15,339,168,171
Texas,Mills County,16,288,156,132
Texas,Mills County,17,159,73,86
Texas,Mills County,18,205,83,122
Texas,Mitchell County,0,8145,4751,3394
Texas,Mitchell County,1,469,237,232
Texas,Mitchell County,2,523,267,256
Texas,Mitchell County,3,486,257,229
Texas,Mitchell County,4,481,263,218
Texas,Mitchell County,5,701,532,169
Texas,Mitchell County,6,743,545,198
Texas,Mitchell County,7,609,417,192
Texas,Mitchell County,8,561,351,210
Texas,Mitchell County,9,492,331,161
Texas,Mitchell County,10,492,278,214
Texas,Mitchell County,11,466,276,190
Texas,Mitchell County,12,463,236,227
Texas,Mitchell County,13,419,196,223
Texas,Mitchell County,14,410,200,210
Texas,Mitchell County,15,306,155,151
Texas,Mitchell County,16,222,99,123
Texas,Mitchell County,17,163,67,96
Texas,Mitchell County,18,139,44,95
Texas,Montague County,0,19596,9618,9978
Texas,Montague County,1,1175,565,610
Texas,Montague County,2,1212,596,616
Texas,Montague County,3,1306,677,629
Texas,Montague County,4,1173,602,571
Texas,Montague County,5,966,471,495
Texas,Montague County,6,1105,542,563
Texas,Montague County,7,1084,543,541
Texas,Montague County,8,1051,517,534
Texas,Montague County,9,1023,511,512
Texas,Montague County,10,1115,553,562
Texas,Montague County,11,1254,621,633
Texas,Montague County,12,1419,731,688
Texas,Montague County,13,1398,673,725
Texas,Montague County,14,1233,573,660
Texas,Montague County,15,1215,596,619
Texas,Montague County,16,792,391,401
Texas,Montague County,17,586,256,330
Texas,Montague County,18,489,200,289
Texas,Montgomery County,0,590925,292758,298167
Texas,Montgomery County,1,40154,20588,19566
Texas,Montgomery County,2,43390,22040,21350
Texas,Montgomery County,3,45276,23126,22150
Texas,Montgomery County,4,41348,21113,20235
Texas,Montgomery County,5,34288,17314,16974
Texas,Montgomery County,6,37234,18808,18426
Texas,Montgomery County,7,37938,18801,19137
Texas,Montgomery County,8,41500,20606,20894
Texas,Montgomery County,9,39592,19654,19938
Texas,Montgomery County,10,41324,20425,20899
Texas,Montgomery County,11,38653,19270,19383
Texas,Montgomery County,12,38705,19097,19608
Texas,Montgomery County,13,34260,16837,17423
Texas,Montgomery County,14,27191,12892,14299
Texas,Montgomery County,15,21211,9992,11219
Texas,Montgomery County,16,13836,6278,7558
Texas,Montgomery County,17,7846,3371,4475
Texas,Montgomery County,18,7179,2546,4633
Texas,Moore County,0,21485,11160,10325
Texas,Moore County,1,2141,1038,1103
Texas,Moore County,2,1842,955,887
Texas,Moore County,3,1847,976,871
Texas,Moore County,4,1611,854,757
Texas,Moore County,5,1391,741,650
Texas,Moore County,6,1585,843,742
Texas,Moore County,7,1420,809,611
Texas,Moore County,8,1457,791,666
Texas,Moore County,9,1281,670,611
Texas,Moore County,10,1181,648,533
Texas,Moore County,11,1135,609,526
Texas,Moore County,12,1157,573,584
Texas,Moore County,13,1094,546,548
Texas,Moore County,14,803,403,400
Texas,Moore County,15,556,262,294
Texas,Moore County,16,406,190,216
Texas,Moore County,17,288,122,166
Texas,Moore County,18,290,130,160
Texas,Morris County,0,12339,5934,6405
Texas,Morris County,1,701,375,326
Texas,Morris County,2,824,415,409
Texas,Morris County,3,815,405,410
Texas,Morris County,4,729,389,340
Texas,Morris County,5,634,316,318
Texas,Morris County,6,716,346,370
Texas,Morris County,7,636,325,311
Texas,Morris County,8,736,360,376
Texas,Morris County,9,660,284,376
Texas,Morris County,10,683,319,364
Texas,Morris County,11,702,332,370
Texas,Morris County,12,877,414,463
Texas,Morris County,13,923,416,507
Texas,Morris County,14,794,377,417
Texas,Morris County,15,678,319,359
Texas,Morris County,16,498,241,257
Texas,Morris County,17,420,195,225
Texas,Morris County,18,313,106,207
Texas,Motley County,0,1234,634,600
Texas,Motley County,1,58,31,27
Texas,Motley County,2,56,31,25
Texas,Motley County,3,84,45,39
Texas,Motley County,4,76,38,38
Texas,Motley County,5,59,38,21
Texas,Motley County,6,55,28,27
Texas,Motley County,7,65,36,29
Texas,Motley County,8,48,20,28
Texas,Motley County,9,50,23,27
Texas,Motley County,10,77,39,38
Texas,Motley County,11,52,35,17
Texas,Motley County,12,96,52,44
Texas,Motley County,13,84,37,47
Texas,Motley County,14,123,57,66
Texas,Motley County,15,84,46,38
Texas,Motley County,16,75,32,43
Texas,Motley County,17,46,22,24
Texas,Motley County,18,46,24,22
Texas,Nacogdoches County,0,65711,31479,34232
Texas,Nacogdoches County,1,4265,2149,2116
Texas,Nacogdoches County,2,4365,2198,2167
Texas,Nacogdoches County,3,4243,2202,2041
Texas,Nacogdoches County,4,6433,2845,3588
Texas,Nacogdoches County,5,8538,4027,4511
Texas,Nacogdoches County,6,4200,2113,2087
Texas,Nacogdoches County,7,3377,1664,1713
Texas,Nacogdoches County,8,3553,1752,1801
Texas,Nacogdoches County,9,3190,1465,1725
Texas,Nacogdoches County,10,3204,1543,1661
Texas,Nacogdoches County,11,3356,1661,1695
Texas,Nacogdoches County,12,3659,1770,1889
Texas,Nacogdoches County,13,3643,1709,1934
Texas,Nacogdoches County,14,3235,1568,1667
Texas,Nacogdoches County,15,2510,1219,1291
Texas,Nacogdoches County,16,1659,731,928
Texas,Nacogdoches County,17,1113,439,674
Texas,Nacogdoches County,18,1168,424,744
Texas,Navarro County,0,49565,24313,25252
Texas,Navarro County,1,3708,1802,1906
Texas,Navarro County,2,3510,1819,1691
Texas,Navarro County,3,3700,1903,1797
Texas,Navarro County,4,3485,1874,1611
Texas,Navarro County,5,3027,1555,1472
Texas,Navarro County,6,2973,1460,1513
Texas,Navarro County,7,2843,1343,1500
Texas,Navarro County,8,2828,1336,1492
Texas,Navarro County,9,2727,1287,1440
Texas,Navarro County,10,2988,1472,1516
Texas,Navarro County,11,2965,1508,1457
Texas,Navarro County,12,3303,1591,1712
Texas,Navarro County,13,3079,1523,1556
Texas,Navarro County,14,2725,1313,1412
Texas,Navarro County,15,2199,1065,1134
Texas,Navarro County,16,1575,713,862
Texas,Navarro County,17,976,420,556
Texas,Navarro County,18,954,329,625
Texas,Newton County,0,13746,7066,6680
Texas,Newton County,1,681,347,334
Texas,Newton County,2,784,404,380
Texas,Newton County,3,752,378,374
Texas,Newton County,4,880,460,420
Texas,Newton County,5,838,499,339
Texas,Newton County,6,885,504,381
Texas,Newton County,7,747,425,322
Texas,Newton County,8,792,431,361
Texas,Newton County,9,713,350,363
Texas,Newton County,10,855,463,392
Texas,Newton County,11,957,487,470
Texas,Newton County,12,1026,502,524
Texas,Newton County,13,1015,493,522
Texas,Newton County,14,882,419,463
Texas,Newton County,15,734,352,382
Texas,Newton County,16,551,274,277
Texas,Newton County,17,362,165,197
Texas,Newton County,18,292,113,179
Texas,Nolan County,0,14751,7370,7381
Texas,Nolan County,1,1063,551,512
Texas,Nolan County,2,1044,520,524
Texas,Nolan County,3,1116,572,544
Texas,Nolan County,4,1064,592,472
Texas,Nolan County,5,873,490,383
Texas,Nolan County,6,848,457,391
Texas,Nolan County,7,874,435,439
Texas,Nolan County,8,880,436,444
Texas,Nolan County,9,800,391,409
Texas,Nolan County,10,824,403,421
Texas,Nolan County,11,840,413,427
Texas,Nolan County,12,911,434,477
Texas,Nolan County,13,920,451,469
Texas,Nolan County,14,824,393,431
Texas,Nolan County,15,674,335,339
Texas,Nolan County,16,524,250,274
Texas,Nolan County,17,327,135,192
Texas,Nolan County,18,345,112,233
Texas,Nueces County,0,362265,179134,183131
Texas,Nueces County,1,24433,12529,11904
Texas,Nueces County,2,24323,12475,11848
Texas,Nueces County,3,24871,12825,12046
Texas,Nueces County,4,25605,13134,12471
Texas,Nueces County,5,25878,13082,12796
Texas,Nueces County,6,26818,13937,12881
Texas,Nueces County,7,25155,12784,12371
Texas,Nueces County,8,24840,12493,12347
Texas,Nueces County,9,21702,10660,11042
Texas,Nueces County,10,21488,10515,10973
Texas,Nueces County,11,20725,10145,10580
Texas,Nueces County,12,22654,10975,11679
Texas,Nueces County,13,21558,10377,11181
Texas,Nueces County,14,17193,8219,8974
Texas,Nueces County,15,13623,6403,7220
Texas,Nueces County,16,8833,3912,4921
Texas,Nueces County,17,6119,2453,3666
Texas,Nueces County,18,6447,2216,4231
Texas,Ochiltree County,0,9947,5030,4917
Texas,Ochiltree County,1,858,424,434
Texas,Ochiltree County,2,833,410,423
Texas,Ochiltree County,3,958,489,469
Texas,Ochiltree County,4,781,414,367
Texas,Ochiltree County,5,635,331,304
Texas,Ochiltree County,6,631,323,308
Texas,Ochiltree County,7,637,326,311
Texas,Ochiltree County,8,595,293,302
Texas,Ochiltree County,9,652,336,316
Texas,Ochiltree County,10,567,296,271
Texas,Ochiltree County,11,557,293,264
Texas,Ochiltree County,12,595,304,291
Texas,Ochiltree County,13,540,275,265
Texas,Ochiltree County,14,367,180,187
Texas,Ochiltree County,15,293,147,146
Texas,Ochiltree County,16,219,90,129
Texas,Ochiltree County,17,116,52,64
Texas,Ochiltree County,18,113,47,66
Texas,Oldham County,0,2131,1109,1022
Texas,Oldham County,1,98,49,49
Texas,Oldham County,2,83,40,43
Texas,Oldham County,3,179,114,65
Texas,Oldham County,4,211,140,71
Texas,Oldham County,5,109,60,49
Texas,Oldham County,6,118,47,71
Texas,Oldham County,7,123,59,64
Texas,Oldham County,8,182,95,87
Texas,Oldham County,9,116,53,63
Texas,Oldham County,10,152,75,77
Texas,Oldham County,11,133,59,74
Texas,Oldham County,12,163,93,70
Texas,Oldham County,13,145,72,73
Texas,Oldham County,14,104,56,48
Texas,Oldham County,15,91,48,43
Texas,Oldham County,16,55,18,37
Texas,Oldham County,17,37,17,20
Texas,Oldham County,18,32,14,18
Texas,Orange County,0,83572,41439,42133
Texas,Orange County,1,5725,2939,2786
Texas,Orange County,2,5778,2977,2801
Texas,Orange County,3,5756,3002,2754
Texas,Orange County,4,5292,2770,2522
Texas,Orange County,5,4849,2459,2390
Texas,Orange County,6,5654,2925,2729
Texas,Orange County,7,5377,2635,2742
Texas,Orange County,8,5269,2612,2657
Texas,Orange County,9,4897,2425,2472
Texas,Orange County,10,5174,2595,2579
Texas,Orange County,11,5201,2560,2641
Texas,Orange County,12,5729,2849,2880
Texas,Orange County,13,5405,2627,2778
Texas,Orange County,14,4353,2099,2254
Texas,Orange County,15,3393,1575,1818
Texas,Orange County,16,2491,1144,1347
Texas,Orange County,17,1699,694,1005
Texas,Orange County,18,1530,552,978
Texas,Palo Pinto County,0,28875,14235,14640
Texas,Palo Pinto County,1,1771,920,851
Texas,Palo Pinto County,2,1897,1053,844
Texas,Palo Pinto County,3,1914,969,945
Texas,Palo Pinto County,4,1803,903,900
Texas,Palo Pinto County,5,1736,901,835
Texas,Palo Pinto County,6,1818,908,910
Texas,Palo Pinto County,7,1635,852,783
Texas,Palo Pinto County,8,1509,685,824
Texas,Palo Pinto County,9,1508,720,788
Texas,Palo Pinto County,10,1686,817,869
Texas,Palo Pinto County,11,1770,831,939
Texas,Palo Pinto County,12,2102,1024,1078
Texas,Palo Pinto County,13,2087,994,1093
Texas,Palo Pinto County,14,1766,856,910
Texas,Palo Pinto County,15,1598,801,797
Texas,Palo Pinto County,16,1067,507,560
Texas,Palo Pinto County,17,630,276,354
Texas,Palo Pinto County,18,578,218,360
Texas,Panola County,0,23148,11456,11692
Texas,Panola County,1,1364,726,638
Texas,Panola County,2,1406,695,711
Texas,Panola County,3,1639,852,787
Texas,Panola County,4,1612,826,786
Texas,Panola County,5,1323,700,623
Texas,Panola County,6,1322,690,632
Texas,Panola County,7,1277,664,613
Texas,Panola County,8,1427,699,728
Texas,Panola County,9,1340,640,700
Texas,Panola County,10,1329,653,676
Texas,Panola County,11,1374,653,721
Texas,Panola County,12,1598,774,824
Texas,Panola County,13,1699,827,872
Texas,Panola County,14,1485,733,752
Texas,Panola County,15,1115,555,560
Texas,Panola County,16,827,355,472
Texas,Panola County,17,569,239,330
Texas,Panola County,18,442,175,267
Texas,Parker County,0,138371,68872,69499
Texas,Parker County,1,8698,4461,4237
Texas,Parker County,2,9447,4921,4526
Texas,Parker County,3,10151,5162,4989
Texas,Parker County,4,9353,4815,4538
Texas,Parker County,5,7434,3871,3563
Texas,Parker County,6,7749,3880,3869
Texas,Parker County,7,8504,4119,4385
Texas,Parker County,8,9154,4553,4601
Texas,Parker County,9,8360,4137,4223
Texas,Parker County,10,9364,4517,4847
Texas,Parker County,11,9606,4822,4784
Texas,Parker County,12,10241,5160,5081
Texas,Parker County,13,9008,4365,4643
Texas,Parker County,14,7313,3522,3791
Texas,Parker County,15,5760,2840,2920
Texas,Parker County,16,3842,1874,1968
Texas,Parker County,17,2340,1046,1294
Texas,Parker County,18,2047,807,1240
Texas,Parmer County,0,9864,5123,4741
Texas,Parmer County,1,790,427,363
Texas,Parmer County,2,767,395,372
Texas,Parmer County,3,780,407,373
Texas,Parmer County,4,747,387,360
Texas,Parmer County,5,644,361,283
Texas,Parmer County,6,668,399,269
Texas,Parmer County,7,608,308,300
Texas,Parmer County,8,628,335,293
Texas,Parmer County,9,543,299,244
Texas,Parmer County,10,549,267,282
Texas,Parmer County,11,609,304,305
Texas,Parmer County,12,619,305,314
Texas,Parmer County,13,557,301,256
Texas,Parmer County,14,409,201,208
Texas,Parmer County,15,326,168,158
Texas,Parmer County,16,271,124,147
Texas,Parmer County,17,188,83,105
Texas,Parmer County,18,161,52,109
Texas,Pecos County,0,15673,8912,6761
Texas,Pecos County,1,1025,520,505
Texas,Pecos County,2,1115,551,564
Texas,Pecos County,3,1098,572,526
Texas,Pecos County,4,955,500,455
Texas,Pecos County,5,946,559,387
Texas,Pecos County,6,1191,741,450
Texas,Pecos County,7,1266,788,478
Texas,Pecos County,8,1237,795,442
Texas,Pecos County,9,1056,693,363
Texas,Pecos County,10,995,635,360
Texas,Pecos County,11,1002,587,415
Texas,Pecos County,12,894,496,398
Texas,Pecos County,13,792,431,361
Texas,Pecos County,14,676,333,343
Texas,Pecos County,15,535,279,256
Texas,Pecos County,16,400,179,221
Texas,Pecos County,17,262,147,115
Texas,Pecos County,18,228,106,122
Texas,Polk County,0,50031,26937,23094
Texas,Polk County,1,2713,1336,1377
Texas,Polk County,2,2776,1453,1323
Texas,Polk County,3,2936,1582,1354
Texas,Polk County,4,2657,1442,1215
Texas,Polk County,5,2767,1649,1118
Texas,Polk County,6,3045,1797,1248
Texas,Polk County,7,3006,1772,1234
Texas,Polk County,8,3080,1844,1236
Texas,Polk County,9,2801,1629,1172
Texas,Polk County,10,3084,1766,1318
Texas,Polk County,11,3277,1733,1544
Texas,Polk County,12,3950,1878,2072
Texas,Polk County,13,4517,2242,2275
Texas,Polk County,14,3875,1974,1901
Texas,Polk County,15,2684,1427,1257
Texas,Polk County,16,1517,804,713
Texas,Polk County,17,756,374,382
Texas,Polk County,18,590,235,355
Texas,Potter County,0,119648,61609,58039
Texas,Potter County,1,9313,4758,4555
Texas,Potter County,2,9505,4873,4632
Texas,Potter County,3,9047,4608,4439
Texas,Potter County,4,7832,3948,3884
Texas,Potter County,5,7945,4166,3779
Texas,Potter County,6,9306,4885,4421
Texas,Potter County,7,8825,4859,3966
Texas,Potter County,8,8396,4626,3770
Texas,Potter County,9,7264,3942,3322
Texas,Potter County,10,7190,3969,3221
Texas,Potter County,11,6787,3679,3108
Texas,Potter County,12,6908,3493,3415
Texas,Potter County,13,6408,3170,3238
Texas,Potter County,14,4970,2423,2547
Texas,Potter County,15,3627,1650,1977
Texas,Potter County,16,2528,1122,1406
Texas,Potter County,17,1810,742,1068
Texas,Potter County,18,1987,696,1291
Texas,Presidio County,0,6948,3557,3391
Texas,Presidio County,1,559,278,281
Texas,Presidio County,2,491,269,222
Texas,Presidio County,3,520,298,222
Texas,Presidio County,4,433,223,210
Texas,Presidio County,5,392,191,201
Texas,Presidio County,6,346,183,163
Texas,Presidio County,7,388,216,172
Texas,Presidio County,8,405,231,174
Texas,Presidio County,9,359,163,196
Texas,Presidio County,10,363,174,189
Texas,Presidio County,11,370,171,199
Texas,Presidio County,12,347,168,179
Texas,Presidio County,13,368,185,183
Texas,Presidio County,14,397,202,195
Texas,Presidio County,15,376,204,172
Texas,Presidio County,16,312,140,172
Texas,Presidio County,17,244,136,108
Texas,Presidio County,18,278,125,153
Texas,Rains County,0,12159,6044,6115
Texas,Rains County,1,584,309,275
Texas,Rains County,2,723,386,337
Texas,Rains County,3,691,369,322
Texas,Rains County,4,648,325,323
Texas,Rains County,5,560,294,266
Texas,Rains County,6,618,296,322
Texas,Rains County,7,647,307,340
Texas,Rains County,8,656,324,332
Texas,Rains County,9,596,296,300
Texas,Rains County,10,708,346,362
Texas,Rains County,11,742,377,365
Texas,Rains County,12,992,498,494
Texas,Rains County,13,1011,464,547
Texas,Rains County,14,989,484,505
Texas,Rains County,15,844,419,425
Texas,Rains County,16,549,281,268
Texas,Rains County,17,359,151,208
Texas,Rains County,18,242,118,124
Texas,Randall County,0,136271,67024,69247
Texas,Randall County,1,8790,4523,4267
Texas,Randall County,2,8995,4542,4453
Texas,Randall County,3,9342,4761,4581
Texas,Randall County,4,9559,4870,4689
Texas,Randall County,5,9316,4724,4592
Texas,Randall County,6,9974,5037,4937
Texas,Randall County,7,10044,5056,4988
Texas,Randall County,8,9798,4962,4836
Texas,Randall County,9,8185,4147,4038
Texas,Randall County,10,7815,3850,3965
Texas,Randall County,11,7494,3608,3886
Texas,Randall County,12,8340,4004,4336
Texas,Randall County,13,8083,3831,4252
Texas,Randall County,14,6918,3255,3663
Texas,Randall County,15,5141,2385,2756
Texas,Randall County,16,3699,1597,2102
Texas,Randall County,17,2583,1055,1528
Texas,Randall County,18,2195,817,1378
Texas,Reagan County,0,3741,2001,1740
Texas,Reagan County,1,291,157,134
Texas,Reagan County,2,325,163,162
Texas,Reagan County,3,312,174,138
Texas,Reagan County,4,259,129,130
Texas,Reagan County,5,264,129,135
Texas,Reagan County,6,225,139,86
Texas,Reagan County,7,248,140,108
Texas,Reagan County,8,278,159,119
Texas,Reagan County,9,268,161,107
Texas,Reagan County,10,209,111,98
Texas,Reagan County,11,220,115,105
Texas,Reagan County,12,211,111,100
Texas,Reagan County,13,211,102,109
Texas,Reagan County,14,143,73,70
Texas,Reagan County,15,99,57,42
Texas,Reagan County,16,70,31,39
Texas,Reagan County,17,62,36,26
Texas,Reagan County,18,46,14,32
Texas,Real County,0,3478,1733,1745
Texas,Real County,1,153,83,70
Texas,Real County,2,158,96,62
Texas,Real County,3,175,91,84
Texas,Real County,4,157,87,70
Texas,Real County,5,157,72,85
Texas,Real County,6,157,75,82
Texas,Real County,7,141,69,72
Texas,Real County,8,165,81,84
Texas,Real County,9,153,73,80
Texas,Real County,10,202,91,111
Texas,Real County,11,218,113,105
Texas,Real County,12,267,126,141
Texas,Real County,13,350,179,171
Texas,Real County,14,321,151,170
Texas,Real County,15,278,133,145
Texas,Real County,16,191,96,95
Texas,Real County,17,150,85,65
Texas,Real County,18,85,32,53
Texas,Red River County,0,12175,5912,6263
Texas,Red River County,1,637,321,316
Texas,Red River County,2,679,337,342
Texas,Red River County,3,665,344,321
Texas,Red River County,4,673,367,306
Texas,Red River County,5,605,303,302
Texas,Red River County,6,650,322,328
Texas,Red River County,7,595,300,295
Texas,Red River County,8,646,312,334
Texas,Red River County,9,623,303,320
Texas,Red River County,10,735,352,383
Texas,Red River County,11,795,381,414
Texas,Red River County,12,950,452,498
Texas,Red River County,13,926,453,473
Texas,Red River County,14,854,415,439
Texas,Red River County,15,777,356,421
Texas,Red River County,16,588,272,316
Texas,Red River County,17,385,184,201
Texas,Red River County,18,392,138,254
Texas,Reeves County,0,15695,9632,6063
Texas,Reeves County,1,1026,516,510
Texas,Reeves County,2,967,521,446
Texas,Reeves County,3,955,489,466
Texas,Reeves County,4,941,542,399
Texas,Reeves County,5,1495,1087,408
Texas,Reeves County,6,1330,939,391
Texas,Reeves County,7,1367,996,371
Texas,Reeves County,8,1375,1007,368
Texas,Reeves County,9,1079,740,339
Texas,Reeves County,10,1058,715,343
Texas,Reeves County,11,847,495,352
Texas,Reeves County,12,730,411,319
Texas,Reeves County,13,646,309,337
Texas,Reeves County,14,569,313,256
Texas,Reeves County,15,430,182,248
Texas,Reeves County,16,374,167,207
Texas,Reeves County,17,252,110,142
Texas,Reeves County,18,254,93,161
Texas,Refugio County,0,7032,3450,3582
Texas,Refugio County,1,451,211,240
Texas,Refugio County,2,417,204,213
Texas,Refugio County,3,462,228,234
Texas,Refugio County,4,449,227,222
Texas,Refugio County,5,349,197,152
Texas,Refugio County,6,414,209,205
Texas,Refugio County,7,351,182,169
Texas,Refugio County,8,418,207,211
Texas,Refugio County,9,323,156,167
Texas,Refugio County,10,399,201,198
Texas,Refugio County,11,441,197,244
Texas,Refugio County,12,500,262,238
Texas,Refugio County,13,468,233,235
Texas,Refugio County,14,420,223,197
Texas,Refugio County,15,468,208,260
Texas,Refugio County,16,292,130,162
Texas,Refugio County,17,228,109,119
Texas,Refugio County,18,182,66,116
Texas,Roberts County,0,903,448,455
Texas,Roberts County,1,58,21,37
Texas,Roberts County,2,52,24,28
Texas,Roberts County,3,75,40,35
Texas,Roberts County,4,58,28,30
Texas,Roberts County,5,29,14,15
Texas,Roberts County,6,48,21,27
Texas,Roberts County,7,50,25,25
Texas,Roberts County,8,75,41,34
Texas,Roberts County,9,45,25,20
Texas,Roberts County,10,47,18,29
Texas,Roberts County,11,47,22,25
Texas,Roberts County,12,70,43,27
Texas,Roberts County,13,60,31,29
Texas,Roberts County,14,59,29,30
Texas,Roberts County,15,57,33,24
Texas,Roberts County,16,33,14,19
Texas,Roberts County,17,25,15,10
Texas,Roberts County,18,15,4,11
Texas,Robertson County,0,17284,8478,8806
Texas,Robertson County,1,1133,582,551
Texas,Robertson County,2,1150,586,564
Texas,Robertson County,3,1209,629,580
Texas,Robertson County,4,1043,544,499
Texas,Robertson County,5,899,459,440
Texas,Robertson County,6,1110,512,598
Texas,Robertson County,7,979,495,484
Texas,Robertson County,8,1060,517,543
Texas,Robertson County,9,953,442,511
Texas,Robertson County,10,971,461,510
Texas,Robertson County,11,1122,562,560
Texas,Robertson County,12,1127,549,578
Texas,Robertson County,13,1192,592,600
Texas,Robertson County,14,1049,505,544
Texas,Robertson County,15,861,435,426
Texas,Robertson County,16,596,268,328
Texas,Robertson County,17,398,173,225
Texas,Robertson County,18,432,167,265
Texas,Rockwall County,0,100657,49740,50917
Texas,Rockwall County,1,6338,3300,3038
Texas,Rockwall County,2,7297,3750,3547
Texas,Rockwall County,3,8476,4301,4175
Texas,Rockwall County,4,7613,3869,3744
Texas,Rockwall County,5,5521,2902,2619
Texas,Rockwall County,6,5039,2534,2505
Texas,Rockwall County,7,6153,2937,3216
Texas,Rockwall County,8,7596,3728,3868
Texas,Rockwall County,9,7428,3659,3769
Texas,Rockwall County,10,7607,3786,3821
Texas,Rockwall County,11,6825,3443,3382
Texas,Rockwall County,12,6618,3279,3339
Texas,Rockwall County,13,5552,2624,2928
Texas,Rockwall County,14,4304,2066,2238
Texas,Rockwall County,15,3355,1553,1802
Texas,Rockwall County,16,2300,1039,1261
Texas,Rockwall County,17,1306,529,777
Texas,Rockwall County,18,1329,441,888
Texas,Runnels County,0,10234,5203,5031
Texas,Runnels County,1,562,292,270
Texas,Runnels County,2,618,324,294
Texas,Runnels County,3,719,372,347
Texas,Runnels County,4,665,356,309
Texas,Runnels County,5,571,307,264
Texas,Runnels County,6,592,302,290
Texas,Runnels County,7,597,312,285
Texas,Runnels County,8,610,326,284
Texas,Runnels County,9,503,256,247
Texas,Runnels County,10,605,292,313
Texas,Runnels County,11,656,323,333
Texas,Runnels County,12,685,357,328
Texas,Runnels County,13,725,373,352
Texas,Runnels County,14,606,318,288
Texas,Runnels County,15,535,259,276
Texas,Runnels County,16,427,196,231
Texas,Runnels County,17,272,129,143
Texas,Runnels County,18,286,109,177
Texas,Rusk County,0,54450,29363,25087
Texas,Rusk County,1,3055,1573,1482
Texas,Rusk County,2,3442,1795,1647
Texas,Rusk County,3,3516,1770,1746
Texas,Rusk County,4,3391,1819,1572
Texas,Rusk County,5,3535,2259,1276
Texas,Rusk County,6,3785,2284,1501
Texas,Rusk County,7,3566,2071,1495
Texas,Rusk County,8,3611,1997,1614
Texas,Rusk County,9,3679,2136,1543
Texas,Rusk County,10,3489,2009,1480
Texas,Rusk County,11,3334,1874,1460
Texas,Rusk County,12,3625,1863,1762
Texas,Rusk County,13,3395,1722,1673
Texas,Rusk County,14,2936,1426,1510
Texas,Rusk County,15,2345,1127,1218
Texas,Rusk County,16,1635,761,874
Texas,Rusk County,17,1030,455,575
Texas,Rusk County,18,1081,422,659
Texas,Sabine County,0,10589,5213,5376
Texas,Sabine County,1,524,277,247
Texas,Sabine County,2,498,236,262
Texas,Sabine County,3,597,295,302
Texas,Sabine County,4,552,271,281
Texas,Sabine County,5,459,230,229
Texas,Sabine County,6,479,238,241
Texas,Sabine County,7,464,232,232
Texas,Sabine County,8,466,212,254
Texas,Sabine County,9,422,213,209
Texas,Sabine County,10,526,255,271
Texas,Sabine County,11,622,304,318
Texas,Sabine County,12,881,443,438
Texas,Sabine County,13,865,428,437
Texas,Sabine County,14,914,455,459
Texas,Sabine County,15,887,439,448
Texas,Sabine County,16,670,364,306
Texas,Sabine County,17,406,187,219
Texas,Sabine County,18,357,134,223
Texas,San Augustine County,0,8232,4052,4180
Texas,San Augustine County,1,421,215,206
Texas,San Augustine County,2,454,224,230
Texas,San Augustine County,3,460,242,218
Texas,San Augustine County,4,446,248,198
Texas,San Augustine County,5,349,168,181
Texas,San Augustine County,6,469,238,231
Texas,San Augustine County,7,380,198,182
Texas,San Augustine County,8,367,156,211
Texas,San Augustine County,9,366,187,179
Texas,San Augustine County,10,433,196,237
Texas,San Augustine County,11,552,280,272
Texas,San Augustine County,12,691,344,347
Texas,San Augustine County,13,667,333,334
Texas,San Augustine County,14,603,319,284
Texas,San Augustine County,15,538,255,283
Texas,San Augustine County,16,444,211,233
Texas,San Augustine County,17,277,122,155
Texas,San Augustine County,18,315,116,199
Texas,San Jacinto County,0,28719,14249,14470
Texas,San Jacinto County,1,1601,793,808
Texas,San Jacinto County,2,1671,856,815
Texas,San Jacinto County,3,1827,939,888
Texas,San Jacinto County,4,1679,868,811
Texas,San Jacinto County,5,1548,788,760
Texas,San Jacinto County,6,1558,769,789
Texas,San Jacinto County,7,1453,708,745
Texas,San Jacinto County,8,1473,710,763
Texas,San Jacinto County,9,1505,725,780
Texas,San Jacinto County,10,1692,845,847
Texas,San Jacinto County,11,1710,819,891
Texas,San Jacinto County,12,2379,1189,1190
Texas,San Jacinto County,13,2343,1179,1164
Texas,San Jacinto County,14,2093,1012,1081
Texas,San Jacinto County,15,1672,825,847
Texas,San Jacinto County,16,1201,612,589
Texas,San Jacinto County,17,732,340,392
Texas,San Jacinto County,18,582,272,310
Texas,San Patricio County,0,66893,33652,33241
Texas,San Patricio County,1,4902,2513,2389
Texas,San Patricio County,2,4846,2577,2269
Texas,San Patricio County,3,5093,2604,2489
Texas,San Patricio County,4,4771,2438,2333
Texas,San Patricio County,5,4084,2165,1919
Texas,San Patricio County,6,4411,2292,2119
Texas,San Patricio County,7,4490,2325,2165
Texas,San Patricio County,8,4551,2294,2257
Texas,San Patricio County,9,4033,2098,1935
Texas,San Patricio County,10,4019,1998,2021
Texas,San Patricio County,11,3854,1881,1973
Texas,San Patricio County,12,4122,1997,2125
Texas,San Patricio County,13,3696,1849,1847
Texas,San Patricio County,14,3180,1574,1606
Texas,San Patricio County,15,2806,1317,1489
Texas,San Patricio County,16,1815,827,988
Texas,San Patricio County,17,1195,507,688
Texas,San Patricio County,18,1025,396,629
Texas,San Saba County,0,6054,3308,2746
Texas,San Saba County,1,312,162,150
Texas,San Saba County,2,319,164,155
Texas,San Saba County,3,353,170,183
Texas,San Saba County,4,354,204,150
Texas,San Saba County,5,460,335,125
Texas,San Saba County,6,481,344,137
Texas,San Saba County,7,416,284,132
Texas,San Saba County,8,285,168,117
Texas,San Saba County,9,229,107,122
Texas,San Saba County,10,328,166,162
Texas,San Saba County,11,315,174,141
Texas,San Saba County,12,377,172,205
Texas,San Saba County,13,379,175,204
Texas,San Saba County,14,398,203,195
Texas,San Saba County,15,404,196,208
Texas,San Saba County,16,257,132,125
Texas,San Saba County,17,182,82,100
Texas,San Saba County,18,205,70,135
Texas,Schleicher County,0,2895,1436,1459
Texas,Schleicher County,1,150,75,75
Texas,Schleicher County,2,189,82,107
Texas,Schleicher County,3,252,138,114
Texas,Schleicher County,4,238,106,132
Texas,Schleicher County,5,136,68,68
Texas,Schleicher County,6,157,72,85
Texas,Schleicher County,7,190,101,89
Texas,Schleicher County,8,194,104,90
Texas,Schleicher County,9,144,70,74
Texas,Schleicher County,10,174,84,90
Texas,Schleicher County,11,161,82,79
Texas,Schleicher County,12,179,92,87
Texas,Schleicher County,13,164,78,86
Texas,Schleicher County,14,201,106,95
Texas,Schleicher County,15,152,84,68
Texas,Schleicher County,16,110,49,61
Texas,Schleicher County,17,55,16,39
Texas,Schleicher County,18,49,29,20
Texas,Scurry County,0,16866,9148,7718
Texas,Scurry County,1,1166,578,588
Texas,Scurry County,2,1191,621,570
Texas,Scurry County,3,1217,652,565
Texas,Scurry County,4,1128,595,533
Texas,Scurry County,5,1149,662,487
Texas,Scurry County,6,1173,703,470
Texas,Scurry County,7,1067,620,447
Texas,Scurry County,8,1221,730,491
Texas,Scurry County,9,1029,627,402
Texas,Scurry County,10,1015,622,393
Texas,Scurry County,11,961,538,423
Texas,Scurry County,12,1044,550,494
Texas,Scurry County,13,957,519,438
Texas,Scurry County,14,775,388,387
Texas,Scurry County,15,580,276,304
Texas,Scurry County,16,465,203,262
Texas,Scurry County,17,354,136,218
Texas,Scurry County,18,374,128,246
Texas,Shackelford County,0,3253,1572,1681
Texas,Shackelford County,1,172,87,85
Texas,Shackelford County,2,203,103,100
Texas,Shackelford County,3,231,116,115
Texas,Shackelford County,4,237,112,125
Texas,Shackelford County,5,143,67,76
Texas,Shackelford County,6,178,80,98
Texas,Shackelford County,7,186,103,83
Texas,Shackelford County,8,146,67,79
Texas,Shackelford County,9,188,89,99
Texas,Shackelford County,10,181,87,94
Texas,Shackelford County,11,179,93,86
Texas,Shackelford County,12,280,130,150
Texas,Shackelford County,13,264,136,128
Texas,Shackelford County,14,190,83,107
Texas,Shackelford County,15,164,88,76
Texas,Shackelford County,16,124,55,69
Texas,Shackelford County,17,109,52,57
Texas,Shackelford County,18,78,24,54
Texas,Shelby County,0,25418,12637,12781
Texas,Shelby County,1,1804,902,902
Texas,Shelby County,2,1747,911,836
Texas,Shelby County,3,1854,950,904
Texas,Shelby County,4,1744,908,836
Texas,Shelby County,5,1481,778,703
Texas,Shelby County,6,1625,815,810
Texas,Shelby County,7,1424,711,713
Texas,Shelby County,8,1433,733,700
Texas,Shelby County,9,1528,743,785
Texas,Shelby County,10,1532,770,762
Texas,Shelby County,11,1521,743,778
Texas,Shelby County,12,1692,849,843
Texas,Shelby County,13,1582,776,806
Texas,Shelby County,14,1410,669,741
Texas,Shelby County,15,1105,532,573
Texas,Shelby County,16,848,380,468
Texas,Shelby County,17,614,292,322
Texas,Shelby County,18,474,175,299
Texas,Sherman County,0,3079,1604,1475
Texas,Sherman County,1,210,94,116
Texas,Sherman County,2,241,133,108
Texas,Sherman County,3,278,146,132
Texas,Sherman County,4,216,130,86
Texas,Sherman County,5,180,95,85
Texas,Sherman County,6,185,104,81
Texas,Sherman County,7,167,82,85
Texas,Sherman County,8,174,87,87
Texas,Sherman County,9,161,92,69
Texas,Sherman County,10,198,102,96
Texas,Sherman County,11,230,111,119
Texas,Sherman County,12,189,100,89
Texas,Sherman County,13,191,107,84
Texas,Sherman County,14,136,72,64
Texas,Sherman County,15,114,55,59
Texas,Sherman County,16,86,38,48
Texas,Sherman County,17,55,29,26
Texas,Sherman County,18,68,27,41
Texas,Smith County,0,230221,111207,119014
Texas,Smith County,1,15891,8195,7696
Texas,Smith County,2,15402,7904,7498
Texas,Smith County,3,15845,8181,7664
Texas,Smith County,4,15960,7972,7988
Texas,Smith County,5,15515,7667,7848
Texas,Smith County,6,16390,7933,8457
Texas,Smith County,7,15049,7274,7775
Texas,Smith County,8,14321,6917,7404
Texas,Smith County,9,12876,6228,6648
Texas,Smith County,10,13685,6456,7229
Texas,Smith County,11,13215,6319,6896
Texas,Smith County,12,14167,6821,7346
Texas,Smith County,13,13895,6477,7418
Texas,Smith County,14,11695,5470,6225
Texas,Smith County,15,9595,4363,5232
Texas,Smith County,16,7125,3164,3961
Texas,Smith County,17,4856,2079,2777
Texas,Smith County,18,4739,1787,2952
Texas,Somervell County,0,9016,4442,4574
Texas,Somervell County,1,449,252,197
Texas,Somervell County,2,548,255,293
Texas,Somervell County,3,629,325,304
Texas,Somervell County,4,599,272,327
Texas,Somervell County,5,493,273,220
Texas,Somervell County,6,494,227,267
Texas,Somervell County,7,492,247,245
Texas,Somervell County,8,537,266,271
Texas,Somervell County,9,537,248,289
Texas,Somervell County,10,602,289,313
Texas,Somervell County,11,633,314,319
Texas,Somervell County,12,654,330,324
Texas,Somervell County,13,644,323,321
Texas,Somervell County,14,591,300,291
Texas,Somervell County,15,415,211,204
Texas,Somervell County,16,282,143,139
Texas,Somervell County,17,205,92,113
Texas,Somervell County,18,212,75,137
Texas,Starr County,0,64525,31430,33095
Texas,Starr County,1,6284,3113,3171
Texas,Starr County,2,6084,3045,3039
Texas,Starr County,3,5445,2705,2740
Texas,Starr County,4,5514,2736,2778
Texas,Starr County,5,5209,2652,2557
Texas,Starr County,6,4727,2458,2269
Texas,Starr County,7,3865,1983,1882
Texas,Starr County,8,3840,1940,1900
Texas,Starr County,9,3690,1792,1898
Texas,Starr County,10,3787,1835,1952
Texas,Starr County,11,3386,1524,1862
Texas,Starr County,12,2915,1326,1589
Texas,Starr County,13,2466,1143,1323
Texas,Starr County,14,2220,970,1250
Texas,Starr County,15,1903,831,1072
Texas,Starr County,16,1386,642,744
Texas,Starr County,17,945,405,540
Texas,Starr County,18,859,330,529
Texas,Stephens County,0,9433,4990,4443
Texas,Stephens County,1,506,269,237
Texas,Stephens County,2,551,286,265
Texas,Stephens County,3,635,323,312
Texas,Stephens County,4,583,317,266
Texas,Stephens County,5,627,408,219
Texas,Stephens County,6,616,382,234
Texas,Stephens County,7,570,314,256
Texas,Stephens County,8,629,370,259
Texas,Stephens County,9,522,281,241
Texas,Stephens County,10,495,254,241
Texas,Stephens County,11,532,297,235
Texas,Stephens County,12,686,330,356
Texas,Stephens County,13,617,301,316
Texas,Stephens County,14,576,286,290
Texas,Stephens County,15,464,220,244
Texas,Stephens County,16,353,170,183
Texas,Stephens County,17,229,94,135
Texas,Stephens County,18,242,88,154
Texas,Sterling County,0,1311,668,643
Texas,Sterling County,1,109,54,55
Texas,Sterling County,2,96,52,44
Texas,Sterling County,3,101,54,47
Texas,Sterling County,4,96,53,43
Texas,Sterling County,5,71,43,28
Texas,Sterling County,6,65,32,33
Texas,Sterling County,7,86,43,43
Texas,Sterling County,8,90,45,45
Texas,Sterling County,9,89,47,42
Texas,Sterling County,10,78,35,43
Texas,Sterling County,11,69,35,34
Texas,Sterling County,12,80,46,34
Texas,Sterling County,13,92,47,45
Texas,Sterling County,14,48,23,25
Texas,Sterling County,15,44,24,20
Texas,Sterling County,16,30,12,18
Texas,Sterling County,17,30,13,17
Texas,Sterling County,18,37,10,27
Texas,Stonewall County,0,1362,665,697
Texas,Stonewall County,1,79,42,37
Texas,Stonewall County,2,72,31,41
Texas,Stonewall County,3,90,42,48
Texas,Stonewall County,4,89,44,45
Texas,Stonewall County,5,52,32,20
Texas,Stonewall County,6,75,41,34
Texas,Stonewall County,7,43,20,23
Texas,Stonewall County,8,85,36,49
Texas,Stonewall County,9,55,28,27
Texas,Stonewall County,10,75,42,33
Texas,Stonewall County,11,88,46,42
Texas,Stonewall County,12,96,49,47
Texas,Stonewall County,13,102,50,52
Texas,Stonewall County,14,93,46,47
Texas,Stonewall County,15,94,39,55
Texas,Stonewall County,16,62,29,33
Texas,Stonewall County,17,46,19,27
Texas,Stonewall County,18,66,29,37
Texas,Sutton County,0,3758,1920,1838
Texas,Sutton County,1,240,120,120
Texas,Sutton County,2,242,130,112
Texas,Sutton County,3,245,124,121
Texas,Sutton County,4,273,128,145
Texas,Sutton County,5,186,107,79
Texas,Sutton County,6,226,118,108
Texas,Sutton County,7,214,126,88
Texas,Sutton County,8,190,91,99
Texas,Sutton County,9,200,96,104
Texas,Sutton County,10,268,144,124
Texas,Sutton County,11,240,116,124
Texas,Sutton County,12,270,142,128
Texas,Sutton County,13,274,134,140
Texas,Sutton County,14,213,107,106
Texas,Sutton County,15,188,99,89
Texas,Sutton County,16,111,55,56
Texas,Sutton County,17,77,44,33
Texas,Sutton County,18,101,39,62
Texas,Swisher County,0,7462,3975,3487
Texas,Swisher County,1,464,244,220
Texas,Swisher County,2,544,285,259
Texas,Swisher County,3,554,272,282
Texas,Swisher County,4,523,279,244
Texas,Swisher County,5,507,333,174
Texas,Swisher County,6,536,331,205
Texas,Swisher County,7,510,306,204
Texas,Swisher County,8,444,239,205
Texas,Swisher County,9,398,222,176
Texas,Swisher County,10,402,217,185
Texas,Swisher County,11,440,227,213
Texas,Swisher County,12,412,211,201
Texas,Swisher County,13,409,205,204
Texas,Swisher County,14,392,196,196
Texas,Swisher County,15,308,143,165
Texas,Swisher County,16,245,122,123
Texas,Swisher County,17,187,69,118
Texas,Swisher County,18,187,74,113
Texas,Tarrant County,0,2084931,1020097,1064834
Texas,Tarrant County,1,146515,75158,71357
Texas,Tarrant County,2,151170,76151,75019
Texas,Tarrant County,3,158807,81251,77556
Texas,Tarrant County,4,148283,74875,73408
Texas,Tarrant County,5,138294,68996,69298
Texas,Tarrant County,6,158507,78562,79945
Texas,Tarrant County,7,153889,75497,78392
Texas,Tarrant County,8,149575,72859,76716
Texas,Tarrant County,9,135794,65769,70025
Texas,Tarrant County,10,139287,68006,71281
Texas,Tarrant County,11,130752,64036,66716
Texas,Tarrant County,12,129737,63720,66017
Texas,Tarrant County,13,109134,52364,56770
Texas,Tarrant County,14,82589,38149,44440
Texas,Tarrant County,15,61851,28265,33586
Texas,Tarrant County,16,39821,17289,22532
Texas,Tarrant County,17,25289,10222,15067
Texas,Tarrant County,18,25637,8928,16709
Texas,Taylor County,0,137640,67226,70414
Texas,Taylor County,1,10099,5088,5011
Texas,Taylor County,2,9509,4813,4696
Texas,Taylor County,3,9228,4773,4455
Texas,Taylor County,4,10414,5186,5228
Texas,Taylor County,5,14335,7272,7063
Texas,Taylor County,6,10820,5581,5239
Texas,Taylor County,7,9394,4685,4709
Texas,Taylor County,8,8776,4362,4414
Texas,Taylor County,9,6849,3381,3468
Texas,Taylor County,10,6599,3243,3356
Texas,Taylor County,11,6768,3246,3522
Texas,Taylor County,12,7790,3702,4088
Texas,Taylor County,13,7274,3475,3799
Texas,Taylor County,14,5791,2626,3165
Texas,Taylor County,15,4904,2205,2699
Texas,Taylor County,16,3701,1587,2114
Texas,Taylor County,17,2627,1067,1560
Texas,Taylor County,18,2762,934,1828
Texas,Terrell County,0,823,421,402
Texas,Terrell County,1,42,21,21
Texas,Terrell County,2,58,28,30
Texas,Terrell County,3,42,21,21
Texas,Terrell County,4,40,25,15
Texas,Terrell County,5,41,28,13
Texas,Terrell County,6,30,10,20
Texas,Terrell County,7,42,23,19
Texas,Terrell County,8,43,19,24
Texas,Terrell County,9,52,28,24
Texas,Terrell County,10,45,26,19
Texas,Terrell County,11,46,25,21
Texas,Terrell County,12,42,19,23
Texas,Terrell County,13,56,31,25
Texas,Terrell County,14,73,38,35
Texas,Terrell County,15,67,32,35
Texas,Terrell County,16,41,20,21
Texas,Terrell County,17,22,11,11
Texas,Terrell County,18,41,16,25
Texas,Terry County,0,12287,6417,5870
Texas,Terry County,1,977,498,479
Texas,Terry County,2,935,467,468
Texas,Terry County,3,953,479,474
Texas,Terry County,4,860,434,426
Texas,Terry County,5,803,485,318
Texas,Terry County,6,891,511,380
Texas,Terry County,7,826,482,344
Texas,Terry County,8,787,458,329
Texas,Terry County,9,617,331,286
Texas,Terry County,10,666,384,282
Texas,Terry County,11,697,347,350
Texas,Terry County,12,739,377,362
Texas,Terry County,13,676,338,338
Texas,Terry County,14,553,275,278
Texas,Terry County,15,448,209,239
Texas,Terry County,16,354,153,201
Texas,Terry County,17,274,110,164
Texas,Terry County,18,231,79,152
Texas,Throckmorton County,0,1515,708,807
Texas,Throckmorton County,1,73,34,39
Texas,Throckmorton County,2,82,26,56
Texas,Throckmorton County,3,93,48,45
Texas,Throckmorton County,4,82,41,41
Texas,Throckmorton County,5,62,39,23
Texas,Throckmorton County,6,67,38,29
Texas,Throckmorton County,7,61,29,32
Texas,Throckmorton County,8,87,35,52
Texas,Throckmorton County,9,67,32,35
Texas,Throckmorton County,10,75,34,41
Texas,Throckmorton County,11,108,42,66
Texas,Throckmorton County,12,121,60,61
Texas,Throckmorton County,13,112,55,57
Texas,Throckmorton County,14,116,58,58
Texas,Throckmorton County,15,99,50,49
Texas,Throckmorton County,16,86,37,49
Texas,Throckmorton County,17,69,30,39
Texas,Throckmorton County,18,55,20,35
Texas,Titus County,0,33033,16186,16847
Texas,Titus County,1,2651,1306,1345
Texas,Titus County,2,2612,1314,1298
Texas,Titus County,3,2774,1392,1382
Texas,Titus County,4,2532,1299,1233
Texas,Titus County,5,2241,1126,1115
Texas,Titus County,6,2220,1069,1151
Texas,Titus County,7,1798,866,932
Texas,Titus County,8,1909,868,1041
Texas,Titus County,9,1940,973,967
Texas,Titus County,10,2075,1030,1045
Texas,Titus County,11,1964,1015,949
Texas,Titus County,12,1915,956,959
Texas,Titus County,13,1687,824,863
Texas,Titus County,14,1597,757,840
Texas,Titus County,15,1227,555,672
Texas,Titus County,16,821,390,431
Texas,Titus County,17,527,238,289
Texas,Titus County,18,543,208,335
Texas,Tom Green County,0,118189,58764,59425
Texas,Tom Green County,1,8001,4085,3916
Texas,Tom Green County,2,7903,4021,3882
Texas,Tom Green County,3,7983,4051,3932
Texas,Tom Green County,4,8950,4634,4316
Texas,Tom Green County,5,9229,4971,4258
Texas,Tom Green County,6,9382,4882,4500
Texas,Tom Green County,7,8938,4677,4261
Texas,Tom Green County,8,7744,3918,3826
Texas,Tom Green County,9,5977,3049,2928
Texas,Tom Green County,10,5998,2904,3094
Texas,Tom Green County,11,6160,2929,3231
Texas,Tom Green County,12,6976,3369,3607
Texas,Tom Green County,13,6681,3088,3593
Texas,Tom Green County,14,5738,2761,2977
Texas,Tom Green County,15,4542,2089,2453
Texas,Tom Green County,16,3190,1422,1768
Texas,Tom Green County,17,2407,1007,1400
Texas,Tom Green County,18,2390,907,1483
Texas,Travis County,0,1248743,631266,617477
Texas,Travis County,1,78436,40110,38326
Texas,Travis County,2,75376,38715,36661
Texas,Travis County,3,74197,37683,36514
Texas,Travis County,4,75309,37925,37384
Texas,Travis County,5,81968,41405,40563
Texas,Travis County,6,126669,65558,61111
Texas,Travis County,7,123833,64785,59048
Texas,Travis County,8,107698,56323,51375
Texas,Travis County,9,92210,47644,44566
Texas,Travis County,10,86388,44421,41967
Texas,Travis County,11,72618,36967,35651
Texas,Travis County,12,69492,34426,35066
Texas,Travis County,13,61154,29496,31658
Texas,Travis County,14,47714,22644,25070
Texas,Travis County,15,32024,15071,16953
Texas,Travis County,16,18820,8512,10308
Texas,Travis County,17,11805,4948,6857
Texas,Travis County,18,13032,4633,8399
Texas,Trinity County,0,14740,7105,7635
Texas,Trinity County,1,782,444,338
Texas,Trinity County,2,793,397,396
Texas,Trinity County,3,860,419,441
Texas,Trinity County,4,788,384,404
Texas,Trinity County,5,650,315,335
Texas,Trinity County,6,751,390,361
Texas,Trinity County,7,680,330,350
Texas,Trinity County,8,742,345,397
Texas,Trinity County,9,704,350,354
Texas,Trinity County,10,813,377,436
Texas,Trinity County,11,894,443,451
Texas,Trinity County,12,1163,519,644
Texas,Trinity County,13,1199,501,698
Texas,Trinity County,14,1238,598,640
Texas,Trinity County,15,1026,541,485
Texas,Trinity County,16,792,361,431
Texas,Trinity County,17,478,231,247
Texas,Trinity County,18,387,160,227
Texas,Tyler County,0,21696,11693,10003
Texas,Tyler County,1,1034,509,525
Texas,Tyler County,2,1207,613,594
Texas,Tyler County,3,1246,640,606
Texas,Tyler County,4,1131,603,528
Texas,Tyler County,5,1408,940,468
Texas,Tyler County,6,1620,1133,487
Texas,Tyler County,7,1326,873,453
Texas,Tyler County,8,1293,738,555
Texas,Tyler County,9,1191,687,504
Texas,Tyler County,10,1163,612,551
Texas,Tyler County,11,1289,657,632
Texas,Tyler County,12,1457,690,767
Texas,Tyler County,13,1485,749,736
Texas,Tyler County,14,1407,687,720
Texas,Tyler County,15,1264,585,679
Texas,Tyler County,16,975,473,502
Texas,Tyler County,17,654,309,345
Texas,Tyler County,18,546,195,351
Texas,Upshur County,0,41260,20387,20873
Texas,Upshur County,1,2431,1202,1229
Texas,Upshur County,2,2678,1368,1310
Texas,Upshur County,3,3000,1579,1421
Texas,Upshur County,4,2627,1404,1223
Texas,Upshur County,5,2196,1190,1006
Texas,Upshur County,6,2460,1182,1278
Texas,Upshur County,7,2291,1114,1177
Texas,Upshur County,8,2504,1242,1262
Texas,Upshur County,9,2285,1132,1153
Texas,Upshur County,10,2476,1215,1261
Texas,Upshur County,11,2536,1239,1297
Texas,Upshur County,12,3227,1548,1679
Texas,Upshur County,13,2973,1473,1500
Texas,Upshur County,14,2453,1178,1275
Texas,Upshur County,15,2033,955,1078
Texas,Upshur County,16,1352,629,723
Texas,Upshur County,17,961,451,510
Texas,Upshur County,18,777,286,491
Texas,Upton County,0,3671,1881,1790
Texas,Upton County,1,297,156,141
Texas,Upton County,2,319,175,144
Texas,Upton County,3,285,138,147
Texas,Upton County,4,267,135,132
Texas,Upton County,5,180,101,79
Texas,Upton County,6,240,123,117
Texas,Upton County,7,268,136,132
Texas,Upton County,8,231,124,107
Texas,Upton County,9,230,121,109
Texas,Upton County,10,199,91,108
Texas,Upton County,11,185,94,91
Texas,Upton County,12,198,90,108
Texas,Upton County,13,256,143,113
Texas,Upton County,14,148,70,78
Texas,Upton County,15,123,67,56
Texas,Upton County,16,102,58,44
Texas,Upton County,17,71,35,36
Texas,Upton County,18,72,24,48
Texas,Uvalde County,0,26846,13209,13637
Texas,Uvalde County,1,1959,984,975
Texas,Uvalde County,2,2041,1015,1026
Texas,Uvalde County,3,2032,1068,964
Texas,Uvalde County,4,2136,1076,1060
Texas,Uvalde County,5,1906,983,923
Texas,Uvalde County,6,1939,1013,926
Texas,Uvalde County,7,1614,822,792
Texas,Uvalde County,8,1490,734,756
Texas,Uvalde County,9,1498,750,748
Texas,Uvalde County,10,1514,707,807
Texas,Uvalde County,11,1374,670,704
Texas,Uvalde County,12,1424,664,760
Texas,Uvalde County,13,1401,709,692
Texas,Uvalde County,14,1262,563,699
Texas,Uvalde County,15,1207,558,649
Texas,Uvalde County,16,792,363,429
Texas,Uvalde County,17,583,263,320
Texas,Uvalde County,18,674,267,407
Texas,Val Verde County,0,49208,25156,24052
Texas,Val Verde County,1,4257,2151,2106
Texas,Val Verde County,2,3846,1972,1874
Texas,Val Verde County,3,3784,1937,1847
Texas,Val Verde County,4,3603,1869,1734
Texas,Val Verde County,5,4021,2306,1715
Texas,Val Verde County,6,3855,2168,1687
Texas,Val Verde County,7,3342,1868,1474
Texas,Val Verde County,8,3005,1563,1442
Texas,Val Verde County,9,2747,1391,1356
Texas,Val Verde County,10,2721,1352,1369
Texas,Val Verde County,11,2645,1348,1297
Texas,Val Verde County,12,2348,1102,1246
Texas,Val Verde County,13,2033,931,1102
Texas,Val Verde County,14,2006,938,1068
Texas,Val Verde County,15,1812,849,963
Texas,Val Verde County,16,1292,616,676
Texas,Val Verde County,17,919,411,508
Texas,Val Verde County,18,972,384,588
Texas,Van Zandt County,0,56019,27363,28656
Texas,Van Zandt County,1,3292,1669,1623
Texas,Van Zandt County,2,3406,1732,1674
Texas,Van Zandt County,3,3784,1871,1913
Texas,Van Zandt County,4,3772,1879,1893
Texas,Van Zandt County,5,2900,1495,1405
Texas,Van Zandt County,6,3075,1570,1505
Texas,Van Zandt County,7,2912,1462,1450
Texas,Van Zandt County,8,3145,1544,1601
Texas,Van Zandt County,9,3160,1537,1623
Texas,Van Zandt County,10,3593,1707,1886
Texas,Van Zandt County,11,3584,1720,1864
Texas,Van Zandt County,12,4166,2077,2089
Texas,Van Zandt County,13,3909,1865,2044
Texas,Van Zandt County,14,3497,1662,1835
Texas,Van Zandt County,15,2991,1425,1566
Texas,Van Zandt County,16,2143,970,1173
Texas,Van Zandt County,17,1482,724,758
Texas,Van Zandt County,18,1208,454,754
Texas,Victoria County,0,92035,45094,46941
Texas,Victoria County,1,6347,3276,3071
Texas,Victoria County,2,6533,3303,3230
Texas,Victoria County,3,6575,3376,3199
Texas,Victoria County,4,6393,3218,3175
Texas,Victoria County,5,5967,2997,2970
Texas,Victoria County,6,6740,3437,3303
Texas,Victoria County,7,6105,3105,3000
Texas,Victoria County,8,6000,2979,3021
Texas,Victoria County,9,5099,2510,2589
Texas,Victoria County,10,4978,2384,2594
Texas,Victoria County,11,5130,2478,2652
Texas,Victoria County,12,5783,2810,2973
Texas,Victoria County,13,5563,2671,2892
Texas,Victoria County,14,4633,2160,2473
Texas,Victoria County,15,3754,1722,2032
Texas,Victoria County,16,2655,1173,1482
Texas,Victoria County,17,1850,797,1053
Texas,Victoria County,18,1930,698,1232
Texas,Walker County,0,72480,42184,30296
Texas,Walker County,1,3120,1583,1537
Texas,Walker County,2,3019,1620,1399
Texas,Walker County,3,2927,1490,1437
Texas,Walker County,4,4970,2416,2554
Texas,Walker County,5,10431,5358,5073
Texas,Walker County,6,5841,3702,2139
Texas,Walker County,7,5079,3484,1595
Texas,Walker County,8,4823,3256,1567
Texas,Walker County,9,4702,3333,1369
Texas,Walker County,10,5165,3571,1594
Texas,Walker County,11,4762,3200,1562
Texas,Walker County,12,4318,2521,1797
Texas,Walker County,13,3752,2033,1719
Texas,Walker County,14,3350,1699,1651
Texas,Walker County,15,2384,1206,1178
Texas,Walker County,16,1808,871,937
Texas,Walker County,17,1016,438,578
Texas,Walker County,18,1013,403,610
Texas,Waller County,0,53126,26482,26644
Texas,Waller County,1,3527,1837,1690
Texas,Waller County,2,3621,1823,1798
Texas,Waller County,3,3696,1867,1829
Texas,Waller County,4,5598,2649,2949
Texas,Waller County,5,7201,3624,3577
Texas,Waller County,6,3102,1636,1466
Texas,Waller County,7,2829,1425,1404
Texas,Waller County,8,2965,1486,1479
Texas,Waller County,9,2674,1378,1296
Texas,Waller County,10,2817,1344,1473
Texas,Waller County,11,2937,1459,1478
Texas,Waller County,12,3037,1510,1527
Texas,Waller County,13,2840,1445,1395
Texas,Waller County,14,2166,1078,1088
Texas,Waller County,15,1703,822,881
Texas,Waller County,16,1134,552,582
Texas,Waller County,17,624,280,344
Texas,Waller County,18,655,267,388
Texas,Ward County,0,11720,5898,5822
Texas,Ward County,1,890,461,429
Texas,Ward County,2,962,490,472
Texas,Ward County,3,957,446,511
Texas,Ward County,4,840,439,401
Texas,Ward County,5,707,375,332
Texas,Ward County,6,826,433,393
Texas,Ward County,7,799,439,360
Texas,Ward County,8,876,451,425
Texas,Ward County,9,609,327,282
Texas,Ward County,10,653,335,318
Texas,Ward County,11,630,310,320
Texas,Ward County,12,728,354,374
Texas,Ward County,13,607,306,301
Texas,Ward County,14,512,232,280
Texas,Ward County,15,418,194,224
Texas,Ward County,16,274,130,144
Texas,Ward County,17,213,98,115
Texas,Ward County,18,219,78,141
Texas,Washington County,0,35108,17230,17878
Texas,Washington County,1,2038,1031,1007
Texas,Washington County,2,2183,1163,1020
Texas,Washington County,3,2128,1094,1034
Texas,Washington County,4,2793,1498,1295
Texas,Washington County,5,2104,1070,1034
Texas,Washington County,6,1789,877,912
Texas,Washington County,7,1904,945,959
Texas,Washington County,8,1854,903,951
Texas,Washington County,9,1839,906,933
Texas,Washington County,10,1886,947,939
Texas,Washington County,11,2020,988,1032
Texas,Washington County,12,2438,1206,1232
Texas,Washington County,13,2520,1176,1344
Texas,Washington County,14,2197,1076,1121
Texas,Washington County,15,1823,882,941
Texas,Washington County,16,1413,640,773
Texas,Washington County,17,933,397,536
Texas,Washington County,18,1246,431,815
Texas,Webb County,0,275910,135563,140347
Texas,Webb County,1,25875,13334,12541
Texas,Webb County,2,25535,12964,12571
Texas,Webb County,3,24454,12388,12066
Texas,Webb County,4,24291,12255,12036
Texas,Webb County,5,21857,11002,10855
Texas,Webb County,6,20100,10212,9888
Texas,Webb County,7,17278,8740,8538
Texas,Webb County,8,17402,8698,8704
Texas,Webb County,9,17471,8524,8947
Texas,Webb County,10,17222,8267,8955
Texas,Webb County,11,14446,6742,7704
Texas,Webb County,12,12848,6151,6697
Texas,Webb County,13,11044,5016,6028
Texas,Webb County,14,8527,3903,4624
Texas,Webb County,15,6848,3088,3760
Texas,Webb County,16,4579,1996,2583
Texas,Webb County,17,2986,1155,1831
Texas,Webb County,18,3147,1128,2019
Texas,Wharton County,0,41619,20500,21119
Texas,Wharton County,1,2847,1441,1406
Texas,Wharton County,2,2913,1496,1417
Texas,Wharton County,3,3097,1589,1508
Texas,Wharton County,4,2983,1506,1477
Texas,Wharton County,5,2629,1363,1266
Texas,Wharton County,6,2588,1334,1254
Texas,Wharton County,7,2522,1259,1263
Texas,Wharton County,8,2532,1220,1312
Texas,Wharton County,9,2227,1098,1129
Texas,Wharton County,10,2266,1112,1154
Texas,Wharton County,11,2522,1252,1270
Texas,Wharton County,12,2718,1347,1371
Texas,Wharton County,13,2665,1282,1383
Texas,Wharton County,14,2353,1182,1171
Texas,Wharton County,15,1597,746,851
Texas,Wharton County,16,1250,547,703
Texas,Wharton County,17,977,389,588
Texas,Wharton County,18,933,337,596
Texas,Wheeler County,0,5191,2613,2578
Texas,Wheeler County,1,344,174,170
Texas,Wheeler County,2,378,216,162
Texas,Wheeler County,3,372,199,173
Texas,Wheeler County,4,319,177,142
Texas,Wheeler County,5,277,137,140
Texas,Wheeler County,6,299,153,146
Texas,Wheeler County,7,270,134,136
Texas,Wheeler County,8,323,153,170
Texas,Wheeler County,9,279,140,139
Texas,Wheeler County,10,295,137,158
Texas,Wheeler County,11,272,146,126
Texas,Wheeler County,12,382,182,200
Texas,Wheeler County,13,377,188,189
Texas,Wheeler County,14,282,146,136
Texas,Wheeler County,15,274,136,138
Texas,Wheeler County,16,200,92,108
Texas,Wheeler County,17,138,61,77
Texas,Wheeler County,18,110,42,68
Texas,Wichita County,0,132064,68337,63727
Texas,Wichita County,1,8374,4257,4117
Texas,Wichita County,2,8574,4420,4154
Texas,Wichita County,3,8068,4130,3938
Texas,Wichita County,4,10256,5798,4458
Texas,Wichita County,5,11857,7171,4686
Texas,Wichita County,6,10516,5733,4783
Texas,Wichita County,7,9446,5109,4337
Texas,Wichita County,8,8369,4441,3928
Texas,Wichita County,9,6903,3690,3213
Texas,Wichita County,10,7025,3666,3359
Texas,Wichita County,11,7151,3595,3556
Texas,Wichita County,12,8325,4156,4169
Texas,Wichita County,13,7764,3777,3987
Texas,Wichita County,14,6085,2915,3170
Texas,Wichita County,15,4589,2099,2490
Texas,Wichita County,16,3428,1428,2000
Texas,Wichita County,17,2629,1052,1577
Texas,Wichita County,18,2705,900,1805
Texas,Wilbarger County,0,12820,6348,6472
Texas,Wilbarger County,1,752,395,357
Texas,Wilbarger County,2,753,374,379
Texas,Wilbarger County,3,782,374,408
Texas,Wilbarger County,4,883,495,388
Texas,Wilbarger County,5,815,444,371
Texas,Wilbarger County,6,851,429,422
Texas,Wilbarger County,7,896,417,479
Texas,Wilbarger County,8,766,389,377
Texas,Wilbarger County,9,716,354,362
Texas,Wilbarger County,10,770,386,384
Texas,Wilbarger County,11,715,373,342
Texas,Wilbarger County,12,914,437,477
Texas,Wilbarger County,13,852,427,425
Texas,Wilbarger County,14,691,347,344
Texas,Wilbarger County,15,613,283,330
Texas,Wilbarger County,16,427,185,242
Texas,Wilbarger County,17,308,136,172
Texas,Wilbarger County,18,316,103,213
Texas,Willacy County,0,21515,11893,9622
Texas,Willacy County,1,1381,688,693
Texas,Willacy County,2,1386,721,665
Texas,Willacy County,3,1465,719,746
Texas,Willacy County,4,1582,918,664
Texas,Willacy County,5,2069,1372,697
Texas,Willacy County,6,1933,1254,679
Texas,Willacy County,7,1533,975,558
Texas,Willacy County,8,1520,993,527
Texas,Willacy County,9,1320,761,559
Texas,Willacy County,10,1158,627,531
Texas,Willacy County,11,1097,570,527
Texas,Willacy County,12,1045,498,547
Texas,Willacy County,13,1011,467,544
Texas,Willacy County,14,923,424,499
Texas,Willacy County,15,756,362,394
Texas,Willacy County,16,581,242,339
Texas,Willacy County,17,350,161,189
Texas,Willacy County,18,405,141,264
Texas,Williamson County,0,566719,279077,287642
Texas,Williamson County,1,36855,18905,17950
Texas,Williamson County,2,40769,20913,19856
Texas,Williamson County,3,42726,21902,20824
Texas,Williamson County,4,38522,19568,18954
Texas,Williamson County,5,31363,15646,15717
Texas,Williamson County,6,36043,17998,18045
Texas,Williamson County,7,42897,21144,21753
Texas,Williamson County,8,47667,23414,24253
Texas,Williamson County,9,44804,22486,22318
Texas,Williamson County,10,42180,21077,21103
Texas,Williamson County,11,34555,17245,17310
Texas,Williamson County,12,32027,15537,16490
Texas,Williamson County,13,27323,12728,14595
Texas,Williamson County,14,23617,10581,13036
Texas,Williamson County,15,19239,8766,10473
Texas,Williamson County,16,12238,5614,6624
Texas,Williamson County,17,7344,3243,4101
Texas,Williamson County,18,6550,2310,4240
Texas,Wilson County,0,50224,25175,25049
Texas,Wilson County,1,3016,1570,1446
Texas,Wilson County,2,3204,1610,1594
Texas,Wilson County,3,3502,1800,1702
Texas,Wilson County,4,3623,1877,1746
Texas,Wilson County,5,2850,1454,1396
Texas,Wilson County,6,2804,1461,1343
Texas,Wilson County,7,2916,1429,1487
Texas,Wilson County,8,3211,1614,1597
Texas,Wilson County,9,2925,1481,1444
Texas,Wilson County,10,3549,1742,1807
Texas,Wilson County,11,3525,1750,1775
Texas,Wilson County,12,3767,1879,1888
Texas,Wilson County,13,3299,1641,1658
Texas,Wilson County,14,2807,1382,1425
Texas,Wilson County,15,2073,1020,1053
Texas,Wilson County,16,1369,694,675
Texas,Wilson County,17,860,400,460
Texas,Wilson County,18,924,371,553
Texas,Winkler County,0,7720,3961,3759
Texas,Winkler County,1,584,282,302
Texas,Winkler County,2,665,348,317
Texas,Winkler County,3,639,317,322
Texas,Winkler County,4,618,310,308
Texas,Winkler County,5,509,281,228
Texas,Winkler County,6,522,270,252
Texas,Winkler County,7,511,280,231
Texas,Winkler County,8,495,273,222
Texas,Winkler County,9,492,256,236
Texas,Winkler County,10,453,239,214
Texas,Winkler County,11,454,246,208
Texas,Winkler County,12,455,246,209
Texas,Winkler County,13,374,186,188
Texas,Winkler County,14,291,146,145
Texas,Winkler County,15,274,113,161
Texas,Winkler County,16,153,72,81
Texas,Winkler County,17,127,56,71
Texas,Winkler County,18,104,40,64
Texas,Wise County,0,68305,34159,34146
Texas,Wise County,1,4291,2210,2081
Texas,Wise County,2,4646,2302,2344
Texas,Wise County,3,4969,2545,2424
Texas,Wise County,4,4650,2387,2263
Texas,Wise County,5,3713,1907,1806
Texas,Wise County,6,4180,2064,2116
Texas,Wise County,7,4237,2143,2094
Texas,Wise County,8,4448,2248,2200
Texas,Wise County,9,4059,2030,2029
Texas,Wise County,10,4571,2270,2301
Texas,Wise County,11,4695,2349,2346
Texas,Wise County,12,5158,2574,2584
Texas,Wise County,13,4498,2274,2224
Texas,Wise County,14,3327,1624,1703
Texas,Wise County,15,2854,1444,1410
Texas,Wise County,16,1964,915,1049
Texas,Wise County,17,1169,536,633
Texas,Wise County,18,876,337,539
Texas,Wood County,0,45129,22386,22743
Texas,Wood County,1,2202,1166,1036
Texas,Wood County,2,2341,1182,1159
Texas,Wood County,3,2537,1295,1242
Texas,Wood County,4,2685,1371,1314
Texas,Wood County,5,2557,1364,1193
Texas,Wood County,6,2248,1207,1041
Texas,Wood County,7,2074,1052,1022
Texas,Wood County,8,2171,1106,1065
Texas,Wood County,9,2038,1016,1022
Texas,Wood County,10,2438,1265,1173
Texas,Wood County,11,2699,1307,1392
Texas,Wood County,12,3330,1615,1715
Texas,Wood County,13,3667,1758,1909
Texas,Wood County,14,3642,1717,1925
Texas,Wood County,15,3361,1651,1710
Texas,Wood County,16,2465,1170,1295
Texas,Wood County,17,1472,711,761
Texas,Wood County,18,1202,433,769
Texas,Yoakum County,0,8591,4385,4206
Texas,Yoakum County,1,764,416,348
Texas,Yoakum County,2,785,392,393
Texas,Yoakum County,3,830,406,424
Texas,Yoakum County,4,693,352,341
Texas,Yoakum County,5,562,325,237
Texas,Yoakum County,6,519,300,219
Texas,Yoakum County,7,561,295,266
Texas,Yoakum County,8,548,246,302
Texas,Yoakum County,9,495,262,233
Texas,Yoakum County,10,421,197,224
Texas,Yoakum County,11,445,227,218
Texas,Yoakum County,12,502,265,237
Texas,Yoakum County,13,449,225,224
Texas,Yoakum County,14,319,150,169
Texas,Yoakum County,15,256,135,121
Texas,Yoakum County,16,197,101,96
Texas,Yoakum County,17,128,51,77
Texas,Yoakum County,18,117,40,77
Texas,Young County,0,18045,8937,9108
Texas,Young County,1,1097,553,544
Texas,Young County,2,1258,668,590
Texas,Young County,3,1251,629,622
Texas,Young County,4,1141,592,549
Texas,Young County,5,903,490,413
Texas,Young County,6,1020,489,531
Texas,Young County,7,1068,534,534
Texas,Young County,8,1028,508,520
Texas,Young County,9,973,464,509
Texas,Young County,10,1003,496,507
Texas,Young County,11,1085,569,516
Texas,Young County,12,1278,631,647
Texas,Young County,13,1269,650,619
Texas,Young County,14,1154,577,577
Texas,Young County,15,884,409,475
Texas,Young County,16,671,301,370
Texas,Young County,17,489,217,272
Texas,Young County,18,473,160,313
Texas,Zapata County,0,14190,7083,7107
Texas,Zapata County,1,1291,679,612
Texas,Zapata County,2,1380,727,653
Texas,Zapata County,3,1321,728,593
Texas,Zapata County,4,1131,584,547
Texas,Zapata County,5,1028,523,505
Texas,Zapata County,6,936,456,480
Texas,Zapata County,7,836,410,426
Texas,Zapata County,8,809,400,409
Texas,Zapata County,9,889,425,464
Texas,Zapata County,10,751,344,407
Texas,Zapata County,11,728,319,409
Texas,Zapata County,12,654,322,332
Texas,Zapata County,13,593,305,288
Texas,Zapata County,14,561,264,297
Texas,Zapata County,15,463,200,263
Texas,Zapata County,16,390,195,195
Texas,Zapata County,17,229,122,107
Texas,Zapata County,18,200,80,120
Texas,Zavala County,0,11983,6061,5922
Texas,Zavala County,1,919,438,481
Texas,Zavala County,2,1055,538,517
Texas,Zavala County,3,963,512,451
Texas,Zavala County,4,968,488,480
Texas,Zavala County,5,1002,583,419
Texas,Zavala County,6,916,507,409
Texas,Zavala County,7,708,372,336
Texas,Zavala County,8,649,314,335
Texas,Zavala County,9,689,380,309
Texas,Zavala County,10,650,321,329
Texas,Zavala County,11,594,275,319
Texas,Zavala County,12,591,298,293
Texas,Zavala County,13,567,271,296
Texas,Zavala County,14,584,270,314
Texas,Zavala County,15,422,189,233
Texas,Zavala County,16,281,127,154
Texas,Zavala County,17,201,89,112
Texas,Zavala County,18,224,89,135
Utah,Beaver County,0,6580,3361,3219
Utah,Beaver County,1,574,280,294
Utah,Beaver County,2,581,312,269
Utah,Beaver County,3,626,328,298
Utah,Beaver County,4,529,274,255
Utah,Beaver County,5,378,204,174
Utah,Beaver County,6,375,191,184
Utah,Beaver County,7,373,178,195
Utah,Beaver County,8,426,214,212
Utah,Beaver County,9,383,209,174
Utah,Beaver County,10,328,168,160
Utah,Beaver County,11,284,137,147
Utah,Beaver County,12,365,194,171
Utah,Beaver County,13,410,202,208
Utah,Beaver County,14,339,180,159
Utah,Beaver County,15,225,92,133
Utah,Beaver County,16,185,88,97
Utah,Beaver County,17,121,66,55
Utah,Beaver County,18,78,44,34
Utah,Box Elder County,0,54950,27852,27098
Utah,Box Elder County,1,4514,2379,2135
Utah,Box Elder County,2,4907,2514,2393
Utah,Box Elder County,3,5139,2667,2472
Utah,Box Elder County,4,4328,2284,2044
Utah,Box Elder County,5,3232,1740,1492
Utah,Box Elder County,6,3538,1736,1802
Utah,Box Elder County,7,3422,1720,1702
Utah,Box Elder County,8,3913,2005,1908
Utah,Box Elder County,9,3488,1705,1783
Utah,Box Elder County,10,2746,1396,1350
Utah,Box Elder County,11,2592,1282,1310
Utah,Box Elder County,12,3135,1570,1565
Utah,Box Elder County,13,2887,1426,1461
Utah,Box Elder County,14,2328,1167,1161
Utah,Box Elder County,15,1715,860,855
Utah,Box Elder County,16,1280,599,681
Utah,Box Elder County,17,1014,449,565
Utah,Box Elder County,18,772,353,419
Utah,Cache County,0,127068,63667,63401
Utah,Cache County,1,10796,5426,5370
Utah,Cache County,2,10759,5460,5299
Utah,Cache County,3,10753,5480,5273
Utah,Cache County,4,11786,5556,6230
Utah,Cache County,5,18568,9244,9324
Utah,Cache County,6,10471,5757,4714
Utah,Cache County,7,7184,3706,3478
Utah,Cache County,8,7924,3995,3929
Utah,Cache County,9,6982,3533,3449
Utah,Cache County,10,5527,2793,2734
Utah,Cache County,11,4688,2376,2312
Utah,Cache County,12,5002,2437,2565
Utah,Cache County,13,4619,2220,2399
Utah,Cache County,14,3990,1947,2043
Utah,Cache County,15,2943,1430,1513
Utah,Cache County,16,2180,1022,1158
Utah,Cache County,17,1531,726,805
Utah,Cache County,18,1365,559,806
Utah,Carbon County,0,20269,10065,10204
Utah,Carbon County,1,1236,648,588
Utah,Carbon County,2,1475,793,682
Utah,Carbon County,3,1605,805,800
Utah,Carbon County,4,1537,746,791
Utah,Carbon County,5,1246,636,610
Utah,Carbon County,6,1204,614,590
Utah,Carbon County,7,1187,582,605
Utah,Carbon County,8,1363,681,682
Utah,Carbon County,9,1184,585,599
Utah,Carbon County,10,1045,513,532
Utah,Carbon County,11,973,484,489
Utah,Carbon County,12,1226,599,627
Utah,Carbon County,13,1458,723,735
Utah,Carbon County,14,1214,589,625
Utah,Carbon County,15,931,464,467
Utah,Carbon County,16,587,279,308
Utah,Carbon County,17,411,179,232
Utah,Carbon County,18,387,145,242
Utah,Daggett County,0,980,556,424
Utah,Daggett County,1,48,19,29
Utah,Daggett County,2,59,37,22
Utah,Daggett County,3,66,43,23
Utah,Daggett County,4,66,41,25
Utah,Daggett County,5,38,15,23
Utah,Daggett County,6,29,15,14
Utah,Daggett County,7,44,20,24
Utah,Daggett County,8,52,23,29
Utah,Daggett County,9,50,29,21
Utah,Daggett County,10,60,34,26
Utah,Daggett County,11,56,35,21
Utah,Daggett County,12,87,47,40
Utah,Daggett County,13,74,43,31
Utah,Daggett County,14,86,48,38
Utah,Daggett County,15,74,39,35
Utah,Daggett County,16,38,28,10
Utah,Daggett County,17,18,12,6
Utah,Daggett County,18,35,28,7
Utah,Davis County,0,351713,177609,174104
Utah,Davis County,1,29686,15529,14157
Utah,Davis County,2,32020,16512,15508
Utah,Davis County,3,32896,17096,15800
Utah,Davis County,4,27779,14623,13156
Utah,Davis County,5,22953,12109,10844
Utah,Davis County,6,24624,12285,12339
Utah,Davis County,7,24612,12242,12370
Utah,Davis County,8,27912,14025,13887
Utah,Davis County,9,24293,12251,12042
Utah,Davis County,10,19671,9918,9753
Utah,Davis County,11,16608,8315,8293
Utah,Davis County,12,17699,8798,8901
Utah,Davis County,13,15643,7624,8019
Utah,Davis County,14,12097,5797,6300
Utah,Davis County,15,9019,4189,4830
Utah,Davis County,16,6117,2856,3261
Utah,Davis County,17,4228,1851,2377
Utah,Davis County,18,3856,1589,2267
Utah,Duchesne County,0,19964,10103,9861
Utah,Duchesne County,1,1819,945,874
Utah,Duchesne County,2,1943,977,966
Utah,Duchesne County,3,1893,920,973
Utah,Duchesne County,4,1582,844,738
Utah,Duchesne County,5,1029,516,513
Utah,Duchesne County,6,1231,605,626
Utah,Duchesne County,7,1363,684,679
Utah,Duchesne County,8,1495,766,729
Utah,Duchesne County,9,1271,663,608
Utah,Duchesne County,10,978,496,482
Utah,Duchesne County,11,892,455,437
Utah,Duchesne County,12,1046,510,536
Utah,Duchesne County,13,1014,544,470
Utah,Duchesne County,14,774,405,369
Utah,Duchesne County,15,610,300,310
Utah,Duchesne County,16,447,218,229
Utah,Duchesne County,17,303,148,155
Utah,Duchesne County,18,274,107,167
Utah,Emery County,0,10014,5110,4904
Utah,Emery County,1,602,312,290
Utah,Emery County,2,828,469,359
Utah,Emery County,3,937,500,437
Utah,Emery County,4,748,392,356
Utah,Emery County,5,547,306,241
Utah,Emery County,6,496,239,257
Utah,Emery County,7,525,249,276
Utah,Emery County,8,680,337,343
Utah,Emery County,9,611,322,289
Utah,Emery County,10,509,245,264
Utah,Emery County,11,495,255,240
Utah,Emery County,12,622,284,338
Utah,Emery County,13,686,362,324
Utah,Emery County,14,581,298,283
Utah,Emery County,15,426,220,206
Utah,Emery County,16,342,162,180
Utah,Emery County,17,198,88,110
Utah,Emery County,18,181,70,111
Utah,Garfield County,0,5080,2645,2435
Utah,Garfield County,1,299,164,135
Utah,Garfield County,2,286,139,147
Utah,Garfield County,3,349,186,163
Utah,Garfield County,4,354,197,157
Utah,Garfield County,5,247,133,114
Utah,Garfield County,6,288,159,129
Utah,Garfield County,7,276,137,139
Utah,Garfield County,8,321,180,141
Utah,Garfield County,9,249,133,116
Utah,Garfield County,10,267,129,138
Utah,Garfield County,11,253,141,112
Utah,Garfield County,12,364,177,187
Utah,Garfield County,13,352,177,175
Utah,Garfield County,14,415,208,207
Utah,Garfield County,15,309,179,130
Utah,Garfield County,16,198,99,99
Utah,Garfield County,17,125,60,65
Utah,Garfield County,18,128,47,81
Utah,Grand County,0,9764,4933,4831
Utah,Grand County,1,595,300,295
Utah,Grand County,2,572,299,273
Utah,Grand County,3,580,284,296
Utah,Grand County,4,525,281,244
Utah,Grand County,5,485,250,235
Utah,Grand County,6,636,314,322
Utah,Grand County,7,611,304,307
Utah,Grand County,8,756,374,382
Utah,Grand County,9,576,282,294
Utah,Grand County,10,588,309,279
Utah,Grand County,11,561,271,290
Utah,Grand County,12,698,359,339
Utah,Grand County,13,764,381,383
Utah,Grand County,14,670,349,321
Utah,Grand County,15,470,256,214
Utah,Grand County,16,296,148,148
Utah,Grand County,17,185,93,92
Utah,Grand County,18,196,79,117
Utah,Iron County,0,52775,26363,26412
Utah,Iron County,1,4114,2109,2005
Utah,Iron County,2,4215,2143,2072
Utah,Iron County,3,4526,2296,2230
Utah,Iron County,4,4543,2152,2391
Utah,Iron County,5,5523,2781,2742
Utah,Iron County,6,3942,2069,1873
Utah,Iron County,7,3004,1511,1493
Utah,Iron County,8,3399,1700,1699
Utah,Iron County,9,2900,1482,1418
Utah,Iron County,10,2534,1254,1280
Utah,Iron County,11,2228,1109,1119
Utah,Iron County,12,2503,1243,1260
Utah,Iron County,13,2644,1220,1424
Utah,Iron County,14,2348,1221,1127
Utah,Iron County,15,1817,844,973
Utah,Iron County,16,1216,623,593
Utah,Iron County,17,732,353,379
Utah,Iron County,18,587,253,334
Utah,Juab County,0,11555,5929,5626
Utah,Juab County,1,1043,539,504
Utah,Juab County,2,1096,582,514
Utah,Juab County,3,1142,631,511
Utah,Juab County,4,1051,571,480
Utah,Juab County,5,737,385,352
Utah,Juab County,6,723,359,364
Utah,Juab County,7,648,315,333
Utah,Juab County,8,812,419,393
Utah,Juab County,9,730,368,362
Utah,Juab County,10,628,303,325
Utah,Juab County,11,538,286,252
Utah,Juab County,12,547,274,273
Utah,Juab County,13,463,230,233
Utah,Juab County,14,492,237,255
Utah,Juab County,15,374,190,184
Utah,Juab County,16,250,115,135
Utah,Juab County,17,164,84,80
Utah,Juab County,18,117,41,76
Utah,Kane County,0,7709,3894,3815
Utah,Kane County,1,460,232,228
Utah,Kane County,2,513,259,254
Utah,Kane County,3,535,282,253
Utah,Kane County,4,479,246,233
Utah,Kane County,5,339,189,150
Utah,Kane County,6,427,242,185
Utah,Kane County,7,451,221,230
Utah,Kane County,8,465,229,236
Utah,Kane County,9,375,211,164
Utah,Kane County,10,368,181,187
Utah,Kane County,11,409,198,211
Utah,Kane County,12,476,224,252
Utah,Kane County,13,616,281,335
Utah,Kane County,14,609,305,304
Utah,Kane County,15,502,228,274
Utah,Kane County,16,344,193,151
Utah,Kane County,17,211,123,88
Utah,Kane County,18,130,50,80
Utah,Millard County,0,13006,6658,6348
Utah,Millard County,1,1019,541,478
Utah,Millard County,2,1127,574,553
Utah,Millard County,3,1193,605,588
Utah,Millard County,4,1017,551,466
Utah,Millard County,5,742,410,332
Utah,Millard County,6,640,305,335
Utah,Millard County,7,694,333,361
Utah,Millard County,8,809,454,355
Utah,Millard County,9,697,359,338
Utah,Millard County,10,641,328,313
Utah,Millard County,11,618,315,303
Utah,Millard County,12,748,349,399
Utah,Millard County,13,829,415,414
Utah,Millard County,14,673,346,327
Utah,Millard County,15,567,287,280
Utah,Millard County,16,420,218,202
Utah,Millard County,17,262,130,132
Utah,Millard County,18,310,138,172
Utah,Morgan County,0,12045,6224,5821
Utah,Morgan County,1,890,472,418
Utah,Morgan County,2,1227,653,574
Utah,Morgan County,3,1367,737,630
Utah,Morgan County,4,1122,601,521
Utah,Morgan County,5,692,367,325
Utah,Morgan County,6,511,246,265
Utah,Morgan County,7,611,284,327
Utah,Morgan County,8,825,425,400
Utah,Morgan County,9,864,437,427
Utah,Morgan County,10,688,350,338
Utah,Morgan County,11,624,315,309
Utah,Morgan County,12,641,338,303
Utah,Morgan County,13,601,321,280
Utah,Morgan County,14,467,228,239
Utah,Morgan County,15,338,159,179
Utah,Morgan County,16,311,156,155
Utah,Morgan County,17,154,79,75
Utah,Morgan County,18,112,56,56
Utah,Piute County,0,1445,746,699
Utah,Piute County,1,47,25,22
Utah,Piute County,2,75,29,46
Utah,Piute County,3,133,76,57
Utah,Piute County,4,109,62,47
Utah,Piute County,5,62,34,28
Utah,Piute County,6,58,24,34
Utah,Piute County,7,50,26,24
Utah,Piute County,8,68,35,33
Utah,Piute County,9,83,45,38
Utah,Piute County,10,68,35,33
Utah,Piute County,11,70,37,33
Utah,Piute County,12,90,53,37
Utah,Piute County,13,115,52,63
Utah,Piute County,14,135,63,72
Utah,Piute County,15,105,55,50
Utah,Piute County,16,86,47,39
Utah,Piute County,17,45,21,24
Utah,Piute County,18,46,27,19
Utah,Rich County,0,2464,1268,1196
Utah,Rich County,1,188,109,79
Utah,Rich County,2,210,109,101
Utah,Rich County,3,206,104,102
Utah,Rich County,4,182,85,97
Utah,Rich County,5,145,87,58
Utah,Rich County,6,126,53,73
Utah,Rich County,7,139,62,77
Utah,Rich County,8,145,83,62
Utah,Rich County,9,133,66,67
Utah,Rich County,10,123,68,55
Utah,Rich County,11,118,54,64
Utah,Rich County,12,141,61,80
Utah,Rich County,13,165,94,71
Utah,Rich County,14,152,84,68
Utah,Rich County,15,108,52,56
Utah,Rich County,16,84,40,44
Utah,Rich County,17,36,22,14
Utah,Rich County,18,63,35,28
Utah,Salt Lake County,0,1152633,578614,574019
Utah,Salt Lake County,1,86592,43952,42640
Utah,Salt Lake County,2,86324,43866,42458
Utah,Salt Lake County,3,88464,45555,42909
Utah,Salt Lake County,4,80790,41597,39193
Utah,Salt Lake County,5,80823,41213,39610
Utah,Salt Lake County,6,99521,50487,49034
Utah,Salt Lake County,7,90915,46598,44317
Utah,Salt Lake County,8,90564,46178,44386
Utah,Salt Lake County,9,78381,40104,38277
Utah,Salt Lake County,10,69324,35418,33906
Utah,Salt Lake County,11,59843,30231,29612
Utah,Salt Lake County,12,60476,29442,31034
Utah,Salt Lake County,13,55459,27350,28109
Utah,Salt Lake County,14,44510,21236,23274
Utah,Salt Lake County,15,31988,14891,17097
Utah,Salt Lake County,16,21276,9384,11892
Utah,Salt Lake County,17,13727,5835,7892
Utah,Salt Lake County,18,13656,5277,8379
Utah,San Juan County,0,15449,7726,7723
Utah,San Juan County,1,1192,610,582
Utah,San Juan County,2,1328,660,668
Utah,San Juan County,3,1387,718,669
Utah,San Juan County,4,1360,705,655
Utah,San Juan County,5,1021,541,480
Utah,San Juan County,6,996,513,483
Utah,San Juan County,7,891,475,416
Utah,San Juan County,8,837,398,439
Utah,San Juan County,9,813,401,412
Utah,San Juan County,10,856,447,409
Utah,San Juan County,11,814,412,402
Utah,San Juan County,12,939,432,507
Utah,San Juan County,13,828,395,433
Utah,San Juan County,14,726,357,369
Utah,San Juan County,15,560,277,283
Utah,San Juan County,16,391,182,209
Utah,San Juan County,17,250,102,148
Utah,San Juan County,18,260,101,159
Utah,Sanpete County,0,30623,16112,14511
Utah,Sanpete County,1,1893,963,930
Utah,Sanpete County,2,2012,1027,985
Utah,Sanpete County,3,2320,1205,1115
Utah,Sanpete County,4,3202,1560,1642
Utah,Sanpete County,5,2846,1589,1257
Utah,Sanpete County,6,2085,1141,944
Utah,Sanpete County,7,1852,1032,820
Utah,Sanpete County,8,1966,1136,830
Utah,Sanpete County,9,1923,1062,861
Utah,Sanpete County,10,1680,951,729
Utah,Sanpete County,11,1449,788,661
Utah,Sanpete County,12,1562,786,776
Utah,Sanpete County,13,1560,782,778
Utah,Sanpete County,14,1491,745,746
Utah,Sanpete County,15,1063,518,545
Utah,Sanpete County,16,800,397,403
Utah,Sanpete County,17,535,250,285
Utah,Sanpete County,18,384,180,204
Utah,Sevier County,0,21539,10945,10594
Utah,Sevier County,1,1590,827,763
Utah,Sevier County,2,1712,866,846
Utah,Sevier County,3,1866,980,886
Utah,Sevier County,4,1754,930,824
Utah,Sevier County,5,1221,668,553
Utah,Sevier County,6,1182,634,548
Utah,Sevier County,7,1210,577,633
Utah,Sevier County,8,1481,747,734
Utah,Sevier County,9,1386,718,668
Utah,Sevier County,10,1121,587,534
Utah,Sevier County,11,1012,508,504
Utah,Sevier County,12,1299,627,672
Utah,Sevier County,13,1240,603,637
Utah,Sevier County,14,1086,538,548
Utah,Sevier County,15,900,413,487
Utah,Sevier County,16,666,331,335
Utah,Sevier County,17,452,227,225
Utah,Sevier County,18,361,164,197
Utah,Summit County,0,41933,21461,20472
Utah,Summit County,1,2279,1146,1133
Utah,Summit County,2,2676,1328,1348
Utah,Summit County,3,3246,1675,1571
Utah,Summit County,4,3058,1614,1444
Utah,Summit County,5,2359,1300,1059
Utah,Summit County,6,2548,1339,1209
Utah,Summit County,7,2478,1302,1176
Utah,Summit County,8,2652,1303,1349
Utah,Summit County,9,2775,1439,1336
Utah,Summit County,10,3174,1552,1622
Utah,Summit County,11,3127,1550,1577
Utah,Summit County,12,3223,1595,1628
Utah,Summit County,13,3058,1590,1468
Utah,Summit County,14,2193,1137,1056
Utah,Summit County,15,1481,758,723
Utah,Summit County,16,902,493,409
Utah,Summit County,17,392,207,185
Utah,Summit County,18,312,133,179
Utah,Tooele County,0,69907,35389,34518
Utah,Tooele County,1,5628,2921,2707
Utah,Tooele County,2,6474,3347,3127
Utah,Tooele County,3,6822,3506,3316
Utah,Tooele County,4,5793,3002,2791
Utah,Tooele County,5,4278,2148,2130
Utah,Tooele County,6,4524,2243,2281
Utah,Tooele County,7,4812,2360,2452
Utah,Tooele County,8,5644,2819,2825
Utah,Tooele County,9,5173,2618,2555
Utah,Tooele County,10,4324,2204,2120
Utah,Tooele County,11,3524,1837,1687
Utah,Tooele County,12,3495,1797,1698
Utah,Tooele County,13,3013,1521,1492
Utah,Tooele County,14,2378,1182,1196
Utah,Tooele County,15,1656,832,824
Utah,Tooele County,16,1073,527,546
Utah,Tooele County,17,680,293,387
Utah,Tooele County,18,616,232,384
Utah,Uintah County,0,35438,18011,17427
Utah,Uintah County,1,3031,1590,1441
Utah,Uintah County,2,3353,1724,1629
Utah,Uintah County,3,3504,1779,1725
Utah,Uintah County,4,2736,1432,1304
Utah,Uintah County,5,1878,1008,870
Utah,Uintah County,6,2438,1230,1208
Utah,Uintah County,7,2518,1246,1272
Utah,Uintah County,8,2862,1470,1392
Utah,Uintah County,9,2308,1209,1099
Utah,Uintah County,10,1795,941,854
Utah,Uintah County,11,1580,758,822
Utah,Uintah County,12,1831,929,902
Utah,Uintah County,13,1749,842,907
Utah,Uintah County,14,1330,684,646
Utah,Uintah County,15,982,484,498
Utah,Uintah County,16,666,301,365
Utah,Uintah County,17,451,203,248
Utah,Uintah County,18,426,181,245
Utah,Utah County,0,622213,314587,307626
Utah,Utah County,1,58844,30333,28511
Utah,Utah County,2,57689,29763,27926
Utah,Utah County,3,58106,29843,28263
Utah,Utah County,4,58866,29342,29524
Utah,Utah County,5,78791,40424,38367
Utah,Utah County,6,51858,27530,24328
Utah,Utah County,7,37526,18629,18897
Utah,Utah County,8,41781,21146,20635
Utah,Utah County,9,36892,18734,18158
Utah,Utah County,10,28909,14523,14386
Utah,Utah County,11,23304,11844,11460
Utah,Utah County,12,22055,11001,11054
Utah,Utah County,13,19542,9485,10057
Utah,Utah County,14,15829,7484,8345
Utah,Utah County,15,12509,5832,6677
Utah,Utah County,16,8682,3933,4749
Utah,Utah County,17,5854,2630,3224
Utah,Utah County,18,5176,2111,3065
Utah,Wasatch County,0,33240,16873,16367
Utah,Wasatch County,1,2574,1334,1240
Utah,Wasatch County,2,2882,1459,1423
Utah,Wasatch County,3,3248,1707,1541
Utah,Wasatch County,4,2621,1367,1254
Utah,Wasatch County,5,1984,1055,929
Utah,Wasatch County,6,1721,875,846
Utah,Wasatch County,7,1964,964,1000
Utah,Wasatch County,8,2478,1174,1304
Utah,Wasatch County,9,2441,1247,1194
Utah,Wasatch County,10,2027,1057,970
Utah,Wasatch County,11,1764,850,914
Utah,Wasatch County,12,1903,971,932
Utah,Wasatch County,13,1811,933,878
Utah,Wasatch County,14,1452,717,735
Utah,Wasatch County,15,1115,547,568
Utah,Wasatch County,16,661,344,317
Utah,Wasatch County,17,319,149,170
Utah,Wasatch County,18,275,123,152
Utah,Washington County,0,171700,85053,86647
Utah,Washington County,1,11537,5913,5624
Utah,Washington County,2,12238,6409,5829
Utah,Washington County,3,13235,6866,6369
Utah,Washington County,4,12339,6286,6053
Utah,Washington County,5,10492,5410,5082
Utah,Washington County,6,10195,5057,5138
Utah,Washington County,7,9577,4701,4876
Utah,Washington County,8,10830,5510,5320
Utah,Washington County,9,9535,4817,4718
Utah,Washington County,10,8258,4104,4154
Utah,Washington County,11,7726,3736,3990
Utah,Washington County,12,8801,3998,4803
Utah,Washington County,13,10093,4650,5443
Utah,Washington County,14,10694,4943,5751
Utah,Washington County,15,9612,4651,4961
Utah,Washington County,16,7385,3551,3834
Utah,Washington County,17,4865,2461,2404
Utah,Washington County,18,4288,1990,2298
Utah,Wayne County,0,2690,1381,1309
Utah,Wayne County,1,163,92,71
Utah,Wayne County,2,172,84,88
Utah,Wayne County,3,191,91,100
Utah,Wayne County,4,198,106,92
Utah,Wayne County,5,148,78,70
Utah,Wayne County,6,108,60,48
Utah,Wayne County,7,168,87,81
Utah,Wayne County,8,144,73,71
Utah,Wayne County,9,131,66,65
Utah,Wayne County,10,143,79,64
Utah,Wayne County,11,146,77,69
Utah,Wayne County,12,187,86,101
Utah,Wayne County,13,205,102,103
Utah,Wayne County,14,226,121,105
Utah,Wayne County,15,170,86,84
Utah,Wayne County,16,98,51,47
Utah,Wayne County,17,46,26,20
Utah,Wayne County,18,46,16,30
Utah,Weber County,0,256359,129008,127351
Utah,Weber County,1,19751,10078,9673
Utah,Weber County,2,20325,10348,9977
Utah,Weber County,3,20464,10391,10073
Utah,Weber County,4,18531,9511,9020
Utah,Weber County,5,18102,9211,8891
Utah,Weber County,6,20736,10655,10081
Utah,Weber County,7,18572,9446,9126
Utah,Weber County,8,18755,9628,9127
Utah,Weber County,9,16628,8551,8077
Utah,Weber County,10,14288,7158,7130
Utah,Weber County,11,13209,6697,6512
Utah,Weber County,12,14201,7160,7041
Utah,Weber County,13,12900,6378,6522
Utah,Weber County,14,10218,4916,5302
Utah,Weber County,15,7799,3733,4066
Utah,Weber County,16,5046,2259,2787
Utah,Weber County,17,3495,1532,1963
Utah,Weber County,18,3339,1356,1983
Vermont,Addison County,0,36973,18469,18504
Vermont,Addison County,1,1572,806,766
Vermont,Addison County,2,1677,875,802
Vermont,Addison County,3,1823,982,841
Vermont,Addison County,4,2902,1429,1473
Vermont,Addison County,5,3347,1765,1582
Vermont,Addison County,6,1837,971,866
Vermont,Addison County,7,1933,1000,933
Vermont,Addison County,8,2007,989,1018
Vermont,Addison County,9,1944,974,970
Vermont,Addison County,10,2278,1118,1160
Vermont,Addison County,11,2561,1263,1298
Vermont,Addison County,12,2835,1407,1428
Vermont,Addison County,13,2900,1412,1488
Vermont,Addison County,14,2584,1276,1308
Vermont,Addison County,15,1970,980,990
Vermont,Addison County,16,1198,550,648
Vermont,Addison County,17,798,381,417
Vermont,Addison County,18,807,291,516
Vermont,Bennington County,0,35631,17363,18268
Vermont,Bennington County,1,1670,842,828
Vermont,Bennington County,2,1800,952,848
Vermont,Bennington County,3,2013,1082,931
Vermont,Bennington County,4,2288,1129,1159
Vermont,Bennington County,5,2237,1073,1164
Vermont,Bennington County,6,1777,909,868
Vermont,Bennington County,7,1709,846,863
Vermont,Bennington County,8,1805,862,943
Vermont,Bennington County,9,1706,857,849
Vermont,Bennington County,10,2128,1017,1111
Vermont,Bennington County,11,2501,1207,1294
Vermont,Bennington County,12,2937,1426,1511
Vermont,Bennington County,13,2898,1404,1494
Vermont,Bennington County,14,2552,1258,1294
Vermont,Bennington County,15,2042,971,1071
Vermont,Bennington County,16,1465,654,811
Vermont,Bennington County,17,958,430,528
Vermont,Bennington County,18,1145,444,701
Vermont,Caledonia County,0,30302,15166,15136
Vermont,Caledonia County,1,1451,736,715
Vermont,Caledonia County,2,1509,784,725
Vermont,Caledonia County,3,1755,910,845
Vermont,Caledonia County,4,2112,1133,979
Vermont,Caledonia County,5,1825,977,848
Vermont,Caledonia County,6,1647,869,778
Vermont,Caledonia County,7,1546,788,758
Vermont,Caledonia County,8,1716,848,868
Vermont,Caledonia County,9,1672,844,828
Vermont,Caledonia County,10,1953,982,971
Vermont,Caledonia County,11,1973,977,996
Vermont,Caledonia County,12,2334,1122,1212
Vermont,Caledonia County,13,2455,1173,1282
Vermont,Caledonia County,14,2268,1102,1166
Vermont,Caledonia County,15,1678,859,819
Vermont,Caledonia County,16,1067,515,552
Vermont,Caledonia County,17,638,282,356
Vermont,Caledonia County,18,703,265,438
Vermont,Chittenden County,0,164572,80692,83880
Vermont,Chittenden County,1,7714,4042,3672
Vermont,Chittenden County,2,7721,3983,3738
Vermont,Chittenden County,3,8425,4339,4086
Vermont,Chittenden County,4,13688,6732,6956
Vermont,Chittenden County,5,18647,9367,9280
Vermont,Chittenden County,6,12329,6399,5930
Vermont,Chittenden County,7,10905,5587,5318
Vermont,Chittenden County,8,10176,5081,5095
Vermont,Chittenden County,9,8923,4416,4507
Vermont,Chittenden County,10,9675,4727,4948
Vermont,Chittenden County,11,10071,4903,5168
Vermont,Chittenden County,12,11302,5476,5826
Vermont,Chittenden County,13,10323,5082,5241
Vermont,Chittenden County,14,8188,3767,4421
Vermont,Chittenden County,15,6154,2788,3366
Vermont,Chittenden County,16,4204,1837,2367
Vermont,Chittenden County,17,2685,1042,1643
Vermont,Chittenden County,18,3442,1124,2318
Vermont,Essex County,0,6250,3131,3119
Vermont,Essex County,1,300,146,154
Vermont,Essex County,2,298,158,140
Vermont,Essex County,3,292,144,148
Vermont,Essex County,4,323,173,150
Vermont,Essex County,5,271,139,132
Vermont,Essex County,6,278,147,131
Vermont,Essex County,7,272,121,151
Vermont,Essex County,8,294,137,157
Vermont,Essex County,9,314,159,155
Vermont,Essex County,10,411,208,203
Vermont,Essex County,11,469,236,233
Vermont,Essex County,12,538,257,281
Vermont,Essex County,13,592,288,304
Vermont,Essex County,14,489,268,221
Vermont,Essex County,15,456,236,220
Vermont,Essex County,16,293,154,139
Vermont,Essex County,17,181,88,93
Vermont,Essex County,18,179,72,107
Vermont,Franklin County,0,49421,24611,24810
Vermont,Franklin County,1,2892,1474,1418
Vermont,Franklin County,2,3054,1624,1430
Vermont,Franklin County,3,3128,1623,1505
Vermont,Franklin County,4,2902,1475,1427
Vermont,Franklin County,5,2741,1370,1371
Vermont,Franklin County,6,3176,1610,1566
Vermont,Franklin County,7,3107,1559,1548
Vermont,Franklin County,8,3198,1554,1644
Vermont,Franklin County,9,2978,1482,1496
Vermont,Franklin County,10,3350,1661,1689
Vermont,Franklin County,11,3528,1721,1807
Vermont,Franklin County,12,3871,1987,1884
Vermont,Franklin County,13,3571,1744,1827
Vermont,Franklin County,14,2804,1358,1446
Vermont,Franklin County,15,2091,1056,1035
Vermont,Franklin County,16,1349,653,696
Vermont,Franklin County,17,848,373,475
Vermont,Franklin County,18,833,287,546
Vermont,Grand Isle County,0,7090,3578,3512
Vermont,Grand Isle County,1,293,144,149
Vermont,Grand Isle County,2,370,196,174
Vermont,Grand Isle County,3,363,172,191
Vermont,Grand Isle County,4,384,206,178
Vermont,Grand Isle County,5,317,179,138
Vermont,Grand Isle County,6,369,195,174
Vermont,Grand Isle County,7,409,207,202
Vermont,Grand Isle County,8,395,189,206
Vermont,Grand Isle County,9,388,200,188
Vermont,Grand Isle County,10,427,208,219
Vermont,Grand Isle County,11,542,266,276
Vermont,Grand Isle County,12,683,334,349
Vermont,Grand Isle County,13,675,349,326
Vermont,Grand Isle County,14,598,310,288
Vermont,Grand Isle County,15,421,210,211
Vermont,Grand Isle County,16,231,114,117
Vermont,Grand Isle County,17,128,66,62
Vermont,Grand Isle County,18,97,33,64
Vermont,Lamoille County,0,25300,12657,12643
Vermont,Lamoille County,1,1309,686,623
Vermont,Lamoille County,2,1424,705,719
Vermont,Lamoille County,3,1535,759,776
Vermont,Lamoille County,4,1628,831,797
Vermont,Lamoille County,5,1567,818,749
Vermont,Lamoille County,6,1550,804,746
Vermont,Lamoille County,7,1607,824,783
Vermont,Lamoille County,8,1588,803,785
Vermont,Lamoille County,9,1604,790,814
Vermont,Lamoille County,10,1703,910,793
Vermont,Lamoille County,11,1715,849,866
Vermont,Lamoille County,12,1916,907,1009
Vermont,Lamoille County,13,1761,852,909
Vermont,Lamoille County,14,1527,744,783
Vermont,Lamoille County,15,1142,594,548
Vermont,Lamoille County,16,786,386,400
Vermont,Lamoille County,17,489,233,256
Vermont,Lamoille County,18,449,162,287
Vermont,Orange County,0,28999,14524,14475
Vermont,Orange County,1,1366,714,652
Vermont,Orange County,2,1467,776,691
Vermont,Orange County,3,1501,780,721
Vermont,Orange County,4,1709,976,733
Vermont,Orange County,5,1610,854,756
Vermont,Orange County,6,1441,731,710
Vermont,Orange County,7,1618,828,790
Vermont,Orange County,8,1741,863,878
Vermont,Orange County,9,1551,777,774
Vermont,Orange County,10,1801,891,910
Vermont,Orange County,11,2052,1010,1042
Vermont,Orange County,12,2507,1203,1304
Vermont,Orange County,13,2486,1236,1250
Vermont,Orange County,14,2249,1116,1133
Vermont,Orange County,15,1615,769,846
Vermont,Orange County,16,1046,510,536
Vermont,Orange County,17,637,265,372
Vermont,Orange County,18,602,225,377
Vermont,Orleans County,0,26907,13501,13406
Vermont,Orleans County,1,1309,699,610
Vermont,Orleans County,2,1412,693,719
Vermont,Orleans County,3,1507,759,748
Vermont,Orleans County,4,1508,786,722
Vermont,Orleans County,5,1473,759,714
Vermont,Orleans County,6,1477,788,689
Vermont,Orleans County,7,1455,799,656
Vermont,Orleans County,8,1498,747,751
Vermont,Orleans County,9,1481,744,737
Vermont,Orleans County,10,1683,870,813
Vermont,Orleans County,11,1805,906,899
Vermont,Orleans County,12,1988,988,1000
Vermont,Orleans County,13,2198,1109,1089
Vermont,Orleans County,14,2039,967,1072
Vermont,Orleans County,15,1617,824,793
Vermont,Orleans County,16,1117,559,558
Vermont,Orleans County,17,645,277,368
Vermont,Orleans County,18,695,227,468
Vermont,Rutland County,0,58672,28924,29748
Vermont,Rutland County,1,2676,1356,1320
Vermont,Rutland County,2,2805,1427,1378
Vermont,Rutland County,3,3006,1572,1434
Vermont,Rutland County,4,3731,1909,1822
Vermont,Rutland County,5,3579,1790,1789
Vermont,Rutland County,6,3210,1681,1529
Vermont,Rutland County,7,3139,1567,1572
Vermont,Rutland County,8,3068,1552,1516
Vermont,Rutland County,9,2864,1435,1429
Vermont,Rutland County,10,3596,1782,1814
Vermont,Rutland County,11,4167,2087,2080
Vermont,Rutland County,12,4983,2393,2590
Vermont,Rutland County,13,4893,2421,2472
Vermont,Rutland County,14,4360,2108,2252
Vermont,Rutland County,15,3463,1674,1789
Vermont,Rutland County,16,2220,1039,1181
Vermont,Rutland County,17,1417,628,789
Vermont,Rutland County,18,1495,503,992
Vermont,Washington County,0,58140,28773,29367
Vermont,Washington County,1,2779,1429,1350
Vermont,Washington County,2,2982,1566,1416
Vermont,Washington County,3,3137,1575,1562
Vermont,Washington County,4,3852,2112,1740
Vermont,Washington County,5,3611,2033,1578
Vermont,Washington County,6,3208,1624,1584
Vermont,Washington County,7,3379,1661,1718
Vermont,Washington County,8,3494,1690,1804
Vermont,Washington County,9,3481,1706,1775
Vermont,Washington County,10,3806,1876,1930
Vermont,Washington County,11,4076,1995,2081
Vermont,Washington County,12,4485,2165,2320
Vermont,Washington County,13,4439,2147,2292
Vermont,Washington County,14,3933,1908,2025
Vermont,Washington County,15,2949,1415,1534
Vermont,Washington County,16,1870,839,1031
Vermont,Washington County,17,1265,578,687
Vermont,Washington County,18,1394,454,940
Vermont,Windham County,0,42756,20919,21837
Vermont,Windham County,1,1889,957,932
Vermont,Windham County,2,2059,1082,977
Vermont,Windham County,3,2287,1158,1129
Vermont,Windham County,4,2405,1270,1135
Vermont,Windham County,5,2371,1297,1074
Vermont,Windham County,6,2314,1159,1155
Vermont,Windham County,7,2314,1133,1181
Vermont,Windham County,8,2410,1144,1266
Vermont,Windham County,9,2194,1043,1151
Vermont,Windham County,10,2459,1201,1258
Vermont,Windham County,11,2885,1350,1535
Vermont,Windham County,12,3687,1783,1904
Vermont,Windham County,13,3725,1819,1906
Vermont,Windham County,14,3503,1739,1764
Vermont,Windham County,15,2524,1173,1351
Vermont,Windham County,16,1594,734,860
Vermont,Windham County,17,994,456,538
Vermont,Windham County,18,1142,421,721
Vermont,Windsor County,0,55286,26944,28342
Vermont,Windsor County,1,2461,1245,1216
Vermont,Windsor County,2,2694,1394,1300
Vermont,Windsor County,3,2989,1502,1487
Vermont,Windsor County,4,2853,1448,1405
Vermont,Windsor County,5,2597,1333,1264
Vermont,Windsor County,6,2920,1463,1457
Vermont,Windsor County,7,3165,1551,1614
Vermont,Windsor County,8,3214,1589,1625
Vermont,Windsor County,9,2897,1443,1454
Vermont,Windsor County,10,3262,1632,1630
Vermont,Windsor County,11,3842,1838,2004
Vermont,Windsor County,12,4631,2192,2439
Vermont,Windsor County,13,4876,2314,2562
Vermont,Windsor County,14,4242,2073,2169
Vermont,Windsor County,15,3435,1607,1828
Vermont,Windsor County,16,2270,1109,1161
Vermont,Windsor County,17,1500,666,834
Vermont,Windsor County,18,1438,545,893
Virginia,Accomack County,0,32412,15817,16595
Virginia,Accomack County,1,1810,950,860
Virginia,Accomack County,2,1886,963,923
Virginia,Accomack County,3,1857,976,881
Virginia,Accomack County,4,1709,890,819
Virginia,Accomack County,5,1411,761,650
Virginia,Accomack County,6,1867,900,967
Virginia,Accomack County,7,1750,897,853
Virginia,Accomack County,8,1731,871,860
Virginia,Accomack County,9,1591,753,838
Virginia,Accomack County,10,1791,885,906
Virginia,Accomack County,11,2101,995,1106
Virginia,Accomack County,12,2449,1173,1276
Virginia,Accomack County,13,2821,1329,1492
Virginia,Accomack County,14,2421,1146,1275
Virginia,Accomack County,15,2030,944,1086
Virginia,Accomack County,16,1425,647,778
Virginia,Accomack County,17,876,378,498
Virginia,Accomack County,18,886,359,527
Virginia,Albemarle County,0,108718,51970,56748
Virginia,Albemarle County,1,5712,2908,2804
Virginia,Albemarle County,2,5934,3049,2885
Virginia,Albemarle County,3,6078,3084,2994
Virginia,Albemarle County,4,9387,4457,4930
Virginia,Albemarle County,5,7438,3662,3776
Virginia,Albemarle County,6,7019,3342,3677
Virginia,Albemarle County,7,7050,3530,3520
Virginia,Albemarle County,8,6596,3257,3339
Virginia,Albemarle County,9,6041,2982,3059
Virginia,Albemarle County,10,6328,3109,3219
Virginia,Albemarle County,11,6536,3136,3400
Virginia,Albemarle County,12,7157,3304,3853
Virginia,Albemarle County,13,7194,3237,3957
Virginia,Albemarle County,14,6499,2985,3514
Virginia,Albemarle County,15,4955,2319,2636
Virginia,Albemarle County,16,3548,1565,1983
Virginia,Albemarle County,17,2380,1012,1368
Virginia,Albemarle County,18,2866,1032,1834
Virginia,Alleghany County,0,14910,7291,7619
Virginia,Alleghany County,1,634,314,320
Virginia,Alleghany County,2,757,390,367
Virginia,Alleghany County,3,826,453,373
Virginia,Alleghany County,4,854,443,411
Virginia,Alleghany County,5,790,413,377
Virginia,Alleghany County,6,796,396,400
Virginia,Alleghany County,7,664,322,342
Virginia,Alleghany County,8,731,358,373
Virginia,Alleghany County,9,726,362,364
Virginia,Alleghany County,10,1015,493,522
Virginia,Alleghany County,11,1099,554,545
Virginia,Alleghany County,12,1144,551,593
Virginia,Alleghany County,13,1192,564,628
Virginia,Alleghany County,14,1041,533,508
Virginia,Alleghany County,15,1020,470,550
Virginia,Alleghany County,16,752,359,393
Virginia,Alleghany County,17,435,180,255
Virginia,Alleghany County,18,434,136,298
Virginia,Amelia County,0,13013,6416,6597
Virginia,Amelia County,1,647,347,300
Virginia,Amelia County,2,740,374,366
Virginia,Amelia County,3,788,394,394
Virginia,Amelia County,4,752,397,355
Virginia,Amelia County,5,668,353,315
Virginia,Amelia County,6,754,367,387
Virginia,Amelia County,7,728,360,368
Virginia,Amelia County,8,702,360,342
Virginia,Amelia County,9,681,320,361
Virginia,Amelia County,10,816,407,409
Virginia,Amelia County,11,953,471,482
Virginia,Amelia County,12,1155,572,583
Virginia,Amelia County,13,1053,526,527
Virginia,Amelia County,14,798,378,420
Virginia,Amelia County,15,691,357,334
Virginia,Amelia County,16,508,232,276
Virginia,Amelia County,17,290,115,175
Virginia,Amelia County,18,289,86,203
Virginia,Amherst County,0,31666,15368,16298
Virginia,Amherst County,1,1641,859,782
Virginia,Amherst County,2,1732,919,813
Virginia,Amherst County,3,1798,888,910
Virginia,Amherst County,4,1827,948,879
Virginia,Amherst County,5,1837,920,917
Virginia,Amherst County,6,1851,924,927
Virginia,Amherst County,7,1733,839,894
Virginia,Amherst County,8,1664,819,845
Virginia,Amherst County,9,1652,799,853
Virginia,Amherst County,10,2110,1051,1059
Virginia,Amherst County,11,2305,1124,1181
Virginia,Amherst County,12,2530,1206,1324
Virginia,Amherst County,13,2285,1097,1188
Virginia,Amherst County,14,2093,976,1117
Virginia,Amherst County,15,1696,823,873
Virginia,Amherst County,16,1331,588,743
Virginia,Amherst County,17,783,330,453
Virginia,Amherst County,18,798,258,540
Virginia,Appomattox County,0,15841,7692,8149
Virginia,Appomattox County,1,924,468,456
Virginia,Appomattox County,2,934,478,456
Virginia,Appomattox County,3,927,476,451
Virginia,Appomattox County,4,912,458,454
Virginia,Appomattox County,5,830,418,412
Virginia,Appomattox County,6,969,489,480
Virginia,Appomattox County,7,940,452,488
Virginia,Appomattox County,8,948,462,486
Virginia,Appomattox County,9,840,421,419
Virginia,Appomattox County,10,1007,502,505
Virginia,Appomattox County,11,1012,472,540
Virginia,Appomattox County,12,1170,552,618
Virginia,Appomattox County,13,1148,540,608
Virginia,Appomattox County,14,981,467,514
Virginia,Appomattox County,15,890,435,455
Virginia,Appomattox County,16,679,305,374
Virginia,Appomattox County,17,387,180,207
Virginia,Appomattox County,18,343,117,226
Virginia,Arlington County,0,237521,119009,118512
Virginia,Arlington County,1,14285,7335,6950
Virginia,Arlington County,2,12023,6224,5799
Virginia,Arlington County,3,10976,5557,5419
Virginia,Arlington County,4,9027,4563,4464
Virginia,Arlington County,5,16215,8076,8139
Virginia,Arlington County,6,30020,14964,15056
Virginia,Arlington County,7,27129,13804,13325
Virginia,Arlington County,8,22185,11244,10941
Virginia,Arlington County,9,17356,8766,8590
Virginia,Arlington County,10,15989,8118,7871
Virginia,Arlington County,11,13734,7134,6600
Virginia,Arlington County,12,12552,6542,6010
Virginia,Arlington County,13,10821,5220,5601
Virginia,Arlington County,14,8785,4169,4616
Virginia,Arlington County,15,6616,3142,3474
Virginia,Arlington County,16,4180,1878,2302
Virginia,Arlington County,17,2546,1100,1446
Virginia,Arlington County,18,3082,1173,1909
Virginia,Augusta County,0,75457,38274,37183
Virginia,Augusta County,1,3455,1731,1724
Virginia,Augusta County,2,3820,1934,1886
Virginia,Augusta County,3,4383,2249,2134
Virginia,Augusta County,4,4272,2273,1999
Virginia,Augusta County,5,4086,2223,1863
Virginia,Augusta County,6,4563,2487,2076
Virginia,Augusta County,7,4243,2277,1966
Virginia,Augusta County,8,4420,2358,2062
Virginia,Augusta County,9,4235,2205,2030
Virginia,Augusta County,10,5114,2618,2496
Virginia,Augusta County,11,5438,2721,2717
Virginia,Augusta County,12,5946,2995,2951
Virginia,Augusta County,13,5605,2749,2856
Virginia,Augusta County,14,4907,2395,2512
Virginia,Augusta County,15,4176,2008,2168
Virginia,Augusta County,16,3088,1509,1579
Virginia,Augusta County,17,1933,844,1089
Virginia,Augusta County,18,1773,698,1075
Virginia,Bath County,0,4292,2161,2131
Virginia,Bath County,1,189,98,91
Virginia,Bath County,2,182,79,103
Virginia,Bath County,3,165,77,88
Virginia,Bath County,4,187,101,86
Virginia,Bath County,5,204,95,109
Virginia,Bath County,6,236,123,113
Virginia,Bath County,7,212,114,98
Virginia,Bath County,8,195,99,96
Virginia,Bath County,9,208,107,101
Virginia,Bath County,10,272,127,145
Virginia,Bath County,11,340,184,156
Virginia,Bath County,12,367,192,175
Virginia,Bath County,13,348,172,176
Virginia,Bath County,14,328,160,168
Virginia,Bath County,15,344,168,176
Virginia,Bath County,16,241,123,118
Virginia,Bath County,17,127,66,61
Virginia,Bath County,18,147,76,71
Virginia,Bedford County,0,78747,38794,39953
Virginia,Bedford County,1,3605,1833,1772
Virginia,Bedford County,2,4333,2237,2096
Virginia,Bedford County,3,4630,2356,2274
Virginia,Bedford County,4,4622,2351,2271
Virginia,Bedford County,5,4158,2137,2021
Virginia,Bedford County,6,4215,2151,2064
Virginia,Bedford County,7,3825,1915,1910
Virginia,Bedford County,8,3983,1931,2052
Virginia,Bedford County,9,4218,2088,2130
Virginia,Bedford County,10,5462,2635,2827
Virginia,Bedford County,11,5890,2900,2990
Virginia,Bedford County,12,6595,3219,3376
Virginia,Bedford County,13,6422,3164,3258
Virginia,Bedford County,14,5468,2672,2796
Virginia,Bedford County,15,4546,2207,2339
Virginia,Bedford County,16,3201,1472,1729
Virginia,Bedford County,17,1895,851,1044
Virginia,Bedford County,18,1679,675,1004
Virginia,Bland County,0,6293,3445,2848
Virginia,Bland County,1,240,110,130
Virginia,Bland County,2,249,135,114
Virginia,Bland County,3,283,147,136
Virginia,Bland County,4,284,150,134
Virginia,Bland County,5,315,188,127
Virginia,Bland County,6,418,249,169
Virginia,Bland County,7,356,250,106
Virginia,Bland County,8,376,240,136
Virginia,Bland County,9,429,274,155
Virginia,Bland County,10,510,296,214
Virginia,Bland County,11,471,272,199
Virginia,Bland County,12,450,220,230
Virginia,Bland County,13,465,213,252
Virginia,Bland County,14,441,228,213
Virginia,Bland County,15,390,188,202
Virginia,Bland County,16,300,153,147
Virginia,Bland County,17,171,78,93
Virginia,Bland County,18,145,54,91
Virginia,Botetourt County,0,33277,16494,16783
Virginia,Botetourt County,1,1404,717,687
Virginia,Botetourt County,2,1630,817,813
Virginia,Botetourt County,3,1945,988,957
Virginia,Botetourt County,4,1950,1011,939
Virginia,Botetourt County,5,1675,862,813
Virginia,Botetourt County,6,1571,851,720
Virginia,Botetourt County,7,1626,831,795
Virginia,Botetourt County,8,1734,860,874
Virginia,Botetourt County,9,1722,839,883
Virginia,Botetourt County,10,2355,1186,1169
Virginia,Botetourt County,11,2643,1288,1355
Virginia,Botetourt County,12,2792,1380,1412
Virginia,Botetourt County,13,2661,1327,1334
Virginia,Botetourt County,14,2530,1253,1277
Virginia,Botetourt County,15,2032,989,1043
Virginia,Botetourt County,16,1401,634,767
Virginia,Botetourt County,17,852,393,459
Virginia,Botetourt County,18,754,268,486
Virginia,Brunswick County,0,16384,8773,7611
Virginia,Brunswick County,1,679,325,354
Virginia,Brunswick County,2,696,337,359
Virginia,Brunswick County,3,800,421,379
Virginia,Brunswick County,4,817,440,377
Virginia,Brunswick County,5,1125,722,403
Virginia,Brunswick County,6,1239,857,382
Virginia,Brunswick County,7,1068,708,360
Virginia,Brunswick County,8,1000,587,413
Virginia,Brunswick County,9,956,568,388
Virginia,Brunswick County,10,981,522,459
Virginia,Brunswick County,11,1089,553,536
Virginia,Brunswick County,12,1190,571,619
Virginia,Brunswick County,13,1221,585,636
Virginia,Brunswick County,14,1156,541,615
Virginia,Brunswick County,15,893,423,470
Virginia,Brunswick County,16,633,288,345
Virginia,Brunswick County,17,453,197,256
Virginia,Brunswick County,18,388,128,260
Virginia,Buchanan County,0,21221,10735,10486
Virginia,Buchanan County,1,841,437,404
Virginia,Buchanan County,2,1026,520,506
Virginia,Buchanan County,3,1108,583,525
Virginia,Buchanan County,4,1051,525,526
Virginia,Buchanan County,5,1060,603,457
Virginia,Buchanan County,6,1221,699,522
Virginia,Buchanan County,7,1176,652,524
Virginia,Buchanan County,8,1229,646,583
Virginia,Buchanan County,9,1258,679,579
Virginia,Buchanan County,10,1499,776,723
Virginia,Buchanan County,11,1591,799,792
Virginia,Buchanan County,12,1707,844,863
Virginia,Buchanan County,13,1745,873,872
Virginia,Buchanan County,14,1490,696,794
Virginia,Buchanan County,15,1278,589,689
Virginia,Buchanan County,16,927,433,494
Virginia,Buchanan County,17,626,248,378
Virginia,Buchanan County,18,388,133,255
Virginia,Buckingham County,0,16999,9364,7635
Virginia,Buckingham County,1,677,360,317
Virginia,Buckingham County,2,881,427,454
Virginia,Buckingham County,3,916,473,443
Virginia,Buckingham County,4,818,457,361
Virginia,Buckingham County,5,926,576,350
Virginia,Buckingham County,6,1200,757,443
Virginia,Buckingham County,7,1167,729,438
Virginia,Buckingham County,8,1101,676,425
Virginia,Buckingham County,9,1102,703,399
Virginia,Buckingham County,10,1161,701,460
Virginia,Buckingham County,11,1240,697,543
Virginia,Buckingham County,12,1259,668,591
Virginia,Buckingham County,13,1211,610,601
Virginia,Buckingham County,14,1120,535,585
Virginia,Buckingham County,15,893,435,458
Virginia,Buckingham County,16,579,280,299
Virginia,Buckingham County,17,409,163,246
Virginia,Buckingham County,18,339,117,222
Virginia,Campbell County,0,54973,26723,28250
Virginia,Campbell County,1,2613,1304,1309
Virginia,Campbell County,2,2961,1510,1451
Virginia,Campbell County,3,3061,1568,1493
Virginia,Campbell County,4,3114,1575,1539
Virginia,Campbell County,5,3290,1630,1660
Virginia,Campbell County,6,3885,1939,1946
Virginia,Campbell County,7,3396,1770,1626
Virginia,Campbell County,8,3113,1583,1530
Virginia,Campbell County,9,3048,1499,1549
Virginia,Campbell County,10,3652,1775,1877
Virginia,Campbell County,11,3762,1848,1914
Virginia,Campbell County,12,4123,1954,2169
Virginia,Campbell County,13,4012,1940,2072
Virginia,Campbell County,14,3292,1531,1761
Virginia,Campbell County,15,2932,1313,1619
Virginia,Campbell County,16,1989,884,1105
Virginia,Campbell County,17,1410,598,812
Virginia,Campbell County,18,1320,502,818
Virginia,Caroline County,0,30772,15214,15558
Virginia,Caroline County,1,2018,1006,1012
Virginia,Caroline County,2,2042,1026,1016
Virginia,Caroline County,3,1929,1008,921
Virginia,Caroline County,4,1686,862,824
Virginia,Caroline County,5,1559,772,787
Virginia,Caroline County,6,2138,1041,1097
Virginia,Caroline County,7,2140,1109,1031
Virginia,Caroline County,8,2004,1060,944
Virginia,Caroline County,9,1836,929,907
Virginia,Caroline County,10,2002,1030,972
Virginia,Caroline County,11,2080,1017,1063
Virginia,Caroline County,12,2278,1150,1128
Virginia,Caroline County,13,2010,942,1068
Virginia,Caroline County,14,1686,803,883
Virginia,Caroline County,15,1371,652,719
Virginia,Caroline County,16,920,419,501
Virginia,Caroline County,17,539,202,337
Virginia,Caroline County,18,534,186,348
Virginia,Carroll County,0,29636,14676,14960
Virginia,Carroll County,1,1300,700,600
Virginia,Carroll County,2,1449,743,706
Virginia,Carroll County,3,1619,836,783
Virginia,Carroll County,4,1608,824,784
Virginia,Carroll County,5,1364,729,635
Virginia,Carroll County,6,1553,765,788
Virginia,Carroll County,7,1417,711,706
Virginia,Carroll County,8,1480,749,731
Virginia,Carroll County,9,1675,869,806
Virginia,Carroll County,10,2012,972,1040
Virginia,Carroll County,11,2218,1144,1074
Virginia,Carroll County,12,2372,1173,1199
Virginia,Carroll County,13,2310,1104,1206
Virginia,Carroll County,14,2256,1117,1139
Virginia,Carroll County,15,1953,926,1027
Virginia,Carroll County,16,1414,687,727
Virginia,Carroll County,17,860,357,503
Virginia,Carroll County,18,776,270,506
Virginia,Charles City County,0,6941,3345,3596
Virginia,Charles City County,1,257,116,141
Virginia,Charles City County,2,279,137,142
Virginia,Charles City County,3,306,151,155
Virginia,Charles City County,4,330,181,149
Virginia,Charles City County,5,315,160,155
Virginia,Charles City County,6,419,218,201
Virginia,Charles City County,7,325,163,162
Virginia,Charles City County,8,345,163,182
Virginia,Charles City County,9,314,145,169
Virginia,Charles City County,10,446,220,226
Virginia,Charles City County,11,585,282,303
Virginia,Charles City County,12,703,340,363
Virginia,Charles City County,13,609,305,304
Virginia,Charles City County,14,581,269,312
Virginia,Charles City County,15,473,243,230
Virginia,Charles City County,16,302,135,167
Virginia,Charles City County,17,175,58,117
Virginia,Charles City County,18,177,59,118
Virginia,Charlotte County,0,11938,5896,6042
Virginia,Charlotte County,1,657,348,309
Virginia,Charlotte County,2,690,377,313
Virginia,Charlotte County,3,715,358,357
Virginia,Charlotte County,4,690,359,331
Virginia,Charlotte County,5,634,338,296
Virginia,Charlotte County,6,640,338,302
Virginia,Charlotte County,7,587,290,297
Virginia,Charlotte County,8,572,281,291
Virginia,Charlotte County,9,609,293,316
Virginia,Charlotte County,10,724,352,372
Virginia,Charlotte County,11,847,409,438
Virginia,Charlotte County,12,988,511,477
Virginia,Charlotte County,13,931,448,483
Virginia,Charlotte County,14,785,378,407
Virginia,Charlotte County,15,683,321,362
Virginia,Charlotte County,16,522,245,277
Virginia,Charlotte County,17,328,151,177
Virginia,Charlotte County,18,336,99,237
Virginia,Chesterfield County,0,348556,168039,180517
Virginia,Chesterfield County,1,20848,10852,9996
Virginia,Chesterfield County,2,22635,11651,10984
Virginia,Chesterfield County,3,24079,12291,11788
Virginia,Chesterfield County,4,24853,12708,12145
Virginia,Chesterfield County,5,21020,10279,10741
Virginia,Chesterfield County,6,20497,9974,10523
Virginia,Chesterfield County,7,21358,10338,11020
Virginia,Chesterfield County,8,23707,11306,12401
Virginia,Chesterfield County,9,22931,10810,12121
Virginia,Chesterfield County,10,24550,11710,12840
Virginia,Chesterfield County,11,23852,11461,12391
Virginia,Chesterfield County,12,24096,11345,12751
Virginia,Chesterfield County,13,22102,10182,11920
Virginia,Chesterfield County,14,18368,8470,9898
Virginia,Chesterfield County,15,14615,6734,7881
Virginia,Chesterfield County,16,8990,4063,4927
Virginia,Chesterfield County,17,5120,2136,2984
Virginia,Chesterfield County,18,4935,1729,3206
Virginia,Clarke County,0,14523,7238,7285
Virginia,Clarke County,1,679,355,324
Virginia,Clarke County,2,707,359,348
Virginia,Clarke County,3,934,470,464
Virginia,Clarke County,4,882,442,440
Virginia,Clarke County,5,738,397,341
Virginia,Clarke County,6,644,336,308
Virginia,Clarke County,7,678,350,328
Virginia,Clarke County,8,772,378,394
Virginia,Clarke County,9,768,377,391
Virginia,Clarke County,10,959,465,494
Virginia,Clarke County,11,1257,651,606
Virginia,Clarke County,12,1307,662,645
Virginia,Clarke County,13,1130,549,581
Virginia,Clarke County,14,1015,529,486
Virginia,Clarke County,15,821,392,429
Virginia,Clarke County,16,535,245,290
Virginia,Clarke County,17,370,159,211
Virginia,Clarke County,18,327,122,205
Virginia,Craig County,0,5064,2508,2556
Virginia,Craig County,1,195,102,93
Virginia,Craig County,2,227,116,111
Virginia,Craig County,3,282,151,131
Virginia,Craig County,4,290,145,145
Virginia,Craig County,5,250,121,129
Virginia,Craig County,6,274,142,132
Virginia,Craig County,7,236,130,106
Virginia,Craig County,8,242,115,127
Virginia,Craig County,9,272,137,135
Virginia,Craig County,10,353,171,182
Virginia,Craig County,11,415,218,197
Virginia,Craig County,12,426,214,212
Virginia,Craig County,13,417,205,212
Virginia,Craig County,14,375,191,184
Virginia,Craig County,15,341,166,175
Virginia,Craig County,16,205,96,109
Virginia,Craig County,17,131,51,80
Virginia,Craig County,18,133,37,96
Virginia,Culpeper County,0,51859,25944,25915
Virginia,Culpeper County,1,3386,1713,1673
Virginia,Culpeper County,2,3554,1771,1783
Virginia,Culpeper County,3,3727,1861,1866
Virginia,Culpeper County,4,3407,1742,1665
Virginia,Culpeper County,5,2738,1411,1327
Virginia,Culpeper County,6,3064,1607,1457
Virginia,Culpeper County,7,3179,1583,1596
Virginia,Culpeper County,8,3382,1755,1627
Virginia,Culpeper County,9,3272,1671,1601
Virginia,Culpeper County,10,3405,1784,1621
Virginia,Culpeper County,11,3664,1856,1808
Virginia,Culpeper County,12,3701,1881,1820
Virginia,Culpeper County,13,3221,1525,1696
Virginia,Culpeper County,14,2706,1334,1372
Virginia,Culpeper County,15,2241,1025,1216
Virginia,Culpeper County,16,1499,714,785
Virginia,Culpeper County,17,890,407,483
Virginia,Culpeper County,18,823,304,519
Virginia,Cumberland County,0,9809,4736,5073
Virginia,Cumberland County,1,468,235,233
Virginia,Cumberland County,2,511,267,244
Virginia,Cumberland County,3,550,276,274
Virginia,Cumberland County,4,555,272,283
Virginia,Cumberland County,5,547,259,288
Virginia,Cumberland County,6,640,323,317
Virginia,Cumberland County,7,513,248,265
Virginia,Cumberland County,8,521,256,265
Virginia,Cumberland County,9,489,222,267
Virginia,Cumberland County,10,610,292,318
Virginia,Cumberland County,11,744,371,373
Virginia,Cumberland County,12,776,390,386
Virginia,Cumberland County,13,686,323,363
Virginia,Cumberland County,14,690,328,362
Virginia,Cumberland County,15,627,295,332
Virginia,Cumberland County,16,432,201,231
Virginia,Cumberland County,17,233,101,132
Virginia,Cumberland County,18,217,77,140
Virginia,Dickenson County,0,14523,7360,7163
Virginia,Dickenson County,1,691,339,352
Virginia,Dickenson County,2,810,436,374
Virginia,Dickenson County,3,858,446,412
Virginia,Dickenson County,4,776,401,375
Virginia,Dickenson County,5,677,351,326
Virginia,Dickenson County,6,842,451,391
Virginia,Dickenson County,7,782,410,372
Virginia,Dickenson County,8,915,487,428
Virginia,Dickenson County,9,909,474,435
Virginia,Dickenson County,10,928,492,436
Virginia,Dickenson County,11,951,510,441
Virginia,Dickenson County,12,1083,527,556
Virginia,Dickenson County,13,1103,572,531
Virginia,Dickenson County,14,995,475,520
Virginia,Dickenson County,15,877,417,460
Virginia,Dickenson County,16,645,312,333
Virginia,Dickenson County,17,361,158,203
Virginia,Dickenson County,18,320,102,218
Virginia,Dinwiddie County,0,28529,13941,14588
Virginia,Dinwiddie County,1,1344,682,662
Virginia,Dinwiddie County,2,1640,827,813
Virginia,Dinwiddie County,3,1673,840,833
Virginia,Dinwiddie County,4,1735,875,860
Virginia,Dinwiddie County,5,1580,801,779
Virginia,Dinwiddie County,6,1897,957,940
Virginia,Dinwiddie County,7,1774,883,891
Virginia,Dinwiddie County,8,1606,762,844
Virginia,Dinwiddie County,9,1609,778,831
Virginia,Dinwiddie County,10,1970,965,1005
Virginia,Dinwiddie County,11,2307,1138,1169
Virginia,Dinwiddie County,12,2325,1177,1148
Virginia,Dinwiddie County,13,2088,1004,1084
Virginia,Dinwiddie County,14,1648,762,886
Virginia,Dinwiddie County,15,1313,639,674
Virginia,Dinwiddie County,16,943,438,505
Virginia,Dinwiddie County,17,581,241,340
Virginia,Dinwiddie County,18,496,172,324
Virginia,Essex County,0,10919,5113,5806
Virginia,Essex County,1,516,268,248
Virginia,Essex County,2,564,299,265
Virginia,Essex County,3,571,262,309
Virginia,Essex County,4,589,262,327
Virginia,Essex County,5,553,276,277
Virginia,Essex County,6,675,333,342
Virginia,Essex County,7,610,293,317
Virginia,Essex County,8,541,256,285
Virginia,Essex County,9,525,242,283
Virginia,Essex County,10,687,305,382
Virginia,Essex County,11,793,352,441
Virginia,Essex County,12,897,414,483
Virginia,Essex County,13,868,426,442
Virginia,Essex County,14,830,362,468
Virginia,Essex County,15,673,307,366
Virginia,Essex County,16,468,228,240
Virginia,Essex County,17,286,130,156
Virginia,Essex County,18,273,98,175
Virginia,Fairfax County,0,1150795,570871,579924
Virginia,Fairfax County,1,72674,37266,35408
Virginia,Fairfax County,2,74202,37813,36389
Virginia,Fairfax County,3,76520,39293,37227
Virginia,Fairfax County,4,72948,37362,35586
Virginia,Fairfax County,5,69156,34972,34184
Virginia,Fairfax County,6,74384,38486,35898
Virginia,Fairfax County,7,79412,40560,38852
Virginia,Fairfax County,8,85272,42343,42929
Virginia,Fairfax County,9,80970,39748,41222
Virginia,Fairfax County,10,83629,41091,42538
Virginia,Fairfax County,11,80346,39270,41076
Virginia,Fairfax County,12,78869,38844,40025
Virginia,Fairfax County,13,67573,32912,34661
Virginia,Fairfax County,14,52927,25190,27737
Virginia,Fairfax County,15,41144,19365,21779
Virginia,Fairfax County,16,26749,12369,14380
Virginia,Fairfax County,17,16357,7297,9060
Virginia,Fairfax County,18,17663,6690,10973
Virginia,Fauquier County,0,70675,34991,35684
Virginia,Fauquier County,1,4176,2116,2060
Virginia,Fauquier County,2,4452,2249,2203
Virginia,Fauquier County,3,4763,2507,2256
Virginia,Fauquier County,4,4742,2459,2283
Virginia,Fauquier County,5,3869,1930,1939
Virginia,Fauquier County,6,3848,1924,1924
Virginia,Fauquier County,7,4002,2029,1973
Virginia,Fauquier County,8,4215,2070,2145
Virginia,Fauquier County,9,4075,2013,2062
Virginia,Fauquier County,10,4943,2416,2527
Virginia,Fauquier County,11,5428,2646,2782
Virginia,Fauquier County,12,5731,2833,2898
Virginia,Fauquier County,13,4811,2394,2417
Virginia,Fauquier County,14,3899,1885,2014
Virginia,Fauquier County,15,3097,1522,1575
Virginia,Fauquier County,16,2157,988,1169
Virginia,Fauquier County,17,1335,604,731
Virginia,Fauquier County,18,1132,406,726
Virginia,Floyd County,0,15795,7939,7856
Virginia,Floyd County,1,764,398,366
Virginia,Floyd County,2,834,442,392
Virginia,Floyd County,3,952,491,461
Virginia,Floyd County,4,880,453,427
Virginia,Floyd County,5,723,371,352
Virginia,Floyd County,6,752,360,392
Virginia,Floyd County,7,775,408,367
Virginia,Floyd County,8,861,427,434
Virginia,Floyd County,9,934,471,463
Virginia,Floyd County,10,1060,537,523
Virginia,Floyd County,11,1109,615,494
Virginia,Floyd County,12,1267,625,642
Virginia,Floyd County,13,1280,633,647
Virginia,Floyd County,14,1191,593,598
Virginia,Floyd County,15,910,428,482
Virginia,Floyd County,16,706,371,335
Virginia,Floyd County,17,426,193,233
Virginia,Floyd County,18,371,123,248
Virginia,Fluvanna County,0,26783,12252,14531
Virginia,Fluvanna County,1,1295,660,635
Virginia,Fluvanna County,2,1368,702,666
Virginia,Fluvanna County,3,1647,820,827
Virginia,Fluvanna County,4,1496,724,772
Virginia,Fluvanna County,5,1387,596,791
Virginia,Fluvanna County,6,1536,627,909
Virginia,Fluvanna County,7,1607,714,893
Virginia,Fluvanna County,8,1817,792,1025
Virginia,Fluvanna County,9,1622,709,913
Virginia,Fluvanna County,10,1790,810,980
Virginia,Fluvanna County,11,1895,833,1062
Virginia,Fluvanna County,12,1951,917,1034
Virginia,Fluvanna County,13,1954,888,1066
Virginia,Fluvanna County,14,1669,774,895
Virginia,Fluvanna County,15,1519,703,816
Virginia,Fluvanna County,16,1039,475,564
Virginia,Fluvanna County,17,649,288,361
Virginia,Fluvanna County,18,542,220,322
Virginia,Franklin County,0,56195,27672,28523
Virginia,Franklin County,1,2665,1348,1317
Virginia,Franklin County,2,2933,1465,1468
Virginia,Franklin County,3,3194,1658,1536
Virginia,Franklin County,4,3387,1680,1707
Virginia,Franklin County,5,2894,1454,1440
Virginia,Franklin County,6,2923,1471,1452
Virginia,Franklin County,7,2692,1298,1394
Virginia,Franklin County,8,2740,1393,1347
Virginia,Franklin County,9,2743,1344,1399
Virginia,Franklin County,10,3505,1735,1770
Virginia,Franklin County,11,4182,2091,2091
Virginia,Franklin County,12,4556,2238,2318
Virginia,Franklin County,13,4562,2246,2316
Virginia,Franklin County,14,4274,2062,2212
Virginia,Franklin County,15,3689,1836,1853
Virginia,Franklin County,16,2499,1237,1262
Virginia,Franklin County,17,1498,650,848
Virginia,Franklin County,18,1259,466,793
Virginia,Frederick County,0,88355,44026,44329
Virginia,Frederick County,1,5426,2783,2643
Virginia,Frederick County,2,5448,2757,2691
Virginia,Frederick County,3,5881,3062,2819
Virginia,Frederick County,4,5529,2874,2655
Virginia,Frederick County,5,4855,2492,2363
Virginia,Frederick County,6,5351,2740,2611
Virginia,Frederick County,7,5307,2652,2655
Virginia,Frederick County,8,5709,2826,2883
Virginia,Frederick County,9,5197,2610,2587
Virginia,Frederick County,10,5950,2986,2964
Virginia,Frederick County,11,6434,3234,3200
Virginia,Frederick County,12,6449,3236,3213
Virginia,Frederick County,13,5555,2717,2838
Virginia,Frederick County,14,4796,2291,2505
Virginia,Frederick County,15,4103,1955,2148
Virginia,Frederick County,16,2834,1303,1531
Virginia,Frederick County,17,1820,831,989
Virginia,Frederick County,18,1711,677,1034
Virginia,Giles County,0,16844,8297,8547
Virginia,Giles County,1,905,445,460
Virginia,Giles County,2,936,473,463
Virginia,Giles County,3,951,486,465
Virginia,Giles County,4,1035,537,498
Virginia,Giles County,5,856,440,416
Virginia,Giles County,6,1018,512,506
Virginia,Giles County,7,824,423,401
Virginia,Giles County,8,900,449,451
Virginia,Giles County,9,989,490,499
Virginia,Giles County,10,1171,582,589
Virginia,Giles County,11,1271,634,637
Virginia,Giles County,12,1188,619,569
Virginia,Giles County,13,1119,511,608
Virginia,Giles County,14,1137,575,562
Virginia,Giles County,15,1008,480,528
Virginia,Giles County,16,718,350,368
Virginia,Giles County,17,410,176,234
Virginia,Giles County,18,408,115,293
Virginia,Gloucester County,0,37349,18376,18973
Virginia,Gloucester County,1,1893,996,897
Virginia,Gloucester County,2,2082,1016,1066
Virginia,Gloucester County,3,2097,1074,1023
Virginia,Gloucester County,4,2154,1144,1010
Virginia,Gloucester County,5,1865,936,929
Virginia,Gloucester County,6,2213,1110,1103
Virginia,Gloucester County,7,2203,1120,1083
Virginia,Gloucester County,8,2233,1132,1101
Virginia,Gloucester County,9,2085,1036,1049
Virginia,Gloucester County,10,2332,1150,1182
Virginia,Gloucester County,11,2827,1335,1492
Virginia,Gloucester County,12,3196,1584,1612
Virginia,Gloucester County,13,3051,1460,1591
Virginia,Gloucester County,14,2324,1133,1191
Virginia,Gloucester County,15,1884,913,971
Virginia,Gloucester County,16,1343,606,737
Virginia,Gloucester County,17,816,365,451
Virginia,Gloucester County,18,751,266,485
Virginia,Goochland County,0,23244,11401,11843
Virginia,Goochland County,1,879,434,445
Virginia,Goochland County,2,1082,571,511
Virginia,Goochland County,3,1272,651,621
Virginia,Goochland County,4,1318,672,646
Virginia,Goochland County,5,1109,557,552
Virginia,Goochland County,6,1183,630,553
Virginia,Goochland County,7,1090,559,531
Virginia,Goochland County,8,1172,566,606
Virginia,Goochland County,9,1325,643,682
Virginia,Goochland County,10,1624,775,849
Virginia,Goochland County,11,1859,881,978
Virginia,Goochland County,12,2159,1029,1130
Virginia,Goochland County,13,1981,940,1041
Virginia,Goochland County,14,1759,864,895
Virginia,Goochland County,15,1479,727,752
Virginia,Goochland County,16,948,444,504
Virginia,Goochland County,17,493,244,249
Virginia,Goochland County,18,512,214,298
Virginia,Grayson County,0,15631,8047,7584
Virginia,Grayson County,1,654,343,311
Virginia,Grayson County,2,716,341,375
Virginia,Grayson County,3,732,374,358
Virginia,Grayson County,4,805,415,390
Virginia,Grayson County,5,819,480,339
Virginia,Grayson County,6,858,494,364
Virginia,Grayson County,7,788,453,335
Virginia,Grayson County,8,779,434,345
Virginia,Grayson County,9,920,508,412
Virginia,Grayson County,10,1078,600,478
Virginia,Grayson County,11,1161,586,575
Virginia,Grayson County,12,1239,615,624
Virginia,Grayson County,13,1250,641,609
Virginia,Grayson County,14,1201,593,608
Virginia,Grayson County,15,977,487,490
Virginia,Grayson County,16,713,321,392
Virginia,Grayson County,17,477,207,270
Virginia,Grayson County,18,464,155,309
Virginia,Greene County,0,19779,9632,10147
Virginia,Greene County,1,1240,601,639
Virginia,Greene County,2,1322,670,652
Virginia,Greene County,3,1386,698,688
Virginia,Greene County,4,1222,660,562
Virginia,Greene County,5,910,483,427
Virginia,Greene County,6,1134,550,584
Virginia,Greene County,7,1250,607,643
Virginia,Greene County,8,1241,588,653
Virginia,Greene County,9,1162,582,580
Virginia,Greene County,10,1288,616,672
Virginia,Greene County,11,1435,709,726
Virginia,Greene County,12,1469,726,743
Virginia,Greene County,13,1288,601,687
Virginia,Greene County,14,1112,512,600
Virginia,Greene County,15,1012,461,551
Virginia,Greene County,16,638,318,320
Virginia,Greene County,17,359,144,215
Virginia,Greene County,18,311,106,205
Virginia,Greensville County,0,11627,7285,4342
Virginia,Greensville County,1,592,306,286
Virginia,Greensville County,2,551,302,249
Virginia,Greensville County,3,549,279,270
Virginia,Greensville County,4,546,296,250
Virginia,Greensville County,5,753,568,185
Virginia,Greensville County,6,905,651,254
Virginia,Greensville County,7,960,716,244
Virginia,Greensville County,8,826,632,194
Virginia,Greensville County,9,887,656,231
Virginia,Greensville County,10,949,660,289
Virginia,Greensville County,11,863,575,288
Virginia,Greensville County,12,770,467,303
Virginia,Greensville County,13,721,373,348
Virginia,Greensville County,14,618,326,292
Virginia,Greensville County,15,470,211,259
Virginia,Greensville County,16,318,129,189
Virginia,Greensville County,17,189,71,118
Virginia,Greensville County,18,160,67,93
Virginia,Halifax County,0,34120,16355,17765
Virginia,Halifax County,1,1780,884,896
Virginia,Halifax County,2,1784,937,847
Virginia,Halifax County,3,2094,1041,1053
Virginia,Halifax County,4,1947,999,948
Virginia,Halifax County,5,1822,942,880
Virginia,Halifax County,6,1892,985,907
Virginia,Halifax County,7,1655,815,840
Virginia,Halifax County,8,1693,813,880
Virginia,Halifax County,9,1695,830,865
Virginia,Halifax County,10,2053,982,1071
Virginia,Halifax County,11,2251,1097,1154
Virginia,Halifax County,12,2473,1221,1252
Virginia,Halifax County,13,2668,1235,1433
Virginia,Halifax County,14,2519,1190,1329
Virginia,Halifax County,15,2208,1019,1189
Virginia,Halifax County,16,1518,674,844
Virginia,Halifax County,17,1042,400,642
Virginia,Halifax County,18,1026,291,735
Virginia,Hanover County,0,107239,52476,54763
Virginia,Hanover County,1,5416,2813,2603
Virginia,Hanover County,2,6407,3359,3048
Virginia,Hanover County,3,7230,3745,3485
Virginia,Hanover County,4,7437,3786,3651
Virginia,Hanover County,5,6293,3254,3039
Virginia,Hanover County,6,5381,2746,2635
Virginia,Hanover County,7,5731,2806,2925
Virginia,Hanover County,8,6342,3140,3202
Virginia,Hanover County,9,6334,3034,3300
Virginia,Hanover County,10,7573,3696,3877
Virginia,Hanover County,11,7922,3751,4171
Virginia,Hanover County,12,8597,4161,4436
Virginia,Hanover County,13,7544,3644,3900
Virginia,Hanover County,14,6218,2972,3246
Virginia,Hanover County,15,5003,2333,2670
Virginia,Hanover County,16,3478,1550,1928
Virginia,Hanover County,17,2100,908,1192
Virginia,Hanover County,18,2233,778,1455
Virginia,Henrico County,0,329261,156230,173031
Virginia,Henrico County,1,19533,10163,9370
Virginia,Henrico County,2,20175,10398,9777
Virginia,Henrico County,3,21616,10883,10733
Virginia,Henrico County,4,19929,10361,9568
Virginia,Henrico County,5,18475,9297,9178
Virginia,Henrico County,6,23805,11484,12321
Virginia,Henrico County,7,23609,11367,12242
Virginia,Henrico County,8,23192,11105,12087
Virginia,Henrico County,9,20750,9857,10893
Virginia,Henrico County,10,22350,10573,11777
Virginia,Henrico County,11,21856,10208,11648
Virginia,Henrico County,12,22388,10333,12055
Virginia,Henrico County,13,20538,9209,11329
Virginia,Henrico County,14,16884,7504,9380
Virginia,Henrico County,15,12859,5597,7262
Virginia,Henrico County,16,8581,3533,5048
Virginia,Henrico County,17,5736,2127,3609
Virginia,Henrico County,18,6985,2231,4754
Virginia,Henry County,0,50953,24528,26425
Virginia,Henry County,1,2363,1161,1202
Virginia,Henry County,2,2798,1470,1328
Virginia,Henry County,3,2917,1518,1399
Virginia,Henry County,4,2791,1437,1354
Virginia,Henry County,5,2534,1282,1252
Virginia,Henry County,6,2718,1364,1354
Virginia,Henry County,7,2594,1232,1362
Virginia,Henry County,8,2491,1176,1315
Virginia,Henry County,9,2658,1331,1327
Virginia,Henry County,10,3220,1560,1660
Virginia,Henry County,11,3789,1828,1961
Virginia,Henry County,12,4015,1954,2061
Virginia,Henry County,13,3887,1903,1984
Virginia,Henry County,14,3411,1589,1822
Virginia,Henry County,15,3102,1383,1719
Virginia,Henry County,16,2508,1104,1404
Virginia,Henry County,17,1597,692,905
Virginia,Henry County,18,1560,544,1016
Virginia,Highland County,0,2210,1100,1110
Virginia,Highland County,1,100,50,50
Virginia,Highland County,2,67,34,33
Virginia,Highland County,3,65,28,37
Virginia,Highland County,4,85,42,43
Virginia,Highland County,5,66,31,35
Virginia,Highland County,6,108,53,55
Virginia,Highland County,7,83,38,45
Virginia,Highland County,8,72,40,32
Virginia,Highland County,9,98,46,52
Virginia,Highland County,10,103,59,44
Virginia,Highland County,11,110,63,47
Virginia,Highland County,12,230,111,119
Virginia,Highland County,13,263,129,134
Virginia,Highland County,14,242,130,112
Virginia,Highland County,15,218,110,108
Virginia,Highland County,16,136,67,69
Virginia,Highland County,17,92,45,47
Virginia,Highland County,18,72,24,48
Virginia,Isle of Wight County,0,36953,18094,18859
Virginia,Isle of Wight County,1,1956,1022,934
Virginia,Isle of Wight County,2,2081,1082,999
Virginia,Isle of Wight County,3,2260,1103,1157
Virginia,Isle of Wight County,4,2126,1085,1041
Virginia,Isle of Wight County,5,1981,1059,922
Virginia,Isle of Wight County,6,1929,976,953
Virginia,Isle of Wight County,7,2109,1006,1103
Virginia,Isle of Wight County,8,2219,1129,1090
Virginia,Isle of Wight County,9,1974,949,1025
Virginia,Isle of Wight County,10,2427,1179,1248
Virginia,Isle of Wight County,11,2713,1290,1423
Virginia,Isle of Wight County,12,3355,1663,1692
Virginia,Isle of Wight County,13,2748,1373,1375
Virginia,Isle of Wight County,14,2375,1131,1244
Virginia,Isle of Wight County,15,1832,835,997
Virginia,Isle of Wight County,16,1295,617,678
Virginia,Isle of Wight County,17,795,345,450
Virginia,Isle of Wight County,18,778,250,528
Virginia,James City County,0,76397,36921,39476
Virginia,James City County,1,3779,1911,1868
Virginia,James City County,2,4135,2116,2019
Virginia,James City County,3,4546,2303,2243
Virginia,James City County,4,4419,2277,2142
Virginia,James City County,5,3713,1934,1779
Virginia,James City County,6,3892,1978,1914
Virginia,James City County,7,3870,1933,1937
Virginia,James City County,8,4273,2109,2164
Virginia,James City County,9,4051,1954,2097
Virginia,James City County,10,4589,2221,2368
Virginia,James City County,11,5012,2420,2592
Virginia,James City County,12,5470,2538,2932
Virginia,James City County,13,5347,2451,2896
Virginia,James City County,14,5506,2507,2999
Virginia,James City County,15,5174,2374,2800
Virginia,James City County,16,3852,1779,2073
Virginia,James City County,17,2442,1195,1247
Virginia,James City County,18,2327,921,1406
Virginia,King and Queen County,0,7042,3567,3475
Virginia,King and Queen County,1,304,151,153
Virginia,King and Queen County,2,329,164,165
Virginia,King and Queen County,3,391,195,196
Virginia,King and Queen County,4,339,182,157
Virginia,King and Queen County,5,377,203,174
Virginia,King and Queen County,6,431,228,203
Virginia,King and Queen County,7,374,212,162
Virginia,King and Queen County,8,349,176,173
Virginia,King and Queen County,9,338,177,161
Virginia,King and Queen County,10,449,231,218
Virginia,King and Queen County,11,547,274,273
Virginia,King and Queen County,12,593,304,289
Virginia,King and Queen County,13,609,315,294
Virginia,King and Queen County,14,529,259,270
Virginia,King and Queen County,15,422,212,210
Virginia,King and Queen County,16,305,150,155
Virginia,King and Queen County,17,160,67,93
Virginia,King and Queen County,18,196,67,129
Virginia,King George County,0,26575,13459,13116
Virginia,King George County,1,1595,844,751
Virginia,King George County,2,1858,959,899
Virginia,King George County,3,2041,1053,988
Virginia,King George County,4,1735,871,864
Virginia,King George County,5,1638,925,713
Virginia,King George County,6,1663,879,784
Virginia,King George County,7,1664,829,835
Virginia,King George County,8,1912,946,966
Virginia,King George County,9,1765,889,876
Virginia,King George County,10,1721,851,870
Virginia,King George County,11,1984,982,1002
Virginia,King George County,12,1956,997,959
Virginia,King George County,13,1567,785,782
Virginia,King George County,14,1171,586,585
Virginia,King George County,15,956,469,487
Virginia,King George County,16,628,304,324
Virginia,King George County,17,380,162,218
Virginia,King George County,18,341,128,213
Virginia,King William County,0,16939,8291,8648
Virginia,King William County,1,1022,527,495
Virginia,King William County,2,1035,520,515
Virginia,King William County,3,1144,595,549
Virginia,King William County,4,1051,558,493
Virginia,King William County,5,862,423,439
Virginia,King William County,6,1104,530,574
Virginia,King William County,7,1124,554,570
Virginia,King William County,8,1081,539,542
Virginia,King William County,9,1004,506,498
Virginia,King William County,10,1133,556,577
Virginia,King William County,11,1288,616,672
Virginia,King William County,12,1287,644,643
Virginia,King William County,13,1076,503,573
Virginia,King William County,14,969,429,540
Virginia,King William County,15,738,368,370
Virginia,King William County,16,479,217,262
Virginia,King William County,17,298,125,173
Virginia,King William County,18,244,81,163
Virginia,Lancaster County,0,10783,5083,5700
Virginia,Lancaster County,1,486,233,253
Virginia,Lancaster County,2,435,233,202
Virginia,Lancaster County,3,496,280,216
Virginia,Lancaster County,4,470,249,221
Virginia,Lancaster County,5,398,196,202
Virginia,Lancaster County,6,452,227,225
Virginia,Lancaster County,7,433,203,230
Virginia,Lancaster County,8,394,199,195
Virginia,Lancaster County,9,399,176,223
Virginia,Lancaster County,10,485,230,255
Virginia,Lancaster County,11,573,270,303
Virginia,Lancaster County,12,832,372,460
Virginia,Lancaster County,13,1034,458,576
Virginia,Lancaster County,14,1000,488,512
Virginia,Lancaster County,15,1009,456,553
Virginia,Lancaster County,16,789,383,406
Virginia,Lancaster County,17,501,224,277
Virginia,Lancaster County,18,597,206,391
Virginia,Lee County,0,23541,12237,11304
Virginia,Lee County,1,1079,589,490
Virginia,Lee County,2,1241,649,592
Virginia,Lee County,3,1276,643,633
Virginia,Lee County,4,1207,615,592
Virginia,Lee County,5,1170,652,518
Virginia,Lee County,6,1517,900,617
Virginia,Lee County,7,1424,880,544
Virginia,Lee County,8,1437,830,607
Virginia,Lee County,9,1440,783,657
Virginia,Lee County,10,1619,842,777
Virginia,Lee County,11,1586,778,808
Virginia,Lee County,12,1705,831,874
Virginia,Lee County,13,1814,911,903
Virginia,Lee County,14,1639,804,835
Virginia,Lee County,15,1309,644,665
Virginia,Lee County,16,993,433,560
Virginia,Lee County,17,630,278,352
Virginia,Lee County,18,455,175,280
Virginia,Loudoun County,0,406850,201469,205381
Virginia,Loudoun County,1,28856,14580,14276
Virginia,Loudoun County,2,32680,16858,15822
Virginia,Loudoun County,3,34052,17286,16766
Virginia,Loudoun County,4,28840,14456,14384
Virginia,Loudoun County,5,20967,10558,10409
Virginia,Loudoun County,6,20174,10021,10153
Virginia,Loudoun County,7,27683,13111,14572
Virginia,Loudoun County,8,35141,16925,18216
Virginia,Loudoun County,9,34435,17122,17313
Virginia,Loudoun County,10,34321,17583,16738
Virginia,Loudoun County,11,29577,14871,14706
Virginia,Loudoun County,12,24699,12604,12095
Virginia,Loudoun County,13,17623,8732,8891
Virginia,Loudoun County,14,12682,5930,6752
Virginia,Loudoun County,15,10048,4510,5538
Virginia,Loudoun County,16,6615,2917,3698
Virginia,Loudoun County,17,4188,1764,2424
Virginia,Loudoun County,18,4269,1641,2628
Virginia,Louisa County,0,36778,18169,18609
Virginia,Louisa County,1,1972,1014,958
Virginia,Louisa County,2,2003,1000,1003
Virginia,Louisa County,3,2165,1097,1068
Virginia,Louisa County,4,1907,955,952
Virginia,Louisa County,5,1743,921,822
Virginia,Louisa County,6,2191,1058,1133
Virginia,Louisa County,7,2148,1043,1105
Virginia,Louisa County,8,2097,1046,1051
Virginia,Louisa County,9,1990,989,1001
Virginia,Louisa County,10,2313,1161,1152
Virginia,Louisa County,11,2789,1349,1440
Virginia,Louisa County,12,3219,1581,1638
Virginia,Louisa County,13,2957,1466,1491
Virginia,Louisa County,14,2564,1258,1306
Virginia,Louisa County,15,2037,1012,1025
Virginia,Louisa County,16,1275,598,677
Virginia,Louisa County,17,766,357,409
Virginia,Louisa County,18,642,264,378
Virginia,Lunenburg County,0,12086,6400,5686
Virginia,Lunenburg County,1,588,311,277
Virginia,Lunenburg County,2,616,329,287
Virginia,Lunenburg County,3,670,337,333
Virginia,Lunenburg County,4,561,297,264
Virginia,Lunenburg County,5,587,331,256
Virginia,Lunenburg County,6,746,423,323
Virginia,Lunenburg County,7,727,434,293
Virginia,Lunenburg County,8,700,450,250
Virginia,Lunenburg County,9,791,476,315
Virginia,Lunenburg County,10,707,404,303
Virginia,Lunenburg County,11,835,471,364
Virginia,Lunenburg County,12,883,449,434
Virginia,Lunenburg County,13,978,469,509
Virginia,Lunenburg County,14,891,458,433
Virginia,Lunenburg County,15,702,306,396
Virginia,Lunenburg County,16,487,228,259
Virginia,Lunenburg County,17,337,139,198
Virginia,Lunenburg County,18,280,88,192
Virginia,Madison County,0,13295,6416,6879
Virginia,Madison County,1,657,334,323
Virginia,Madison County,2,711,341,370
Virginia,Madison County,3,818,415,403
Virginia,Madison County,4,776,370,406
Virginia,Madison County,5,624,297,327
Virginia,Madison County,6,719,367,352
Virginia,Madison County,7,730,359,371
Virginia,Madison County,8,686,336,350
Virginia,Madison County,9,678,325,353
Virginia,Madison County,10,806,395,411
Virginia,Madison County,11,918,467,451
Virginia,Madison County,12,1136,542,594
Virginia,Madison County,13,1077,517,560
Virginia,Madison County,14,927,428,499
Virginia,Madison County,15,779,350,429
Virginia,Madison County,16,544,262,282
Virginia,Madison County,17,371,178,193
Virginia,Madison County,18,338,133,205
Virginia,Mathews County,0,8802,4235,4567
Virginia,Mathews County,1,317,173,144
Virginia,Mathews County,2,361,179,182
Virginia,Mathews County,3,393,179,214
Virginia,Mathews County,4,463,235,228
Virginia,Mathews County,5,434,223,211
Virginia,Mathews County,6,355,183,172
Virginia,Mathews County,7,374,178,196
Virginia,Mathews County,8,336,160,176
Virginia,Mathews County,9,428,224,204
Virginia,Mathews County,10,503,250,253
Virginia,Mathews County,11,623,290,333
Virginia,Mathews County,12,684,332,352
Virginia,Mathews County,13,797,368,429
Virginia,Mathews County,14,767,362,405
Virginia,Mathews County,15,740,340,400
Virginia,Mathews County,16,542,263,279
Virginia,Mathews County,17,384,175,209
Virginia,Mathews County,18,301,121,180
Virginia,Mecklenburg County,0,30650,14885,15765
Virginia,Mecklenburg County,1,1473,748,725
Virginia,Mecklenburg County,2,1504,750,754
Virginia,Mecklenburg County,3,1683,862,821
Virginia,Mecklenburg County,4,1602,816,786
Virginia,Mecklenburg County,5,1548,796,752
Virginia,Mecklenburg County,6,1630,871,759
Virginia,Mecklenburg County,7,1460,749,711
Virginia,Mecklenburg County,8,1509,791,718
Virginia,Mecklenburg County,9,1546,739,807
Virginia,Mecklenburg County,10,1800,860,940
Virginia,Mecklenburg County,11,2057,1012,1045
Virginia,Mecklenburg County,12,2446,1176,1270
Virginia,Mecklenburg County,13,2534,1200,1334
Virginia,Mecklenburg County,14,2396,1139,1257
Virginia,Mecklenburg County,15,2116,988,1128
Virginia,Mecklenburg County,16,1493,676,817
Virginia,Mecklenburg County,17,969,398,571
Virginia,Mecklenburg County,18,884,314,570
Virginia,Middlesex County,0,10769,5243,5526
Virginia,Middlesex County,1,506,252,254
Virginia,Middlesex County,2,427,222,205
Virginia,Middlesex County,3,504,252,252
Virginia,Middlesex County,4,503,263,240
Virginia,Middlesex County,5,454,238,216
Virginia,Middlesex County,6,505,284,221
Virginia,Middlesex County,7,458,234,224
Virginia,Middlesex County,8,482,247,235
Virginia,Middlesex County,9,407,205,202
Virginia,Middlesex County,10,585,292,293
Virginia,Middlesex County,11,679,316,363
Virginia,Middlesex County,12,942,461,481
Virginia,Middlesex County,13,964,434,530
Virginia,Middlesex County,14,920,423,497
Virginia,Middlesex County,15,954,453,501
Virginia,Middlesex County,16,690,335,355
Virginia,Middlesex County,17,387,174,213
Virginia,Middlesex County,18,402,158,244
Virginia,Montgomery County,0,98985,51452,47533
Virginia,Montgomery County,1,4217,2141,2076
Virginia,Montgomery County,2,4231,2171,2060
Virginia,Montgomery County,3,4284,2219,2065
Virginia,Montgomery County,4,10993,5994,4999
Virginia,Montgomery County,5,18531,10706,7825
Virginia,Montgomery County,6,7937,4277,3660
Virginia,Montgomery County,7,6301,3327,2974
Virginia,Montgomery County,8,5031,2679,2352
Virginia,Montgomery County,9,4813,2442,2371
Virginia,Montgomery County,10,5200,2579,2621
Virginia,Montgomery County,11,4986,2514,2472
Virginia,Montgomery County,12,4964,2369,2595
Virginia,Montgomery County,13,5022,2463,2559
Virginia,Montgomery County,14,4075,1913,2162
Virginia,Montgomery County,15,3160,1463,1697
Virginia,Montgomery County,16,2237,1030,1207
Virginia,Montgomery County,17,1492,638,854
Virginia,Montgomery County,18,1511,527,984
Virginia,Nelson County,0,14836,7170,7666
Virginia,Nelson County,1,620,302,318
Virginia,Nelson County,2,689,341,348
Virginia,Nelson County,3,798,405,393
Virginia,Nelson County,4,798,421,377
Virginia,Nelson County,5,658,347,311
Virginia,Nelson County,6,691,336,355
Virginia,Nelson County,7,698,341,357
Virginia,Nelson County,8,788,369,419
Virginia,Nelson County,9,720,351,369
Virginia,Nelson County,10,846,429,417
Virginia,Nelson County,11,1001,479,522
Virginia,Nelson County,12,1149,548,601
Virginia,Nelson County,13,1327,625,702
Virginia,Nelson County,14,1400,659,741
Virginia,Nelson County,15,1139,565,574
Virginia,Nelson County,16,762,362,400
Virginia,Nelson County,17,404,180,224
Virginia,Nelson County,18,348,110,238
Virginia,New Kent County,0,22391,11450,10941
Virginia,New Kent County,1,1133,599,534
Virginia,New Kent County,2,1210,591,619
Virginia,New Kent County,3,1347,714,633
Virginia,New Kent County,4,1242,658,584
Virginia,New Kent County,5,1123,600,523
Virginia,New Kent County,6,1397,799,598
Virginia,New Kent County,7,1464,774,690
Virginia,New Kent County,8,1380,697,683
Virginia,New Kent County,9,1390,712,678
Virginia,New Kent County,10,1565,821,744
Virginia,New Kent County,11,1712,871,841
Virginia,New Kent County,12,1785,886,899
Virginia,New Kent County,13,1783,872,911
Virginia,New Kent County,14,1445,688,757
Virginia,New Kent County,15,1193,604,589
Virginia,New Kent County,16,631,321,310
Virginia,New Kent County,17,326,151,175
Virginia,New Kent County,18,265,92,173
Virginia,Northampton County,0,11735,5603,6132
Virginia,Northampton County,1,556,274,282
Virginia,Northampton County,2,682,381,301
Virginia,Northampton County,3,693,361,332
Virginia,Northampton County,4,582,311,271
Virginia,Northampton County,5,522,288,234
Virginia,Northampton County,6,600,304,296
Virginia,Northampton County,7,566,273,293
Virginia,Northampton County,8,598,293,305
Virginia,Northampton County,9,501,254,247
Virginia,Northampton County,10,618,287,331
Virginia,Northampton County,11,658,299,359
Virginia,Northampton County,12,991,437,554
Virginia,Northampton County,13,1070,478,592
Virginia,Northampton County,14,983,467,516
Virginia,Northampton County,15,788,361,427
Virginia,Northampton County,16,564,251,313
Virginia,Northampton County,17,337,142,195
Virginia,Northampton County,18,426,142,284
Virginia,Northumberland County,0,12147,5956,6191
Virginia,Northumberland County,1,413,216,197
Virginia,Northumberland County,2,515,278,237
Virginia,Northumberland County,3,497,275,222
Virginia,Northumberland County,4,513,270,243
Virginia,Northumberland County,5,474,243,231
Virginia,Northumberland County,6,524,247,277
Virginia,Northumberland County,7,428,207,221
Virginia,Northumberland County,8,498,250,248
Virginia,Northumberland County,9,441,225,216
Virginia,Northumberland County,10,477,226,251
Virginia,Northumberland County,11,769,345,424
Virginia,Northumberland County,12,1019,485,534
Virginia,Northumberland County,13,1123,534,589
Virginia,Northumberland County,14,1229,575,654
Virginia,Northumberland County,15,1256,582,674
Virginia,Northumberland County,16,944,484,460
Virginia,Northumberland County,17,527,286,241
Virginia,Northumberland County,18,500,228,272
Virginia,Nottoway County,0,15420,8338,7082
Virginia,Nottoway County,1,767,379,388
Virginia,Nottoway County,2,831,394,437
Virginia,Nottoway County,3,829,431,398
Virginia,Nottoway County,4,817,412,405
Virginia,Nottoway County,5,993,629,364
Virginia,Nottoway County,6,1136,731,405
Virginia,Nottoway County,7,1031,654,377
Virginia,Nottoway County,8,994,561,433
Virginia,Nottoway County,9,895,546,349
Virginia,Nottoway County,10,970,610,360
Virginia,Nottoway County,11,1076,598,478
Virginia,Nottoway County,12,1091,570,521
Virginia,Nottoway County,13,1031,506,525
Virginia,Nottoway County,14,914,460,454
Virginia,Nottoway County,15,730,334,396
Virginia,Nottoway County,16,574,241,333
Virginia,Nottoway County,17,374,149,225
Virginia,Nottoway County,18,367,133,234
Virginia,Orange County,0,36644,17877,18767
Virginia,Orange County,1,2041,1005,1036
Virginia,Orange County,2,2201,1087,1114
Virginia,Orange County,3,2149,1059,1090
Virginia,Orange County,4,2062,1106,956
Virginia,Orange County,5,1965,1007,958
Virginia,Orange County,6,2183,1123,1060
Virginia,Orange County,7,2139,1039,1100
Virginia,Orange County,8,2135,1104,1031
Virginia,Orange County,9,2076,1011,1065
Virginia,Orange County,10,2300,1118,1182
Virginia,Orange County,11,2589,1294,1295
Virginia,Orange County,12,2760,1356,1404
Virginia,Orange County,13,2580,1230,1350
Virginia,Orange County,14,2273,1030,1243
Virginia,Orange County,15,1953,863,1090
Virginia,Orange County,16,1489,702,787
Virginia,Orange County,17,934,422,512
Virginia,Orange County,18,815,321,494
Virginia,Page County,0,23933,11830,12103
Virginia,Page County,1,1251,631,620
Virginia,Page County,2,1221,606,615
Virginia,Page County,3,1416,706,710
Virginia,Page County,4,1295,688,607
Virginia,Page County,5,1193,602,591
Virginia,Page County,6,1429,722,707
Virginia,Page County,7,1294,649,645
Virginia,Page County,8,1350,669,681
Virginia,Page County,9,1364,685,679
Virginia,Page County,10,1565,782,783
Virginia,Page County,11,1808,924,884
Virginia,Page County,12,1915,951,964
Virginia,Page County,13,1719,831,888
Virginia,Page County,14,1574,785,789
Virginia,Page County,15,1326,639,687
Virginia,Page County,16,1010,480,530
Virginia,Page County,17,659,281,378
Virginia,Page County,18,544,199,345
Virginia,Patrick County,0,17673,8730,8943
Virginia,Patrick County,1,730,366,364
Virginia,Patrick County,2,850,420,430
Virginia,Patrick County,3,959,505,454
Virginia,Patrick County,4,859,442,417
Virginia,Patrick County,5,842,441,401
Virginia,Patrick County,6,744,394,350
Virginia,Patrick County,7,770,375,395
Virginia,Patrick County,8,799,414,385
Virginia,Patrick County,9,1007,486,521
Virginia,Patrick County,10,1228,654,574
Virginia,Patrick County,11,1282,645,637
Virginia,Patrick County,12,1513,721,792
Virginia,Patrick County,13,1423,722,701
Virginia,Patrick County,14,1367,681,686
Virginia,Patrick County,15,1228,574,654
Virginia,Patrick County,16,1001,458,543
Virginia,Patrick County,17,587,280,307
Virginia,Patrick County,18,484,152,332
Virginia,Pittsylvania County,0,60949,30048,30901
Virginia,Pittsylvania County,1,2598,1316,1282
Virginia,Pittsylvania County,2,3052,1539,1513
Virginia,Pittsylvania County,3,3594,1796,1798
Virginia,Pittsylvania County,4,3559,1852,1707
Virginia,Pittsylvania County,5,3142,1675,1467
Virginia,Pittsylvania County,6,3290,1747,1543
Virginia,Pittsylvania County,7,3017,1534,1483
Virginia,Pittsylvania County,8,3132,1587,1545
Virginia,Pittsylvania County,9,3304,1682,1622
Virginia,Pittsylvania County,10,4102,2073,2029
Virginia,Pittsylvania County,11,4471,2242,2229
Virginia,Pittsylvania County,12,5058,2437,2621
Virginia,Pittsylvania County,13,4840,2340,2500
Virginia,Pittsylvania County,14,4363,2114,2249
Virginia,Pittsylvania County,15,3659,1678,1981
Virginia,Pittsylvania County,16,2727,1257,1470
Virginia,Pittsylvania County,17,1576,692,884
Virginia,Pittsylvania County,18,1465,487,978
Virginia,Powhatan County,0,29189,15130,14059
Virginia,Powhatan County,1,1287,663,624
Virginia,Powhatan County,2,1424,752,672
Virginia,Powhatan County,3,1605,849,756
Virginia,Powhatan County,4,1591,873,718
Virginia,Powhatan County,5,1548,872,676
Virginia,Powhatan County,6,1524,868,656
Virginia,Powhatan County,7,1574,843,731
Virginia,Powhatan County,8,1790,953,837
Virginia,Powhatan County,9,1936,1035,901
Virginia,Powhatan County,10,2327,1212,1115
Virginia,Powhatan County,11,2508,1302,1206
Virginia,Powhatan County,12,2478,1221,1257
Virginia,Powhatan County,13,2273,1127,1146
Virginia,Powhatan County,14,1850,911,939
Virginia,Powhatan County,15,1558,765,793
Virginia,Powhatan County,16,972,456,516
Virginia,Powhatan County,17,505,264,241
Virginia,Powhatan County,18,439,164,275
Virginia,Prince Edward County,0,22950,11491,11459
Virginia,Prince Edward County,1,1119,611,508
Virginia,Prince Edward County,2,975,475,500
Virginia,Prince Edward County,3,985,484,501
Virginia,Prince Edward County,4,2664,1262,1402
Virginia,Prince Edward County,5,3886,2224,1662
Virginia,Prince Edward County,6,1425,773,652
Virginia,Prince Edward County,7,1097,572,525
Virginia,Prince Edward County,8,1069,577,492
Virginia,Prince Edward County,9,955,495,460
Virginia,Prince Edward County,10,1084,499,585
Virginia,Prince Edward County,11,1207,610,597
Virginia,Prince Edward County,12,1342,624,718
Virginia,Prince Edward County,13,1363,659,704
Virginia,Prince Edward County,14,1173,553,620
Virginia,Prince Edward County,15,849,385,464
Virginia,Prince Edward County,16,723,324,399
Virginia,Prince Edward County,17,446,172,274
Virginia,Prince Edward County,18,588,192,396
Virginia,Prince George County,0,38082,20584,17498
Virginia,Prince George County,1,2126,1096,1030
Virginia,Prince George County,2,2281,1188,1093
Virginia,Prince George County,3,2407,1198,1209
Virginia,Prince George County,4,2317,1224,1093
Virginia,Prince George County,5,2277,1316,961
Virginia,Prince George County,6,2870,1718,1152
Virginia,Prince George County,7,3244,1902,1342
Virginia,Prince George County,8,3225,1969,1256
Virginia,Prince George County,9,2513,1495,1018
Virginia,Prince George County,10,2338,1312,1026
Virginia,Prince George County,11,2478,1318,1160
Virginia,Prince George County,12,2459,1251,1208
Virginia,Prince George County,13,2200,1111,1089
Virginia,Prince George County,14,1772,837,935
Virginia,Prince George County,15,1470,706,764
Virginia,Prince George County,16,997,493,504
Virginia,Prince George County,17,546,243,303
Virginia,Prince George County,18,562,207,355
Virginia,Prince William County,0,468011,233996,234015
Virginia,Prince William County,1,35026,18313,16713
Virginia,Prince William County,2,35107,18177,16930
Virginia,Prince William County,3,36131,18533,17598
Virginia,Prince William County,4,32331,16451,15880
Virginia,Prince William County,5,29229,15245,13984
Virginia,Prince William County,6,30298,15297,15001
Virginia,Prince William County,7,32631,16346,16285
Virginia,Prince William County,8,36983,18358,18625
Virginia,Prince William County,9,34284,17021,17263
Virginia,Prince William County,10,34325,17142,17183
Virginia,Prince William County,11,32639,16330,16309
Virginia,Prince William County,12,29833,14818,15015
Virginia,Prince William County,13,22875,11208,11667
Virginia,Prince William County,14,16677,7850,8827
Virginia,Prince William County,15,13032,6017,7015
Virginia,Prince William County,16,8063,3578,4485
Virginia,Prince William County,17,4512,1926,2586
Virginia,Prince William County,18,4035,1386,2649
Virginia,Pulaski County,0,34066,17016,17050
Virginia,Pulaski County,1,1619,814,805
Virginia,Pulaski County,2,1568,790,778
Virginia,Pulaski County,3,1762,893,869
Virginia,Pulaski County,4,1702,882,820
Virginia,Pulaski County,5,1757,978,779
Virginia,Pulaski County,6,2158,1163,995
Virginia,Pulaski County,7,1818,963,855
Virginia,Pulaski County,8,1754,943,811
Virginia,Pulaski County,9,1909,985,924
Virginia,Pulaski County,10,2513,1283,1230
Virginia,Pulaski County,11,2499,1308,1191
Virginia,Pulaski County,12,2585,1289,1296
Virginia,Pulaski County,13,2608,1235,1373
Virginia,Pulaski County,14,2438,1123,1315
Virginia,Pulaski County,15,2181,1033,1148
Virginia,Pulaski County,16,1473,670,803
Virginia,Pulaski County,17,905,390,515
Virginia,Pulaski County,18,817,274,543
Virginia,Rappahannock County,0,7252,3559,3693
Virginia,Rappahannock County,1,246,120,126
Virginia,Rappahannock County,2,341,180,161
Virginia,Rappahannock County,3,361,186,175
Virginia,Rappahannock County,4,386,189,197
Virginia,Rappahannock County,5,338,179,159
Virginia,Rappahannock County,6,361,175,186
Virginia,Rappahannock County,7,335,156,179
Virginia,Rappahannock County,8,309,149,160
Virginia,Rappahannock County,9,360,181,179
Virginia,Rappahannock County,10,424,223,201
Virginia,Rappahannock County,11,530,245,285
Virginia,Rappahannock County,12,620,297,323
Virginia,Rappahannock County,13,660,321,339
Virginia,Rappahannock County,14,597,298,299
Virginia,Rappahannock County,15,577,276,301
Virginia,Rappahannock County,16,378,191,187
Virginia,Rappahannock County,17,229,107,122
Virginia,Rappahannock County,18,200,86,114
Virginia,Richmond County,0,9038,5084,3954
Virginia,Richmond County,1,404,211,193
Virginia,Richmond County,2,408,206,202
Virginia,Richmond County,3,469,234,235
Virginia,Richmond County,4,434,216,218
Virginia,Richmond County,5,472,313,159
Virginia,Richmond County,6,635,436,199
Virginia,Richmond County,7,630,442,188
Virginia,Richmond County,8,621,420,201
Virginia,Richmond County,9,596,403,193
Virginia,Richmond County,10,617,412,205
Virginia,Richmond County,11,602,355,247
Virginia,Richmond County,12,664,370,294
Virginia,Richmond County,13,585,289,296
Virginia,Richmond County,14,529,251,278
Virginia,Richmond County,15,416,181,235
Virginia,Richmond County,16,379,154,225
Virginia,Richmond County,17,284,117,167
Virginia,Richmond County,18,293,74,219
Virginia,Roanoke County,0,94073,45334,48739
Virginia,Roanoke County,1,4184,2192,1992
Virginia,Roanoke County,2,5099,2652,2447
Virginia,Roanoke County,3,5773,2965,2808
Virginia,Roanoke County,4,5691,2904,2787
Virginia,Roanoke County,5,5277,2601,2676
Virginia,Roanoke County,6,5369,2722,2647
Virginia,Roanoke County,7,5372,2631,2741
Virginia,Roanoke County,8,5329,2636,2693
Virginia,Roanoke County,9,5633,2758,2875
Virginia,Roanoke County,10,6492,3169,3323
Virginia,Roanoke County,11,6382,3142,3240
Virginia,Roanoke County,12,6709,3248,3461
Virginia,Roanoke County,13,6612,3090,3522
Virginia,Roanoke County,14,6082,2824,3258
Virginia,Roanoke County,15,5219,2360,2859
Virginia,Roanoke County,16,3652,1601,2051
Virginia,Roanoke County,17,2521,977,1544
Virginia,Roanoke County,18,2677,862,1815
Virginia,Rockbridge County,0,22752,11270,11482
Virginia,Rockbridge County,1,955,512,443
Virginia,Rockbridge County,2,1073,517,556
Virginia,Rockbridge County,3,1241,661,580
Virginia,Rockbridge County,4,1281,617,664
Virginia,Rockbridge County,5,1155,601,554
Virginia,Rockbridge County,6,1190,591,599
Virginia,Rockbridge County,7,1129,576,553
Virginia,Rockbridge County,8,1126,574,552
Virginia,Rockbridge County,9,1121,563,558
Virginia,Rockbridge County,10,1354,650,704
Virginia,Rockbridge County,11,1551,778,773
Virginia,Rockbridge County,12,1823,874,949
Virginia,Rockbridge County,13,1844,909,935
Virginia,Rockbridge County,14,1800,908,892
Virginia,Rockbridge County,15,1467,731,736
Virginia,Rockbridge County,16,1109,514,595
Virginia,Rockbridge County,17,798,374,424
Virginia,Rockbridge County,18,735,320,415
Virginia,Rockingham County,0,81244,39975,41269
Virginia,Rockingham County,1,4517,2306,2211
Virginia,Rockingham County,2,4924,2554,2370
Virginia,Rockingham County,3,5101,2611,2490
Virginia,Rockingham County,4,5520,2740,2780
Virginia,Rockingham County,5,4994,2432,2562
Virginia,Rockingham County,6,5015,2544,2471
Virginia,Rockingham County,7,4610,2301,2309
Virginia,Rockingham County,8,4864,2468,2396
Virginia,Rockingham County,9,4526,2283,2243
Virginia,Rockingham County,10,5029,2458,2571
Virginia,Rockingham County,11,5352,2682,2670
Virginia,Rockingham County,12,5739,2850,2889
Virginia,Rockingham County,13,5581,2662,2919
Virginia,Rockingham County,14,4735,2350,2385
Virginia,Rockingham County,15,3776,1786,1990
Virginia,Rockingham County,16,2864,1318,1546
Virginia,Rockingham County,17,2021,870,1151
Virginia,Rockingham County,18,2076,760,1316
Virginia,Russell County,0,26748,13083,13665
Virginia,Russell County,1,1273,652,621
Virginia,Russell County,2,1394,698,696
Virginia,Russell County,3,1468,719,749
Virginia,Russell County,4,1427,717,710
Virginia,Russell County,5,1311,704,607
Virginia,Russell County,6,1542,788,754
Virginia,Russell County,7,1352,682,670
Virginia,Russell County,8,1559,800,759
Virginia,Russell County,9,1602,807,795
Virginia,Russell County,10,1797,883,914
Virginia,Russell County,11,1866,897,969
Virginia,Russell County,12,2196,1066,1130
Virginia,Russell County,13,2188,1065,1123
Virginia,Russell County,14,1886,933,953
Virginia,Russell County,15,1500,718,782
Virginia,Russell County,16,1077,452,625
Virginia,Russell County,17,748,293,455
Virginia,Russell County,18,562,209,353
Virginia,Scott County,0,21534,10829,10705
Virginia,Scott County,1,871,462,409
Virginia,Scott County,2,1094,551,543
Virginia,Scott County,3,1149,573,576
Virginia,Scott County,4,1113,560,553
Virginia,Scott County,5,1044,567,477
Virginia,Scott County,6,1152,629,523
Virginia,Scott County,7,1150,604,546
Virginia,Scott County,8,1205,616,589
Virginia,Scott County,9,1251,671,580
Virginia,Scott County,10,1427,715,712
Virginia,Scott County,11,1547,780,767
Virginia,Scott County,12,1686,859,827
Virginia,Scott County,13,1634,814,820
Virginia,Scott County,14,1558,754,804
Virginia,Scott County,15,1345,616,729
Virginia,Scott County,16,1014,495,519
Virginia,Scott County,17,697,322,375
Virginia,Scott County,18,597,241,356
Virginia,Shenandoah County,0,43497,21277,22220
Virginia,Shenandoah County,1,2493,1261,1232
Virginia,Shenandoah County,2,2492,1264,1228
Virginia,Shenandoah County,3,2603,1314,1289
Virginia,Shenandoah County,4,2492,1279,1213
Virginia,Shenandoah County,5,2205,1082,1123
Virginia,Shenandoah County,6,2544,1252,1292
Virginia,Shenandoah County,7,2434,1210,1224
Virginia,Shenandoah County,8,2494,1267,1227
Virginia,Shenandoah County,9,2250,1121,1129
Virginia,Shenandoah County,10,2766,1397,1369
Virginia,Shenandoah County,11,2994,1489,1505
Virginia,Shenandoah County,12,3181,1554,1627
Virginia,Shenandoah County,13,3106,1488,1618
Virginia,Shenandoah County,14,2795,1365,1430
Virginia,Shenandoah County,15,2525,1173,1352
Virginia,Shenandoah County,16,1844,861,983
Virginia,Shenandoah County,17,1169,518,651
Virginia,Shenandoah County,18,1110,382,728
Virginia,Smyth County,0,30472,14944,15528
Virginia,Smyth County,1,1390,695,695
Virginia,Smyth County,2,1550,768,782
Virginia,Smyth County,3,1802,967,835
Virginia,Smyth County,4,1725,858,867
Virginia,Smyth County,5,1584,812,772
Virginia,Smyth County,6,1885,980,905
Virginia,Smyth County,7,1561,838,723
Virginia,Smyth County,8,1685,822,863
Virginia,Smyth County,9,1798,918,880
Virginia,Smyth County,10,2150,1038,1112
Virginia,Smyth County,11,2151,1090,1061
Virginia,Smyth County,12,2240,1127,1113
Virginia,Smyth County,13,2245,1092,1153
Virginia,Smyth County,14,1992,928,1064
Virginia,Smyth County,15,1719,788,931
Virginia,Smyth County,16,1244,553,691
Virginia,Smyth County,17,915,381,534
Virginia,Smyth County,18,836,289,547
Virginia,Southampton County,0,17586,9142,8444
Virginia,Southampton County,1,671,347,324
Virginia,Southampton County,2,895,464,431
Virginia,Southampton County,3,1008,524,484
Virginia,Southampton County,4,966,471,495
Virginia,Southampton County,5,855,453,402
Virginia,Southampton County,6,993,524,469
Virginia,Southampton County,7,922,484,438
Virginia,Southampton County,8,931,461,470
Virginia,Southampton County,9,960,501,459
Virginia,Southampton County,10,1314,760,554
Virginia,Southampton County,11,1480,821,659
Virginia,Southampton County,12,1609,907,702
Virginia,Southampton County,13,1426,760,666
Virginia,Southampton County,14,1140,577,563
Virginia,Southampton County,15,913,466,447
Virginia,Southampton County,16,674,296,378
Virginia,Southampton County,17,439,190,249
Virginia,Southampton County,18,390,136,254
Virginia,Spotsylvania County,0,134238,65903,68335
Virginia,Spotsylvania County,1,8217,4183,4034
Virginia,Spotsylvania County,2,8901,4617,4284
Virginia,Spotsylvania County,3,9890,4970,4920
Virginia,Spotsylvania County,4,9340,4856,4484
Virginia,Spotsylvania County,5,7985,4056,3929
Virginia,Spotsylvania County,6,8453,4281,4172
Virginia,Spotsylvania County,7,8392,4059,4333
Virginia,Spotsylvania County,8,8728,4349,4379
Virginia,Spotsylvania County,9,8370,4083,4287
Virginia,Spotsylvania County,10,9286,4519,4767
Virginia,Spotsylvania County,11,9859,4764,5095
Virginia,Spotsylvania County,12,9597,4701,4896
Virginia,Spotsylvania County,13,8091,3907,4184
Virginia,Spotsylvania County,14,6445,2997,3448
Virginia,Spotsylvania County,15,5318,2409,2909
Virginia,Spotsylvania County,16,3301,1502,1799
Virginia,Spotsylvania County,17,2003,903,1100
Virginia,Spotsylvania County,18,2062,747,1315
Virginia,Stafford County,0,149960,75624,74336
Virginia,Stafford County,1,9559,4998,4561
Virginia,Stafford County,2,10761,5501,5260
Virginia,Stafford County,3,11530,5895,5635
Virginia,Stafford County,4,11080,5610,5470
Virginia,Stafford County,5,10600,5792,4808
Virginia,Stafford County,6,9784,5217,4567
Virginia,Stafford County,7,10296,5255,5041
Virginia,Stafford County,8,10614,5201,5413
Virginia,Stafford County,9,10224,5182,5042
Virginia,Stafford County,10,10882,5401,5481
Virginia,Stafford County,11,11237,5560,5677
Virginia,Stafford County,12,10166,5031,5135
Virginia,Stafford County,13,7553,3810,3743
Virginia,Stafford County,14,5511,2639,2872
Virginia,Stafford County,15,4376,2071,2305
Virginia,Stafford County,16,2772,1216,1556
Virginia,Stafford County,17,1622,687,935
Virginia,Stafford County,18,1393,558,835
Virginia,Surry County,0,6474,3198,3276
Virginia,Surry County,1,265,137,128
Virginia,Surry County,2,280,141,139
Virginia,Surry County,3,322,184,138
Virginia,Surry County,4,335,162,173
Virginia,Surry County,5,321,155,166
Virginia,Surry County,6,351,196,155
Virginia,Surry County,7,362,188,174
Virginia,Surry County,8,289,141,148
Virginia,Surry County,9,286,137,149
Virginia,Surry County,10,386,186,200
Virginia,Surry County,11,532,256,276
Virginia,Surry County,12,668,334,334
Virginia,Surry County,13,609,292,317
Virginia,Surry County,14,476,231,245
Virginia,Surry County,15,407,211,196
Virginia,Surry County,16,270,128,142
Virginia,Surry County,17,165,67,98
Virginia,Surry County,18,150,52,98
Virginia,Sussex County,0,11237,6658,4579
Virginia,Sussex County,1,477,228,249
Virginia,Sussex County,2,479,239,240
Virginia,Sussex County,3,485,233,252
Virginia,Sussex County,4,489,267,222
Virginia,Sussex County,5,828,610,218
Virginia,Sussex County,6,1133,864,269
Virginia,Sussex County,7,916,672,244
Virginia,Sussex County,8,746,530,216
Virginia,Sussex County,9,621,427,194
Virginia,Sussex County,10,746,461,285
Virginia,Sussex County,11,793,437,356
Virginia,Sussex County,12,789,429,360
Virginia,Sussex County,13,739,362,377
Virginia,Sussex County,14,661,345,316
Virginia,Sussex County,15,491,228,263
Virginia,Sussex County,16,379,147,232
Virginia,Sussex County,17,229,81,148
Virginia,Sussex County,18,236,98,138
Virginia,Tazewell County,0,40855,20225,20630
Virginia,Tazewell County,1,2052,960,1092
Virginia,Tazewell County,2,2061,1062,999
Virginia,Tazewell County,3,2338,1164,1174
Virginia,Tazewell County,4,2270,1145,1125
Virginia,Tazewell County,5,2169,1154,1015
Virginia,Tazewell County,6,2344,1312,1032
Virginia,Tazewell County,7,2197,1204,993
Virginia,Tazewell County,8,2362,1284,1078
Virginia,Tazewell County,9,2527,1339,1188
Virginia,Tazewell County,10,2623,1329,1294
Virginia,Tazewell County,11,2660,1297,1363
Virginia,Tazewell County,12,2920,1401,1519
Virginia,Tazewell County,13,3242,1526,1716
Virginia,Tazewell County,14,3033,1469,1564
Virginia,Tazewell County,15,2355,1117,1238
Virginia,Tazewell County,16,1569,688,881
Virginia,Tazewell County,17,1047,425,622
Virginia,Tazewell County,18,1086,349,737
Virginia,Warren County,0,40003,19939,20064
Virginia,Warren County,1,2416,1244,1172
Virginia,Warren County,2,2295,1183,1112
Virginia,Warren County,3,2571,1316,1255
Virginia,Warren County,4,2460,1230,1230
Virginia,Warren County,5,2343,1187,1156
Virginia,Warren County,6,2635,1325,1310
Virginia,Warren County,7,2519,1303,1216
Virginia,Warren County,8,2403,1217,1186
Virginia,Warren County,9,2208,1104,1104
Virginia,Warren County,10,2582,1262,1320
Virginia,Warren County,11,3070,1533,1537
Virginia,Warren County,12,3271,1655,1616
Virginia,Warren County,13,2810,1419,1391
Virginia,Warren County,14,2198,1097,1101
Virginia,Warren County,15,1722,773,949
Virginia,Warren County,16,1178,576,602
Virginia,Warren County,17,698,304,394
Virginia,Warren County,18,624,211,413
Virginia,Washington County,0,54402,26798,27604
Virginia,Washington County,1,2537,1332,1205
Virginia,Washington County,2,2707,1413,1294
Virginia,Washington County,3,2939,1489,1450
Virginia,Washington County,4,3243,1627,1616
Virginia,Washington County,5,2978,1562,1416
Virginia,Washington County,6,2916,1524,1392
Virginia,Washington County,7,2732,1419,1313
Virginia,Washington County,8,3105,1541,1564
Virginia,Washington County,9,3075,1550,1525
Virginia,Washington County,10,3604,1775,1829
Virginia,Washington County,11,3797,1896,1901
Virginia,Washington County,12,4220,2001,2219
Virginia,Washington County,13,4175,2010,2165
Virginia,Washington County,14,3867,1881,1986
Virginia,Washington County,15,3266,1555,1711
Virginia,Washington County,16,2415,1077,1338
Virginia,Washington County,17,1581,719,862
Virginia,Washington County,18,1245,427,818
Virginia,Westmoreland County,0,17830,8700,9130
Virginia,Westmoreland County,1,971,501,470
Virginia,Westmoreland County,2,885,467,418
Virginia,Westmoreland County,3,969,511,458
Virginia,Westmoreland County,4,847,423,424
Virginia,Westmoreland County,5,845,404,441
Virginia,Westmoreland County,6,1069,585,484
Virginia,Westmoreland County,7,955,485,470
Virginia,Westmoreland County,8,906,481,425
Virginia,Westmoreland County,9,815,374,441
Virginia,Westmoreland County,10,921,437,484
Virginia,Westmoreland County,11,1182,561,621
Virginia,Westmoreland County,12,1437,680,757
Virginia,Westmoreland County,13,1508,731,777
Virginia,Westmoreland County,14,1414,658,756
Virginia,Westmoreland County,15,1221,562,659
Virginia,Westmoreland County,16,867,410,457
Virginia,Westmoreland County,17,574,253,321
Virginia,Westmoreland County,18,444,177,267
Virginia,Wise County,0,38012,19779,18233
Virginia,Wise County,1,1980,962,1018
Virginia,Wise County,2,2058,1058,1000
Virginia,Wise County,3,2124,1098,1026
Virginia,Wise County,4,2310,1217,1093
Virginia,Wise County,5,2489,1468,1021
Virginia,Wise County,6,2758,1641,1117
Virginia,Wise County,7,2377,1382,995
Virginia,Wise County,8,2320,1290,1030
Virginia,Wise County,9,2352,1247,1105
Virginia,Wise County,10,2592,1392,1200
Virginia,Wise County,11,2436,1259,1177
Virginia,Wise County,12,2591,1272,1319
Virginia,Wise County,13,2694,1321,1373
Virginia,Wise County,14,2454,1154,1300
Virginia,Wise County,15,1768,843,925
Virginia,Wise County,16,1239,586,653
Virginia,Wise County,17,798,345,453
Virginia,Wise County,18,672,244,428
Virginia,Wythe County,0,28754,14037,14717
Virginia,Wythe County,1,1407,723,684
Virginia,Wythe County,2,1525,790,735
Virginia,Wythe County,3,1674,851,823
Virginia,Wythe County,4,1628,837,791
Virginia,Wythe County,5,1338,708,630
Virginia,Wythe County,6,1624,797,827
Virginia,Wythe County,7,1565,800,765
Virginia,Wythe County,8,1605,762,843
Virginia,Wythe County,9,1708,840,868
Virginia,Wythe County,10,2063,1045,1018
Virginia,Wythe County,11,2152,1072,1080
Virginia,Wythe County,12,2105,994,1111
Virginia,Wythe County,13,2147,1024,1123
Virginia,Wythe County,14,1984,966,1018
Virginia,Wythe County,15,1569,738,831
Virginia,Wythe County,16,1200,533,667
Virginia,Wythe County,17,777,339,438
Virginia,Wythe County,18,683,218,465
Virginia,York County,0,67846,33273,34573
Virginia,York County,1,3791,1915,1876
Virginia,York County,2,4480,2267,2213
Virginia,York County,3,4823,2392,2431
Virginia,York County,4,4721,2418,2303
Virginia,York County,5,4240,2298,1942
Virginia,York County,6,3872,2042,1830
Virginia,York County,7,4004,1962,2042
Virginia,York County,8,4716,2260,2456
Virginia,York County,9,4153,2057,2096
Virginia,York County,10,4214,2019,2195
Virginia,York County,11,4591,2171,2420
Virginia,York County,12,5078,2463,2615
Virginia,York County,13,4206,2048,2158
Virginia,York County,14,3330,1559,1771
Virginia,York County,15,2981,1416,1565
Virginia,York County,16,2118,979,1139
Virginia,York County,17,1310,577,733
Virginia,York County,18,1218,430,788
Virginia,Alexandria city,0,160530,77269,83261
Virginia,Alexandria city,1,11469,5956,5513
Virginia,Alexandria city,2,7870,4029,3841
Virginia,Alexandria city,3,6362,3252,3110
Virginia,Alexandria city,4,5728,2878,2850
Virginia,Alexandria city,5,7604,3387,4217
Virginia,Alexandria city,6,15668,7173,8495
Virginia,Alexandria city,7,18889,9153,9736
Virginia,Alexandria city,8,16789,8272,8517
Virginia,Alexandria city,9,12689,6399,6290
Virginia,Alexandria city,10,11299,5590,5709
Virginia,Alexandria city,11,10088,4893,5195
Virginia,Alexandria city,12,9491,4651,4840
Virginia,Alexandria city,13,8119,3718,4401
Virginia,Alexandria city,14,6484,2924,3560
Virginia,Alexandria city,15,4973,2192,2781
Virginia,Alexandria city,16,2907,1327,1580
Virginia,Alexandria city,17,1819,735,1084
Virginia,Alexandria city,18,2282,740,1542
Virginia,Bristol city,0,16482,7811,8671
Virginia,Bristol city,1,851,422,429
Virginia,Bristol city,2,886,421,465
Virginia,Bristol city,3,991,516,475
Virginia,Bristol city,4,887,473,414
Virginia,Bristol city,5,809,418,391
Virginia,Bristol city,6,1175,598,577
Virginia,Bristol city,7,964,479,485
Virginia,Bristol city,8,1072,520,552
Virginia,Bristol city,9,972,483,489
Virginia,Bristol city,10,1074,541,533
Virginia,Bristol city,11,1093,541,552
Virginia,Bristol city,12,1102,535,567
Virginia,Bristol city,13,1130,527,603
Virginia,Bristol city,14,1036,455,581
Virginia,Bristol city,15,871,341,530
Virginia,Bristol city,16,684,248,436
Virginia,Bristol city,17,466,187,279
Virginia,Bristol city,18,419,106,313
Virginia,Buena Vista city,0,6237,2928,3309
Virginia,Buena Vista city,1,165,69,96
Virginia,Buena Vista city,2,346,173,173
Virginia,Buena Vista city,3,358,189,169
Virginia,Buena Vista city,4,552,255,297
Virginia,Buena Vista city,5,611,298,313
Virginia,Buena Vista city,6,467,235,232
Virginia,Buena Vista city,7,330,169,161
Virginia,Buena Vista city,8,327,155,172
Virginia,Buena Vista city,9,330,167,163
Virginia,Buena Vista city,10,331,149,182
Virginia,Buena Vista city,11,410,213,197
Virginia,Buena Vista city,12,385,181,204
Virginia,Buena Vista city,13,406,175,231
Virginia,Buena Vista city,14,354,146,208
Virginia,Buena Vista city,15,327,148,179
Virginia,Buena Vista city,16,238,97,141
Virginia,Buena Vista city,17,158,66,92
Virginia,Buena Vista city,18,142,43,99
Virginia,Charlottesville city,0,48117,23316,24801
Virginia,Charlottesville city,1,2764,1397,1367
Virginia,Charlottesville city,2,2146,1076,1070
Virginia,Charlottesville city,3,1733,937,796
Virginia,Charlottesville city,4,2486,1203,1283
Virginia,Charlottesville city,5,7868,3862,4006
Virginia,Charlottesville city,6,5362,2709,2653
Virginia,Charlottesville city,7,4430,2210,2220
Virginia,Charlottesville city,8,3416,1593,1823
Virginia,Charlottesville city,9,2586,1305,1281
Virginia,Charlottesville city,10,2454,1192,1262
Virginia,Charlottesville city,11,2455,1161,1294
Virginia,Charlottesville city,12,2393,1110,1283
Virginia,Charlottesville city,13,2444,1184,1260
Virginia,Charlottesville city,14,2144,955,1189
Virginia,Charlottesville city,15,1377,598,779
Virginia,Charlottesville city,16,872,374,498
Virginia,Charlottesville city,17,602,244,358
Virginia,Charlottesville city,18,585,206,379
Virginia,Chesapeake city,0,242634,118401,124233
Virginia,Chesapeake city,1,15329,7839,7490
Virginia,Chesapeake city,2,15997,8126,7871
Virginia,Chesapeake city,3,16830,8534,8296
Virginia,Chesapeake city,4,15984,8303,7681
Virginia,Chesapeake city,5,14770,7608,7162
Virginia,Chesapeake city,6,17039,8637,8402
Virginia,Chesapeake city,7,17728,8795,8933
Virginia,Chesapeake city,8,17685,8710,8975
Virginia,Chesapeake city,9,15583,7537,8046
Virginia,Chesapeake city,10,15667,7679,7988
Virginia,Chesapeake city,11,15787,7495,8292
Virginia,Chesapeake city,12,17319,8283,9036
Virginia,Chesapeake city,13,14681,6868,7813
Virginia,Chesapeake city,14,11187,5150,6037
Virginia,Chesapeake city,15,8520,3828,4692
Virginia,Chesapeake city,16,5564,2423,3141
Virginia,Chesapeake city,17,3560,1424,2136
Virginia,Chesapeake city,18,3404,1162,2242
Virginia,Colonial Heights city,0,17833,8165,9668
Virginia,Colonial Heights city,1,1251,573,678
Virginia,Colonial Heights city,2,1176,595,581
Virginia,Colonial Heights city,3,1142,560,582
Virginia,Colonial Heights city,4,1087,549,538
Virginia,Colonial Heights city,5,1029,515,514
Virginia,Colonial Heights city,6,1264,623,641
Virginia,Colonial Heights city,7,1015,427,588
Virginia,Colonial Heights city,8,1065,496,569
Virginia,Colonial Heights city,9,919,437,482
Virginia,Colonial Heights city,10,1030,483,547
Virginia,Colonial Heights city,11,1100,492,608
Virginia,Colonial Heights city,12,1211,572,639
Virginia,Colonial Heights city,13,1049,481,568
Virginia,Colonial Heights city,14,866,340,526
Virginia,Colonial Heights city,15,913,393,520
Virginia,Colonial Heights city,16,654,275,379
Virginia,Colonial Heights city,17,507,187,320
Virginia,Colonial Heights city,18,555,167,388
Virginia,Covington city,0,5460,2637,2823
Virginia,Covington city,1,130,62,68
Virginia,Covington city,2,325,173,152
Virginia,Covington city,3,323,163,160
Virginia,Covington city,4,323,155,168
Virginia,Covington city,5,333,176,157
Virginia,Covington city,6,351,187,164
Virginia,Covington city,7,349,183,166
Virginia,Covington city,8,302,133,169
Virginia,Covington city,9,299,152,147
Virginia,Covington city,10,341,178,163
Virginia,Covington city,11,395,187,208
Virginia,Covington city,12,436,216,220
Virginia,Covington city,13,393,192,201
Virginia,Covington city,14,315,153,162
Virginia,Covington city,15,346,151,195
Virginia,Covington city,16,231,93,138
Virginia,Covington city,17,134,45,89
Virginia,Covington city,18,134,38,96
Virginia,Danville city,0,40693,18720,21973
Virginia,Danville city,1,2344,1186,1158
Virginia,Danville city,2,2543,1297,1246
Virginia,Danville city,3,2472,1215,1257
Virginia,Danville city,4,2513,1364,1149
Virginia,Danville city,5,2478,1202,1276
Virginia,Danville city,6,2745,1303,1442
Virginia,Danville city,7,2439,1205,1234
Virginia,Danville city,8,2145,1010,1135
Virginia,Danville city,9,1898,830,1068
Virginia,Danville city,10,2243,1076,1167
Virginia,Danville city,11,2522,1094,1428
Virginia,Danville city,12,2798,1281,1517
Virginia,Danville city,13,3035,1336,1699
Virginia,Danville city,14,2584,1153,1431
Virginia,Danville city,15,2074,856,1218
Virginia,Danville city,16,1402,580,822
Virginia,Danville city,17,1122,377,745
Virginia,Danville city,18,1336,355,981
Virginia,Emporia city,0,5121,2370,2751
Virginia,Emporia city,1,152,74,78
Virginia,Emporia city,2,334,161,173
Virginia,Emporia city,3,367,210,157
Virginia,Emporia city,4,349,172,177
Virginia,Emporia city,5,276,134,142
Virginia,Emporia city,6,375,173,202
Virginia,Emporia city,7,301,140,161
Virginia,Emporia city,8,294,122,172
Virginia,Emporia city,9,276,130,146
Virginia,Emporia city,10,311,145,166
Virginia,Emporia city,11,337,157,180
Virginia,Emporia city,12,352,150,202
Virginia,Emporia city,13,361,178,183
Virginia,Emporia city,14,246,117,129
Virginia,Emporia city,15,246,100,146
Virginia,Emporia city,16,193,90,103
Virginia,Emporia city,17,144,57,87
Virginia,Emporia city,18,207,60,147
Virginia,Fairfax city,0,24574,12216,12358
Virginia,Fairfax city,1,2634,1414,1220
Virginia,Fairfax city,2,1386,744,642
Virginia,Fairfax city,3,1319,664,655
Virginia,Fairfax city,4,1265,629,636
Virginia,Fairfax city,5,1632,820,812
Virginia,Fairfax city,6,1738,991,747
Virginia,Fairfax city,7,1633,842,791
Virginia,Fairfax city,8,1699,839,860
Virginia,Fairfax city,9,1444,690,754
Virginia,Fairfax city,10,1579,802,777
Virginia,Fairfax city,11,1636,797,839
Virginia,Fairfax city,12,1651,802,849
Virginia,Fairfax city,13,1444,710,734
Virginia,Fairfax city,14,1129,518,611
Virginia,Fairfax city,15,883,379,504
Virginia,Fairfax city,16,593,278,315
Virginia,Fairfax city,17,416,154,262
Virginia,Fairfax city,18,493,143,350
Virginia,Falls Church city,0,14772,7251,7521
Virginia,Falls Church city,1,1099,561,538
Virginia,Falls Church city,2,1028,523,505
Virginia,Falls Church city,3,1142,621,521
Virginia,Falls Church city,4,935,493,442
Virginia,Falls Church city,5,753,371,382
Virginia,Falls Church city,6,957,491,466
Virginia,Falls Church city,7,816,404,412
Virginia,Falls Church city,8,968,444,524
Virginia,Falls Church city,9,1077,522,555
Virginia,Falls Church city,10,1168,584,584
Virginia,Falls Church city,11,1045,496,549
Virginia,Falls Church city,12,982,506,476
Virginia,Falls Church city,13,848,407,441
Virginia,Falls Church city,14,726,332,394
Virginia,Falls Church city,15,521,222,299
Virginia,Falls Church city,16,283,115,168
Virginia,Falls Church city,17,216,92,124
Virginia,Falls Church city,18,208,67,141
Virginia,Franklin city,0,8013,3616,4397
Virginia,Franklin city,1,450,221,229
Virginia,Franklin city,2,560,265,295
Virginia,Franklin city,3,570,321,249
Virginia,Franklin city,4,477,251,226
Virginia,Franklin city,5,416,192,224
Virginia,Franklin city,6,533,257,276
Virginia,Franklin city,7,488,202,286
Virginia,Franklin city,8,435,202,233
Virginia,Franklin city,9,367,166,201
Virginia,Franklin city,10,445,198,247
Virginia,Franklin city,11,501,206,295
Virginia,Franklin city,12,587,243,344
Virginia,Franklin city,13,605,245,360
Virginia,Franklin city,14,467,215,252
Virginia,Franklin city,15,430,197,233
Virginia,Franklin city,16,268,111,157
Virginia,Franklin city,17,193,63,130
Virginia,Franklin city,18,221,61,160
Virginia,Fredericksburg city,0,29144,13450,15694
Virginia,Fredericksburg city,1,2004,1031,973
Virginia,Fredericksburg city,2,1747,911,836
Virginia,Fredericksburg city,3,1505,742,763
Virginia,Fredericksburg city,4,2605,1076,1529
Virginia,Fredericksburg city,5,3973,1565,2408
Virginia,Fredericksburg city,6,2634,1283,1351
Virginia,Fredericksburg city,7,1982,974,1008
Virginia,Fredericksburg city,8,1837,941,896
Virginia,Fredericksburg city,9,1552,738,814
Virginia,Fredericksburg city,10,1520,732,788
Virginia,Fredericksburg city,11,1608,749,859
Virginia,Fredericksburg city,12,1545,704,841
Virginia,Fredericksburg city,13,1382,664,718
Virginia,Fredericksburg city,14,1087,479,608
Virginia,Fredericksburg city,15,844,375,469
Virginia,Fredericksburg city,16,537,218,319
Virginia,Fredericksburg city,17,396,151,245
Virginia,Fredericksburg city,18,386,117,269
Virginia,Galax city,0,6423,2979,3444
Virginia,Galax city,1,310,150,160
Virginia,Galax city,2,448,225,223
Virginia,Galax city,3,406,210,196
Virginia,Galax city,4,388,189,199
Virginia,Galax city,5,390,203,187
Virginia,Galax city,6,410,182,228
Virginia,Galax city,7,367,180,187
Virginia,Galax city,8,306,146,160
Virginia,Galax city,9,359,179,180
Virginia,Galax city,10,439,215,224
Virginia,Galax city,11,452,210,242
Virginia,Galax city,12,377,177,200
Virginia,Galax city,13,477,228,249
Virginia,Galax city,14,353,155,198
Virginia,Galax city,15,299,113,186
Virginia,Galax city,16,218,88,130
Virginia,Galax city,17,163,58,105
Virginia,Galax city,18,261,71,190
Virginia,Hampton city,0,134313,64558,69755
Virginia,Hampton city,1,7993,4105,3888
Virginia,Hampton city,2,7696,3944,3752
Virginia,Hampton city,3,7811,3984,3827
Virginia,Hampton city,4,8857,4423,4434
Virginia,Hampton city,5,11654,6257,5397
Virginia,Hampton city,6,11379,5866,5513
Virginia,Hampton city,7,9621,4697,4924
Virginia,Hampton city,8,8428,4009,4419
Virginia,Hampton city,9,6735,3127,3608
Virginia,Hampton city,10,7010,3192,3818
Virginia,Hampton city,11,8007,3638,4369
Virginia,Hampton city,12,9566,4524,5042
Virginia,Hampton city,13,8811,4108,4703
Virginia,Hampton city,14,6801,3028,3773
Virginia,Hampton city,15,5360,2323,3037
Virginia,Hampton city,16,3702,1572,2130
Virginia,Hampton city,17,2506,969,1537
Virginia,Hampton city,18,2376,792,1584
Virginia,Harrisonburg city,0,54033,25987,28046
Virginia,Harrisonburg city,1,3067,1549,1518
Virginia,Harrisonburg city,2,2425,1242,1183
Virginia,Harrisonburg city,3,2373,1196,1177
Virginia,Harrisonburg city,4,7543,3043,4500
Virginia,Harrisonburg city,5,11013,5231,5782
Virginia,Harrisonburg city,6,4155,2122,2033
Virginia,Harrisonburg city,7,3553,1838,1715
Virginia,Harrisonburg city,8,3197,1629,1568
Virginia,Harrisonburg city,9,2700,1444,1256
Virginia,Harrisonburg city,10,2433,1275,1158
Virginia,Harrisonburg city,11,2264,1151,1113
Virginia,Harrisonburg city,12,2200,1069,1131
Virginia,Harrisonburg city,13,2026,1007,1019
Virginia,Harrisonburg city,14,1687,803,884
Virginia,Harrisonburg city,15,1120,510,610
Virginia,Harrisonburg city,16,852,369,483
Virginia,Harrisonburg city,17,604,245,359
Virginia,Harrisonburg city,18,821,264,557
Virginia,Hopewell city,0,22596,10536,12060
Virginia,Hopewell city,1,1730,871,859
Virginia,Hopewell city,2,1619,831,788
Virginia,Hopewell city,3,1643,837,806
Virginia,Hopewell city,4,1331,686,645
Virginia,Hopewell city,5,1351,643,708
Virginia,Hopewell city,6,1756,873,883
Virginia,Hopewell city,7,1528,699,829
Virginia,Hopewell city,8,1393,651,742
Virginia,Hopewell city,9,1212,557,655
Virginia,Hopewell city,10,1318,630,688
Virginia,Hopewell city,11,1423,637,786
Virginia,Hopewell city,12,1465,639,826
Virginia,Hopewell city,13,1281,572,709
Virginia,Hopewell city,14,1094,462,632
Virginia,Hopewell city,15,895,391,504
Virginia,Hopewell city,16,658,279,379
Virginia,Hopewell city,17,458,160,298
Virginia,Hopewell city,18,441,118,323
Virginia,Lexington city,0,7136,4008,3128
Virginia,Lexington city,1,101,59,42
Virginia,Lexington city,2,213,114,99
Virginia,Lexington city,3,219,110,109
Virginia,Lexington city,4,1444,913,531
Virginia,Lexington city,5,1929,1348,581
Virginia,Lexington city,6,340,182,158
Virginia,Lexington city,7,242,118,124
Virginia,Lexington city,8,258,113,145
Virginia,Lexington city,9,232,126,106
Virginia,Lexington city,10,238,118,120
Virginia,Lexington city,11,230,114,116
Virginia,Lexington city,12,263,118,145
Virginia,Lexington city,13,271,117,154
Virginia,Lexington city,14,313,150,163
Virginia,Lexington city,15,289,113,176
Virginia,Lexington city,16,214,95,119
Virginia,Lexington city,17,146,52,94
Virginia,Lexington city,18,194,48,146
Virginia,Lynchburg city,0,82126,38521,43605
Virginia,Lynchburg city,1,5131,2617,2514
Virginia,Lynchburg city,2,4192,2106,2086
Virginia,Lynchburg city,3,4084,2119,1965
Virginia,Lynchburg city,4,8688,3906,4782
Virginia,Lynchburg city,5,14218,6827,7391
Virginia,Lynchburg city,6,7042,3478,3564
Virginia,Lynchburg city,7,4597,2280,2317
Virginia,Lynchburg city,8,3920,1820,2100
Virginia,Lynchburg city,9,3231,1538,1693
Virginia,Lynchburg city,10,3434,1607,1827
Virginia,Lynchburg city,11,3839,1779,2060
Virginia,Lynchburg city,12,3966,1851,2115
Virginia,Lynchburg city,13,3961,1781,2180
Virginia,Lynchburg city,14,3438,1525,1913
Virginia,Lynchburg city,15,2809,1200,1609
Virginia,Lynchburg city,16,2081,871,1210
Virginia,Lynchburg city,17,1512,583,929
Virginia,Lynchburg city,18,1983,633,1350
Virginia,Manassas city,0,41641,20875,20766
Virginia,Manassas city,1,3543,1844,1699
Virginia,Manassas city,2,3077,1590,1487
Virginia,Manassas city,3,2986,1555,1431
Virginia,Manassas city,4,2577,1329,1248
Virginia,Manassas city,5,2680,1348,1332
Virginia,Manassas city,6,3188,1533,1655
Virginia,Manassas city,7,3124,1650,1474
Virginia,Manassas city,8,3041,1612,1429
Virginia,Manassas city,9,2909,1510,1399
Virginia,Manassas city,10,2647,1352,1295
Virginia,Manassas city,11,2639,1283,1356
Virginia,Manassas city,12,2765,1293,1472
Virginia,Manassas city,13,2145,1040,1105
Virginia,Manassas city,14,1639,786,853
Virginia,Manassas city,15,1166,548,618
Virginia,Manassas city,16,670,308,362
Virginia,Manassas city,17,435,173,262
Virginia,Manassas city,18,410,121,289
Virginia,Manassas Park city,0,17307,8910,8397
Virginia,Manassas Park city,1,672,366,306
Virginia,Manassas Park city,2,1220,657,563
Virginia,Manassas Park city,3,1273,661,612
Virginia,Manassas Park city,4,1171,628,543
Virginia,Manassas Park city,5,1221,621,600
Virginia,Manassas Park city,6,1469,746,723
Virginia,Manassas Park city,7,1493,782,711
Virginia,Manassas Park city,8,1596,816,780
Virginia,Manassas Park city,9,1317,695,622
Virginia,Manassas Park city,10,1435,772,663
Virginia,Manassas Park city,11,1271,657,614
Virginia,Manassas Park city,12,1058,539,519
Virginia,Manassas Park city,13,727,362,365
Virginia,Manassas Park city,14,489,242,247
Virginia,Manassas Park city,15,381,174,207
Virginia,Manassas Park city,16,230,93,137
Virginia,Manassas Park city,17,153,48,105
Virginia,Manassas Park city,18,131,51,80
Virginia,Martinsville city,0,12902,5976,6926
Virginia,Martinsville city,1,954,476,478
Virginia,Martinsville city,2,894,487,407
Virginia,Martinsville city,3,898,431,467
Virginia,Martinsville city,4,713,374,339
Virginia,Martinsville city,5,721,373,348
Virginia,Martinsville city,6,755,345,410
Virginia,Martinsville city,7,716,347,369
Virginia,Martinsville city,8,676,305,371
Virginia,Martinsville city,9,654,320,334
Virginia,Martinsville city,10,764,348,416
Virginia,Martinsville city,11,905,412,493
Virginia,Martinsville city,12,917,422,495
Virginia,Martinsville city,13,893,380,513
Virginia,Martinsville city,14,727,332,395
Virginia,Martinsville city,15,613,267,346
Virginia,Martinsville city,16,438,158,280
Virginia,Martinsville city,17,358,140,218
Virginia,Martinsville city,18,306,59,247
Virginia,Newport News city,0,178626,86229,92397
Virginia,Newport News city,1,13024,6781,6243
Virginia,Newport News city,2,11534,5844,5690
Virginia,Newport News city,3,10546,5370,5176
Virginia,Newport News city,4,12231,6208,6023
Virginia,Newport News city,5,14993,7773,7220
Virginia,Newport News city,6,16213,8189,8024
Virginia,Newport News city,7,14110,6939,7171
Virginia,Newport News city,8,11916,5876,6040
Virginia,Newport News city,9,9642,4647,4995
Virginia,Newport News city,10,9442,4387,5055
Virginia,Newport News city,11,10208,4777,5431
Virginia,Newport News city,12,11439,5311,6128
Virginia,Newport News city,13,9987,4607,5380
Virginia,Newport News city,14,7493,3288,4205
Virginia,Newport News city,15,5897,2579,3318
Virginia,Newport News city,16,4116,1655,2461
Virginia,Newport News city,17,2889,1067,1822
Virginia,Newport News city,18,2946,931,2015
Virginia,Norfolk city,0,244076,127235,116841
Virginia,Norfolk city,1,15893,8051,7842
Virginia,Norfolk city,2,13598,6923,6675
Virginia,Norfolk city,3,11792,5968,5824
Virginia,Norfolk city,4,15552,8300,7252
Virginia,Norfolk city,5,34001,21537,12464
Virginia,Norfolk city,6,27033,15065,11968
Virginia,Norfolk city,7,20495,11234,9261
Virginia,Norfolk city,8,15903,8598,7305
Virginia,Norfolk city,9,12033,6151,5882
Virginia,Norfolk city,10,11535,5602,5933
Virginia,Norfolk city,11,12333,5874,6459
Virginia,Norfolk city,12,13821,6516,7305
Virginia,Norfolk city,13,12753,5931,6822
Virginia,Norfolk city,14,9647,4344,5303
Virginia,Norfolk city,15,6816,2967,3849
Virginia,Norfolk city,16,4412,1843,2569
Virginia,Norfolk city,17,2951,1136,1815
Virginia,Norfolk city,18,3508,1195,2313
Virginia,Norton city,0,3968,1859,2109
Virginia,Norton city,1,201,94,107
Virginia,Norton city,2,246,114,132
Virginia,Norton city,3,203,103,100
Virginia,Norton city,4,238,137,101
Virginia,Norton city,5,252,135,117
Virginia,Norton city,6,315,165,150
Virginia,Norton city,7,293,155,138
Virginia,Norton city,8,244,115,129
Virginia,Norton city,9,236,102,134
Virginia,Norton city,10,229,114,115
Virginia,Norton city,11,241,117,124
Virginia,Norton city,12,256,124,132
Virginia,Norton city,13,274,112,162
Virginia,Norton city,14,237,85,152
Virginia,Norton city,15,163,70,93
Virginia,Norton city,16,142,54,88
Virginia,Norton city,17,104,37,67
Virginia,Norton city,18,94,26,68
Virginia,Petersburg city,0,31567,14508,17059
Virginia,Petersburg city,1,2720,1384,1336
Virginia,Petersburg city,2,1838,969,869
Virginia,Petersburg city,3,1637,819,818
Virginia,Petersburg city,4,1504,765,739
Virginia,Petersburg city,5,2146,1010,1136
Virginia,Petersburg city,6,2966,1336,1630
Virginia,Petersburg city,7,2090,949,1141
Virginia,Petersburg city,8,1692,799,893
Virginia,Petersburg city,9,1395,709,686
Virginia,Petersburg city,10,1668,722,946
Virginia,Petersburg city,11,2219,1050,1169
Virginia,Petersburg city,12,2179,1021,1158
Virginia,Petersburg city,13,2158,941,1217
Virginia,Petersburg city,14,1774,758,1016
Virginia,Petersburg city,15,1327,543,784
Virginia,Petersburg city,16,939,356,583
Virginia,Petersburg city,17,592,199,393
Virginia,Petersburg city,18,723,178,545
Virginia,Poquoson city,0,12190,6096,6094
Virginia,Poquoson city,1,585,328,257
Virginia,Poquoson city,2,703,341,362
Virginia,Poquoson city,3,889,455,434
Virginia,Poquoson city,4,807,430,377
Virginia,Poquoson city,5,647,350,297
Virginia,Poquoson city,6,588,322,266
Virginia,Poquoson city,7,675,337,338
Virginia,Poquoson city,8,802,404,398
Virginia,Poquoson city,9,713,358,355
Virginia,Poquoson city,10,786,389,397
Virginia,Poquoson city,11,891,444,447
Virginia,Poquoson city,12,934,451,483
Virginia,Poquoson city,13,810,387,423
Virginia,Poquoson city,14,663,327,336
Virginia,Poquoson city,15,671,327,344
Virginia,Poquoson city,16,462,208,254
Virginia,Poquoson city,17,334,156,178
Virginia,Poquoson city,18,230,82,148
Virginia,Portsmouth city,0,94632,45452,49180
Virginia,Portsmouth city,1,6921,3500,3421
Virginia,Portsmouth city,2,6277,3159,3118
Virginia,Portsmouth city,3,5592,2838,2754
Virginia,Portsmouth city,4,5215,2714,2501
Virginia,Portsmouth city,5,6531,3523,3008
Virginia,Portsmouth city,6,8414,4282,4132
Virginia,Portsmouth city,7,7531,3688,3843
Virginia,Portsmouth city,8,6612,3170,3442
Virginia,Portsmouth city,9,5041,2451,2590
Virginia,Portsmouth city,10,4937,2361,2576
Virginia,Portsmouth city,11,5470,2552,2918
Virginia,Portsmouth city,12,6270,2853,3417
Virginia,Portsmouth city,13,5693,2567,3126
Virginia,Portsmouth city,14,4705,2088,2617
Virginia,Portsmouth city,15,3538,1551,1987
Virginia,Portsmouth city,16,2396,936,1460
Virginia,Portsmouth city,17,1726,650,1076
Virginia,Portsmouth city,18,1763,569,1194
Virginia,Radford city,0,18339,8619,9720
Virginia,Radford city,1,647,346,301
Virginia,Radford city,2,629,301,328
Virginia,Radford city,3,601,298,303
Virginia,Radford city,4,2978,1230,1748
Virginia,Radford city,5,4650,2125,2525
Virginia,Radford city,6,1337,747,590
Virginia,Radford city,7,942,472,470
Virginia,Radford city,8,793,360,433
Virginia,Radford city,9,769,386,383
Virginia,Radford city,10,864,444,420
Virginia,Radford city,11,826,409,417
Virginia,Radford city,12,809,393,416
Virginia,Radford city,13,822,386,436
Virginia,Radford city,14,582,265,317
Virginia,Radford city,15,359,187,172
Virginia,Radford city,16,302,122,180
Virginia,Radford city,17,202,74,128
Virginia,Radford city,18,227,74,153
Virginia,Richmond city,0,228783,108456,120327
Virginia,Richmond city,1,13421,6801,6620
Virginia,Richmond city,2,11303,5738,5565
Virginia,Richmond city,3,9936,4969,4967
Virginia,Richmond city,4,13534,6351,7183
Virginia,Richmond city,5,19374,9035,10339
Virginia,Richmond city,6,27814,13266,14548
Virginia,Richmond city,7,22641,11047,11594
Virginia,Richmond city,8,15921,8024,7897
Virginia,Richmond city,9,11555,5758,5797
Virginia,Richmond city,10,11893,5780,6113
Virginia,Richmond city,11,12970,6098,6872
Virginia,Richmond city,12,14401,6674,7727
Virginia,Richmond city,13,13848,6285,7563
Virginia,Richmond city,14,11132,5021,6111
Virginia,Richmond city,15,7211,3184,4027
Virginia,Richmond city,16,4601,1890,2711
Virginia,Richmond city,17,3064,1154,1910
Virginia,Richmond city,18,4164,1381,2783
Virginia,Roanoke city,0,99920,47891,52029
Virginia,Roanoke city,1,7054,3560,3494
Virginia,Roanoke city,2,6340,3274,3066
Virginia,Roanoke city,3,5973,3071,2902
Virginia,Roanoke city,4,4973,2596,2377
Virginia,Roanoke city,5,5670,2770,2900
Virginia,Roanoke city,6,8240,3962,4278
Virginia,Roanoke city,7,7240,3611,3629
Virginia,Roanoke city,8,6524,3173,3351
Virginia,Roanoke city,9,5717,2806,2911
Virginia,Roanoke city,10,6209,3029,3180
Virginia,Roanoke city,11,6324,3208,3116
Virginia,Roanoke city,12,6733,3188,3545
Virginia,Roanoke city,13,6403,3015,3388
Virginia,Roanoke city,14,5681,2446,3235
Virginia,Roanoke city,15,4115,1803,2312
Virginia,Roanoke city,16,2600,1053,1547
Virginia,Roanoke city,17,1735,613,1122
Virginia,Roanoke city,18,2389,713,1676
Virginia,Salem city,0,25643,12201,13442
Virginia,Salem city,1,1395,714,681
Virginia,Salem city,2,1345,693,652
Virginia,Salem city,3,1402,747,655
Virginia,Salem city,4,2152,1007,1145
Virginia,Salem city,5,2063,1000,1063
Virginia,Salem city,6,1540,763,777
Virginia,Salem city,7,1415,729,686
Virginia,Salem city,8,1469,742,727
Virginia,Salem city,9,1269,599,670
Virginia,Salem city,10,1667,813,854
Virginia,Salem city,11,1606,760,846
Virginia,Salem city,12,1701,816,885
Virginia,Salem city,13,1783,817,966
Virginia,Salem city,14,1515,667,848
Virginia,Salem city,15,1202,533,669
Virginia,Salem city,16,883,361,522
Virginia,Salem city,17,578,236,342
Virginia,Salem city,18,658,204,454
Virginia,Staunton city,0,24922,11435,13487
Virginia,Staunton city,1,1631,813,818
Virginia,Staunton city,2,1237,631,606
Virginia,Staunton city,3,1259,686,573
Virginia,Staunton city,4,1249,544,705
Virginia,Staunton city,5,1403,525,878
Virginia,Staunton city,6,1778,816,962
Virginia,Staunton city,7,1628,771,857
Virginia,Staunton city,8,1644,796,848
Virginia,Staunton city,9,1443,700,743
Virginia,Staunton city,10,1427,678,749
Virginia,Staunton city,11,1550,749,801
Virginia,Staunton city,12,1685,790,895
Virginia,Staunton city,13,1681,727,954
Virginia,Staunton city,14,1650,747,903
Virginia,Staunton city,15,1341,606,735
Virginia,Staunton city,16,934,395,539
Virginia,Staunton city,17,644,241,403
Virginia,Staunton city,18,738,220,518
Virginia,Suffolk city,0,91185,44173,47012
Virginia,Suffolk city,1,6165,3163,3002
Virginia,Suffolk city,2,6054,3136,2918
Virginia,Suffolk city,3,6208,3169,3039
Virginia,Suffolk city,4,5713,2941,2772
Virginia,Suffolk city,5,5124,2608,2516
Virginia,Suffolk city,6,5980,2882,3098
Virginia,Suffolk city,7,6344,3109,3235
Virginia,Suffolk city,8,6322,3055,3267
Virginia,Suffolk city,9,5309,2554,2755
Virginia,Suffolk city,10,6130,2883,3247
Virginia,Suffolk city,11,6371,2965,3406
Virginia,Suffolk city,12,6708,3262,3446
Virginia,Suffolk city,13,5593,2685,2908
Virginia,Suffolk city,14,4359,2076,2283
Virginia,Suffolk city,15,3530,1619,1911
Virginia,Suffolk city,16,2369,1008,1361
Virginia,Suffolk city,17,1419,590,829
Virginia,Suffolk city,18,1487,468,1019
Virginia,Virginia Beach city,0,450189,221065,229124
Virginia,Virginia Beach city,1,28247,14429,13818
Virginia,Virginia Beach city,2,27497,14193,13304
Virginia,Virginia Beach city,3,27714,14088,13626
Virginia,Virginia Beach city,4,26276,13777,12499
Virginia,Virginia Beach city,5,31409,16779,14630
Virginia,Virginia Beach city,6,38178,19709,18469
Virginia,Virginia Beach city,7,36262,18543,17719
Virginia,Virginia Beach city,8,32569,16273,16296
Virginia,Virginia Beach city,9,26912,13406,13506
Virginia,Virginia Beach city,10,27141,12926,14215
Virginia,Virginia Beach city,11,28316,13428,14888
Virginia,Virginia Beach city,12,29715,14000,15715
Virginia,Virginia Beach city,13,25949,11997,13952
Virginia,Virginia Beach city,14,21040,9489,11551
Virginia,Virginia Beach city,15,16679,7475,9204
Virginia,Virginia Beach city,16,11318,4859,6459
Virginia,Virginia Beach city,17,7335,2989,4346
Virginia,Virginia Beach city,18,7632,2705,4927
Virginia,Waynesboro city,0,22628,10802,11826
Virginia,Waynesboro city,1,1673,829,844
Virginia,Waynesboro city,2,1489,765,724
Virginia,Waynesboro city,3,1433,760,673
Virginia,Waynesboro city,4,1172,611,561
Virginia,Waynesboro city,5,1270,570,700
Virginia,Waynesboro city,6,1659,807,852
Virginia,Waynesboro city,7,1546,774,772
Virginia,Waynesboro city,8,1510,718,792
Virginia,Waynesboro city,9,1287,632,655
Virginia,Waynesboro city,10,1272,621,651
Virginia,Waynesboro city,11,1350,662,688
Virginia,Waynesboro city,12,1518,711,807
Virginia,Waynesboro city,13,1387,639,748
Virginia,Waynesboro city,14,1157,522,635
Virginia,Waynesboro city,15,1048,441,607
Virginia,Waynesboro city,16,796,336,460
Virginia,Waynesboro city,17,520,228,292
Virginia,Waynesboro city,18,541,176,365
Virginia,Williamsburg city,0,14896,6853,8043
Virginia,Williamsburg city,1,492,241,251
Virginia,Williamsburg city,2,479,244,235
Virginia,Williamsburg city,3,435,225,210
Virginia,Williamsburg city,4,2404,1060,1344
Virginia,Williamsburg city,5,3176,1388,1788
Virginia,Williamsburg city,6,961,465,496
Virginia,Williamsburg city,7,798,391,407
Virginia,Williamsburg city,8,620,288,332
Virginia,Williamsburg city,9,483,228,255
Virginia,Williamsburg city,10,512,261,251
Virginia,Williamsburg city,11,602,256,346
Virginia,Williamsburg city,12,740,358,382
Virginia,Williamsburg city,13,762,358,404
Virginia,Williamsburg city,14,723,325,398
Virginia,Williamsburg city,15,617,284,333
Virginia,Williamsburg city,16,463,213,250
Virginia,Williamsburg city,17,349,159,190
Virginia,Williamsburg city,18,280,109,171
Virginia,Winchester city,0,28108,13689,14419
Virginia,Winchester city,1,1873,982,891
Virginia,Winchester city,2,1756,877,879
Virginia,Winchester city,3,1750,932,818
Virginia,Winchester city,4,2066,1035,1031
Virginia,Winchester city,5,1978,953,1025
Virginia,Winchester city,6,2113,1045,1068
Virginia,Winchester city,7,1801,887,914
Virginia,Winchester city,8,1835,951,884
Virginia,Winchester city,9,1598,797,801
Virginia,Winchester city,10,1678,745,933
Virginia,Winchester city,11,1736,845,891
Virginia,Winchester city,12,1761,882,879
Virginia,Winchester city,13,1697,795,902
Virginia,Winchester city,14,1456,676,780
Virginia,Winchester city,15,1144,546,598
Virginia,Winchester city,16,734,294,440
Virginia,Winchester city,17,562,233,329
Virginia,Winchester city,18,570,214,356
Washington,Adams County,0,19759,10009,9750
Washington,Adams County,1,1907,937,970
Washington,Adams County,2,2136,1132,1004
Washington,Adams County,3,1932,1010,922
Washington,Adams County,4,1616,794,822
Washington,Adams County,5,1363,714,649
Washington,Adams County,6,1247,646,601
Washington,Adams County,7,1231,653,578
Washington,Adams County,8,1135,553,582
Washington,Adams County,9,1069,525,544
Washington,Adams County,10,1029,528,501
Washington,Adams County,11,959,491,468
Washington,Adams County,12,974,491,483
Washington,Adams County,13,976,466,510
Washington,Adams County,14,755,375,380
Washington,Adams County,15,581,297,284
Washington,Adams County,16,371,183,188
Washington,Adams County,17,236,104,132
Washington,Adams County,18,242,110,132
Washington,Asotin County,0,22610,11023,11587
Washington,Asotin County,1,1165,612,553
Washington,Asotin County,2,1259,624,635
Washington,Asotin County,3,1344,679,665
Washington,Asotin County,4,1236,609,627
Washington,Asotin County,5,1031,534,497
Washington,Asotin County,6,1333,653,680
Washington,Asotin County,7,1284,640,644
Washington,Asotin County,8,1303,640,663
Washington,Asotin County,9,1236,614,622
Washington,Asotin County,10,1256,615,641
Washington,Asotin County,11,1337,663,674
Washington,Asotin County,12,1690,791,899
Washington,Asotin County,13,1864,858,1006
Washington,Asotin County,14,1575,779,796
Washington,Asotin County,15,1316,609,707
Washington,Asotin County,16,1033,492,541
Washington,Asotin County,17,695,324,371
Washington,Asotin County,18,653,287,366
Washington,Benton County,0,201877,101150,100727
Washington,Benton County,1,14468,7442,7026
Washington,Benton County,2,15378,7868,7510
Washington,Benton County,3,15296,7884,7412
Washington,Benton County,4,13661,7107,6554
Washington,Benton County,5,12103,6231,5872
Washington,Benton County,6,13742,6982,6760
Washington,Benton County,7,13822,7008,6814
Washington,Benton County,8,13793,6932,6861
Washington,Benton County,9,11703,6014,5689
Washington,Benton County,10,11454,5766,5688
Washington,Benton County,11,11575,5733,5842
Washington,Benton County,12,12597,6162,6435
Washington,Benton County,13,12188,5966,6222
Washington,Benton County,14,10393,5160,5233
Washington,Benton County,15,7758,3703,4055
Washington,Benton County,16,5262,2489,2773
Washington,Benton County,17,3327,1475,1852
Washington,Benton County,18,3357,1228,2129
Washington,Chelan County,0,77036,38521,38515
Washington,Chelan County,1,4820,2510,2310
Washington,Chelan County,2,5152,2647,2505
Washington,Chelan County,3,5020,2650,2370
Washington,Chelan County,4,4758,2433,2325
Washington,Chelan County,5,4386,2233,2153
Washington,Chelan County,6,4945,2640,2305
Washington,Chelan County,7,4692,2353,2339
Washington,Chelan County,8,4825,2437,2388
Washington,Chelan County,9,4264,2080,2184
Washington,Chelan County,10,4157,2089,2068
Washington,Chelan County,11,4506,2284,2222
Washington,Chelan County,12,5267,2547,2720
Washington,Chelan County,13,5548,2688,2860
Washington,Chelan County,14,4929,2462,2467
Washington,Chelan County,15,3723,1820,1903
Washington,Chelan County,16,2524,1191,1333
Washington,Chelan County,17,1674,769,905
Washington,Chelan County,18,1846,688,1158
Washington,Clallam County,0,76737,37842,38895
Washington,Clallam County,1,3534,1859,1675
Washington,Clallam County,2,3737,1882,1855
Washington,Clallam County,3,3595,1819,1776
Washington,Clallam County,4,3488,1826,1662
Washington,Clallam County,5,3446,1921,1525
Washington,Clallam County,6,4229,2272,1957
Washington,Clallam County,7,4129,2166,1963
Washington,Clallam County,8,4064,2116,1948
Washington,Clallam County,9,3587,1821,1766
Washington,Clallam County,10,3686,1824,1862
Washington,Clallam County,11,4016,1929,2087
Washington,Clallam County,12,5652,2593,3059
Washington,Clallam County,13,6854,3214,3640
Washington,Clallam County,14,7317,3423,3894
Washington,Clallam County,15,5963,2791,3172
Washington,Clallam County,16,4214,2058,2156
Washington,Clallam County,17,2573,1271,1302
Washington,Clallam County,18,2653,1057,1596
Washington,Clark County,0,481857,238118,243739
Washington,Clark County,1,29559,15371,14188
Washington,Clark County,2,31868,16126,15742
Washington,Clark County,3,33648,17139,16509
Washington,Clark County,4,31304,16065,15239
Washington,Clark County,5,27851,14234,13617
Washington,Clark County,6,32594,16696,15898
Washington,Clark County,7,31466,15624,15842
Washington,Clark County,8,32838,16153,16685
Washington,Clark County,9,31483,15468,16015
Washington,Clark County,10,32261,16190,16071
Washington,Clark County,11,30808,15129,15679
Washington,Clark County,12,32032,15731,16301
Washington,Clark County,13,29615,14274,15341
Washington,Clark County,14,26333,12394,13939
Washington,Clark County,15,20376,9531,10845
Washington,Clark County,16,12857,6034,6823
Washington,Clark County,17,7425,3243,4182
Washington,Clark County,18,7539,2716,4823
Washington,Columbia County,0,4059,1982,2077
Washington,Columbia County,1,205,101,104
Washington,Columbia County,2,212,117,95
Washington,Columbia County,3,211,109,102
Washington,Columbia County,4,204,100,104
Washington,Columbia County,5,174,79,95
Washington,Columbia County,6,218,89,129
Washington,Columbia County,7,192,80,112
Washington,Columbia County,8,225,117,108
Washington,Columbia County,9,170,91,79
Washington,Columbia County,10,219,120,99
Washington,Columbia County,11,263,132,131
Washington,Columbia County,12,314,146,168
Washington,Columbia County,13,321,159,162
Washington,Columbia County,14,362,170,192
Washington,Columbia County,15,276,140,136
Washington,Columbia County,16,220,104,116
Washington,Columbia County,17,140,77,63
Washington,Columbia County,18,133,51,82
Washington,Cowlitz County,0,108987,53938,55049
Washington,Cowlitz County,1,6749,3470,3279
Washington,Cowlitz County,2,6886,3458,3428
Washington,Cowlitz County,3,7004,3575,3429
Washington,Cowlitz County,4,6692,3345,3347
Washington,Cowlitz County,5,5878,2975,2903
Washington,Cowlitz County,6,7112,3494,3618
Washington,Cowlitz County,7,6317,3168,3149
Washington,Cowlitz County,8,6614,3312,3302
Washington,Cowlitz County,9,6290,3183,3107
Washington,Cowlitz County,10,6635,3366,3269
Washington,Cowlitz County,11,6693,3309,3384
Washington,Cowlitz County,12,7699,3803,3896
Washington,Cowlitz County,13,7792,3857,3935
Washington,Cowlitz County,14,6787,3245,3542
Washington,Cowlitz County,15,5580,2698,2882
Washington,Cowlitz County,16,3804,1845,1959
Washington,Cowlitz County,17,2219,996,1223
Washington,Cowlitz County,18,2236,839,1397
Washington,Douglas County,0,42907,21740,21167
Washington,Douglas County,1,2811,1450,1361
Washington,Douglas County,2,3153,1645,1508
Washington,Douglas County,3,3233,1646,1587
Washington,Douglas County,4,2911,1518,1393
Washington,Douglas County,5,2550,1359,1191
Washington,Douglas County,6,2674,1436,1238
Washington,Douglas County,7,2685,1406,1279
Washington,Douglas County,8,2633,1360,1273
Washington,Douglas County,9,2485,1259,1226
Washington,Douglas County,10,2460,1244,1216
Washington,Douglas County,11,2368,1178,1190
Washington,Douglas County,12,2683,1376,1307
Washington,Douglas County,13,2723,1347,1376
Washington,Douglas County,14,2383,1121,1262
Washington,Douglas County,15,2007,918,1089
Washington,Douglas County,16,1412,734,678
Washington,Douglas County,17,870,431,439
Washington,Douglas County,18,866,312,554
Washington,Ferry County,0,7649,3909,3740
Washington,Ferry County,1,367,194,173
Washington,Ferry County,2,365,185,180
Washington,Ferry County,3,362,200,162
Washington,Ferry County,4,442,272,170
Washington,Ferry County,5,365,204,161
Washington,Ferry County,6,338,170,168
Washington,Ferry County,7,332,168,164
Washington,Ferry County,8,361,178,183
Washington,Ferry County,9,407,218,189
Washington,Ferry County,10,464,223,241
Washington,Ferry County,11,448,197,251
Washington,Ferry County,12,608,297,311
Washington,Ferry County,13,708,337,371
Washington,Ferry County,14,797,401,396
Washington,Ferry County,15,534,281,253
Washington,Ferry County,16,401,230,171
Washington,Ferry County,17,174,92,82
Washington,Ferry County,18,176,62,114
Washington,Franklin County,0,94347,48752,45595
Washington,Franklin County,1,8466,4274,4192
Washington,Franklin County,2,8778,4374,4404
Washington,Franklin County,3,8566,4288,4278
Washington,Franklin County,4,7354,3831,3523
Washington,Franklin County,5,6330,3318,3012
Washington,Franklin County,6,7164,3880,3284
Washington,Franklin County,7,7472,4030,3442
Washington,Franklin County,8,7087,3863,3224
Washington,Franklin County,9,5982,3122,2860
Washington,Franklin County,10,5333,2823,2510
Washington,Franklin County,11,4674,2445,2229
Washington,Franklin County,12,4314,2208,2106
Washington,Franklin County,13,4133,2134,1999
Washington,Franklin County,14,3238,1617,1621
Washington,Franklin County,15,2349,1139,1210
Washington,Franklin County,16,1446,713,733
Washington,Franklin County,17,865,377,488
Washington,Franklin County,18,796,316,480
Washington,Garfield County,0,2247,1099,1148
Washington,Garfield County,1,160,79,81
Washington,Garfield County,2,115,55,60
Washington,Garfield County,3,124,71,53
Washington,Garfield County,4,115,61,54
Washington,Garfield County,5,100,49,51
Washington,Garfield County,6,80,38,42
Washington,Garfield County,7,114,61,53
Washington,Garfield County,8,119,63,56
Washington,Garfield County,9,143,58,85
Washington,Garfield County,10,117,55,62
Washington,Garfield County,11,122,54,68
Washington,Garfield County,12,160,82,78
Washington,Garfield County,13,207,100,107
Washington,Garfield County,14,187,90,97
Washington,Garfield County,15,149,84,65
Washington,Garfield County,16,75,38,37
Washington,Garfield County,17,75,26,49
Washington,Garfield County,18,85,35,50
Washington,Grant County,0,97331,49539,47792
Washington,Grant County,1,7470,3782,3688
Washington,Grant County,2,8343,4188,4155
Washington,Grant County,3,8286,4248,4038
Washington,Grant County,4,7185,3691,3494
Washington,Grant County,5,6471,3386,3085
Washington,Grant County,6,7140,3778,3362
Washington,Grant County,7,6189,3276,2913
Washington,Grant County,8,5983,3166,2817
Washington,Grant County,9,5524,2691,2833
Washington,Grant County,10,5406,2742,2664
Washington,Grant County,11,5167,2650,2517
Washington,Grant County,12,5580,2851,2729
Washington,Grant County,13,5238,2680,2558
Washington,Grant County,14,4440,2205,2235
Washington,Grant County,15,3622,1826,1796
Washington,Grant County,16,2354,1132,1222
Washington,Grant County,17,1419,651,768
Washington,Grant County,18,1514,596,918
Washington,Grays Harbor County,0,73901,37819,36082
Washington,Grays Harbor County,1,3907,1935,1972
Washington,Grays Harbor County,2,4336,2257,2079
Washington,Grays Harbor County,3,4326,2165,2161
Washington,Grays Harbor County,4,3975,2066,1909
Washington,Grays Harbor County,5,3715,2049,1666
Washington,Grays Harbor County,6,4474,2503,1971
Washington,Grays Harbor County,7,4288,2304,1984
Washington,Grays Harbor County,8,4383,2302,2081
Washington,Grays Harbor County,9,4037,2190,1847
Washington,Grays Harbor County,10,4334,2288,2046
Washington,Grays Harbor County,11,4602,2398,2204
Washington,Grays Harbor County,12,5452,2716,2736
Washington,Grays Harbor County,13,6104,2957,3147
Washington,Grays Harbor County,14,5618,2791,2827
Washington,Grays Harbor County,15,4250,2051,2199
Washington,Grays Harbor County,16,2802,1426,1376
Washington,Grays Harbor County,17,1718,790,928
Washington,Grays Harbor County,18,1580,631,949
Washington,Island County,0,84460,42115,42345
Washington,Island County,1,4806,2381,2425
Washington,Island County,2,4317,2206,2111
Washington,Island County,3,3901,2002,1899
Washington,Island County,4,3783,2025,1758
Washington,Island County,5,5931,3395,2536
Washington,Island County,6,6351,3499,2852
Washington,Island County,7,5534,2937,2597
Washington,Island County,8,4804,2513,2291
Washington,Island County,9,3785,1869,1916
Washington,Island County,10,3978,1953,2025
Washington,Island County,11,4526,2138,2388
Washington,Island County,12,5582,2632,2950
Washington,Island County,13,6399,2890,3509
Washington,Island County,14,6911,3180,3731
Washington,Island County,15,5845,2817,3028
Washington,Island County,16,3813,1823,1990
Washington,Island County,17,2134,1018,1116
Washington,Island County,18,2060,837,1223
Washington,Jefferson County,0,31729,15528,16201
Washington,Jefferson County,1,957,476,481
Washington,Jefferson County,2,1036,516,520
Washington,Jefferson County,3,1088,567,521
Washington,Jefferson County,4,1092,546,546
Washington,Jefferson County,5,1077,592,485
Washington,Jefferson County,6,1311,696,615
Washington,Jefferson County,7,1390,728,662
Washington,Jefferson County,8,1434,744,690
Washington,Jefferson County,9,1277,649,628
Washington,Jefferson County,10,1563,775,788
Washington,Jefferson County,11,1744,852,892
Washington,Jefferson County,12,2522,1132,1390
Washington,Jefferson County,13,3545,1566,1979
Washington,Jefferson County,14,3971,1895,2076
Washington,Jefferson County,15,3411,1648,1763
Washington,Jefferson County,16,2163,1111,1052
Washington,Jefferson County,17,1120,597,523
Washington,Jefferson County,18,1028,438,590
Washington,King County,0,2233163,1121104,1112059
Washington,King County,1,130129,66472,63657
Washington,King County,2,127759,64901,62858
Washington,King County,3,123283,63018,60265
Washington,King County,4,119705,60480,59225
Washington,King County,5,133021,68042,64979
Washington,King County,6,206461,107751,98710
Washington,King County,7,202409,105546,96863
Washington,King County,8,180984,93465,87519
Washington,King County,9,154440,79008,75432
Washington,King County,10,153878,78416,75462
Washington,King County,11,140472,71155,69317
Washington,King County,12,139404,70084,69320
Washington,King County,13,126108,61637,64471
Washington,King County,14,101638,48085,53553
Washington,King County,15,75779,34833,40946
Washington,King County,16,47877,21423,26454
Washington,King County,17,31450,13309,18141
Washington,King County,18,38366,13479,24887
Washington,Kitsap County,0,269805,137982,131823
Washington,Kitsap County,1,15688,8139,7549
Washington,Kitsap County,2,15155,7726,7429
Washington,Kitsap County,3,15312,7854,7458
Washington,Kitsap County,4,14636,7713,6923
Washington,Kitsap County,5,20401,12476,7925
Washington,Kitsap County,6,21067,11669,9398
Washington,Kitsap County,7,18681,9989,8692
Washington,Kitsap County,8,17458,9092,8366
Washington,Kitsap County,9,14617,7439,7178
Washington,Kitsap County,10,15284,7635,7649
Washington,Kitsap County,11,16183,7958,8225
Washington,Kitsap County,12,18801,9161,9640
Washington,Kitsap County,13,18428,8788,9640
Washington,Kitsap County,14,16565,7968,8597
Washington,Kitsap County,15,13439,6403,7036
Washington,Kitsap County,16,8312,4006,4306
Washington,Kitsap County,17,4786,2141,2645
Washington,Kitsap County,18,4992,1825,3167
Washington,Kittitas County,0,47364,23889,23475
Washington,Kittitas County,1,2181,1119,1062
Washington,Kittitas County,2,2297,1199,1098
Washington,Kittitas County,3,2284,1114,1170
Washington,Kittitas County,4,3906,1885,2021
Washington,Kittitas County,5,7514,3801,3713
Washington,Kittitas County,6,3455,1923,1532
Washington,Kittitas County,7,2547,1341,1206
Washington,Kittitas County,8,2534,1275,1259
Washington,Kittitas County,9,2231,1143,1088
Washington,Kittitas County,10,2432,1245,1187
Washington,Kittitas County,11,2405,1203,1202
Washington,Kittitas County,12,3020,1443,1577
Washington,Kittitas County,13,2966,1448,1518
Washington,Kittitas County,14,2621,1319,1302
Washington,Kittitas County,15,2023,1013,1010
Washington,Kittitas County,16,1346,685,661
Washington,Kittitas County,17,821,426,395
Washington,Kittitas County,18,781,307,474
Washington,Klickitat County,0,22107,11157,10950
Washington,Klickitat County,1,1102,560,542
Washington,Klickitat County,2,1153,615,538
Washington,Klickitat County,3,1252,637,615
Washington,Klickitat County,4,1157,600,557
Washington,Klickitat County,5,984,517,467
Washington,Klickitat County,6,1062,549,513
Washington,Klickitat County,7,1180,579,601
Washington,Klickitat County,8,1281,677,604
Washington,Klickitat County,9,1314,639,675
Washington,Klickitat County,10,1367,715,652
Washington,Klickitat County,11,1391,712,679
Washington,Klickitat County,12,1661,794,867
Washington,Klickitat County,13,1921,932,989
Washington,Klickitat County,14,1886,948,938
Washington,Klickitat County,15,1430,737,693
Washington,Klickitat County,16,956,509,447
Washington,Klickitat County,17,541,275,266
Washington,Klickitat County,18,469,162,307
Washington,Lewis County,0,79604,39780,39824
Washington,Lewis County,1,4706,2398,2308
Washington,Lewis County,2,4694,2415,2279
Washington,Lewis County,3,4714,2423,2291
Washington,Lewis County,4,4660,2490,2170
Washington,Lewis County,5,4187,2149,2038
Washington,Lewis County,6,4946,2558,2388
Washington,Lewis County,7,4551,2304,2247
Washington,Lewis County,8,4737,2380,2357
Washington,Lewis County,9,4370,2210,2160
Washington,Lewis County,10,4739,2345,2394
Washington,Lewis County,11,4791,2446,2345
Washington,Lewis County,12,5863,2767,3096
Washington,Lewis County,13,5941,2877,3064
Washington,Lewis County,14,5545,2725,2820
Washington,Lewis County,15,4429,2271,2158
Washington,Lewis County,16,3086,1470,1616
Washington,Lewis County,17,1917,880,1037
Washington,Lewis County,18,1728,672,1056
Washington,Lincoln County,0,10740,5492,5248
Washington,Lincoln County,1,554,305,249
Washington,Lincoln County,2,616,315,301
Washington,Lincoln County,3,707,363,344
Washington,Lincoln County,4,668,357,311
Washington,Lincoln County,5,466,249,217
Washington,Lincoln County,6,433,236,197
Washington,Lincoln County,7,466,234,232
Washington,Lincoln County,8,576,297,279
Washington,Lincoln County,9,550,268,282
Washington,Lincoln County,10,587,285,302
Washington,Lincoln County,11,607,322,285
Washington,Lincoln County,12,810,399,411
Washington,Lincoln County,13,954,487,467
Washington,Lincoln County,14,869,462,407
Washington,Lincoln County,15,726,365,361
Washington,Lincoln County,16,479,252,227
Washington,Lincoln County,17,330,169,161
Washington,Lincoln County,18,342,127,215
Washington,Mason County,0,65507,34046,31461
Washington,Mason County,1,3448,1771,1677
Washington,Mason County,2,3564,1887,1677
Washington,Mason County,3,3614,1891,1723
Washington,Mason County,4,3304,1812,1492
Washington,Mason County,5,3369,1943,1426
Washington,Mason County,6,4126,2319,1807
Washington,Mason County,7,3715,2098,1617
Washington,Mason County,8,3827,2058,1769
Washington,Mason County,9,3335,1850,1485
Washington,Mason County,10,3726,1957,1769
Washington,Mason County,11,3945,2003,1942
Washington,Mason County,12,4966,2434,2532
Washington,Mason County,13,5632,2812,2820
Washington,Mason County,14,5185,2546,2639
Washington,Mason County,15,4124,2028,2096
Washington,Mason County,16,2686,1328,1358
Washington,Mason County,17,1638,780,858
Washington,Mason County,18,1303,529,774
Washington,Okanogan County,0,42132,21211,20921
Washington,Okanogan County,1,2629,1319,1310
Washington,Okanogan County,2,2845,1517,1328
Washington,Okanogan County,3,2772,1415,1357
Washington,Okanogan County,4,2384,1255,1129
Washington,Okanogan County,5,1975,975,1000
Washington,Okanogan County,6,2363,1149,1214
Washington,Okanogan County,7,2321,1195,1126
Washington,Okanogan County,8,2434,1282,1152
Washington,Okanogan County,9,2250,1152,1098
Washington,Okanogan County,10,2423,1240,1183
Washington,Okanogan County,11,2245,1099,1146
Washington,Okanogan County,12,2966,1417,1549
Washington,Okanogan County,13,3431,1667,1764
Washington,Okanogan County,14,3132,1541,1591
Washington,Okanogan County,15,2502,1319,1183
Washington,Okanogan County,16,1569,862,707
Washington,Okanogan County,17,1009,484,525
Washington,Okanogan County,18,882,323,559
Washington,Pacific County,0,22036,11003,11033
Washington,Pacific County,1,929,485,444
Washington,Pacific County,2,927,478,449
Washington,Pacific County,3,1038,503,535
Washington,Pacific County,4,943,546,397
Washington,Pacific County,5,895,482,413
Washington,Pacific County,6,1031,522,509
Washington,Pacific County,7,1022,518,504
Washington,Pacific County,8,1165,642,523
Washington,Pacific County,9,983,484,499
Washington,Pacific County,10,1085,534,551
Washington,Pacific County,11,1309,649,660
Washington,Pacific County,12,1660,786,874
Washington,Pacific County,13,2286,1096,1190
Washington,Pacific County,14,2334,1116,1218
Washington,Pacific County,15,1909,936,973
Washington,Pacific County,16,1185,590,595
Washington,Pacific County,17,721,378,343
Washington,Pacific County,18,614,258,356
Washington,Pend Oreille County,0,13602,6922,6680
Washington,Pend Oreille County,1,659,332,327
Washington,Pend Oreille County,2,697,347,350
Washington,Pend Oreille County,3,767,408,359
Washington,Pend Oreille County,4,795,417,378
Washington,Pend Oreille County,5,561,297,264
Washington,Pend Oreille County,6,574,302,272
Washington,Pend Oreille County,7,615,297,318
Washington,Pend Oreille County,8,643,313,330
Washington,Pend Oreille County,9,631,325,306
Washington,Pend Oreille County,10,758,400,358
Washington,Pend Oreille County,11,886,481,405
Washington,Pend Oreille County,12,1148,559,589
Washington,Pend Oreille County,13,1333,638,695
Washington,Pend Oreille County,14,1276,666,610
Washington,Pend Oreille County,15,1035,556,479
Washington,Pend Oreille County,16,596,307,289
Washington,Pend Oreille County,17,326,160,166
Washington,Pend Oreille County,18,302,117,185
Washington,Pierce County,0,891299,443333,447966
Washington,Pierce County,1,59975,30711,29264
Washington,Pierce County,2,59194,30205,28989
Washington,Pierce County,3,57279,29410,27869
Washington,Pierce County,4,53050,27248,25802
Washington,Pierce County,5,58888,31609,27279
Washington,Pierce County,6,72543,37563,34980
Washington,Pierce County,7,67340,33851,33489
Washington,Pierce County,8,64083,31815,32268
Washington,Pierce County,9,54239,27046,27193
Washington,Pierce County,10,55387,27586,27801
Washington,Pierce County,11,55012,27236,27776
Washington,Pierce County,12,58264,28530,29734
Washington,Pierce County,13,52910,25532,27378
Washington,Pierce County,14,42570,20175,22395
Washington,Pierce County,15,32275,14945,17330
Washington,Pierce County,16,21163,9421,11742
Washington,Pierce County,17,13329,5599,7730
Washington,Pierce County,18,13798,4851,8947
Washington,San Juan County,0,17128,8286,8842
Washington,San Juan County,1,489,252,237
Washington,San Juan County,2,608,304,304
Washington,San Juan County,3,694,321,373
Washington,San Juan County,4,668,353,315
Washington,San Juan County,5,651,333,318
Washington,San Juan County,6,644,311,333
Washington,San Juan County,7,778,388,390
Washington,San Juan County,8,820,387,433
Washington,San Juan County,9,802,403,399
Washington,San Juan County,10,870,424,446
Washington,San Juan County,11,1030,494,536
Washington,San Juan County,12,1419,663,756
Washington,San Juan County,13,1816,838,978
Washington,San Juan County,14,2013,966,1047
Washington,San Juan County,15,1757,861,896
Washington,San Juan County,16,1001,514,487
Washington,San Juan County,17,567,281,286
Washington,San Juan County,18,501,193,308
Washington,Skagit County,0,128206,63544,64662
Washington,Skagit County,1,7780,4053,3727
Washington,Skagit County,2,7784,3943,3841
Washington,Skagit County,3,7814,3974,3840
Washington,Skagit County,4,7292,3839,3453
Washington,Skagit County,5,7163,3565,3598
Washington,Skagit County,6,8318,4336,3982
Washington,Skagit County,7,7855,4051,3804
Washington,Skagit County,8,7987,4084,3903
Washington,Skagit County,9,7127,3602,3525
Washington,Skagit County,10,7216,3567,3649
Washington,Skagit County,11,7286,3636,3650
Washington,Skagit County,12,8826,4227,4599
Washington,Skagit County,13,9167,4325,4842
Washington,Skagit County,14,8761,4206,4555
Washington,Skagit County,15,7115,3355,3760
Washington,Skagit County,16,4732,2225,2507
Washington,Skagit County,17,2955,1328,1627
Washington,Skagit County,18,3028,1228,1800
Washington,Skamania County,0,11924,6061,5863
Washington,Skamania County,1,524,268,256
Washington,Skamania County,2,611,313,298
Washington,Skamania County,3,652,342,310
Washington,Skamania County,4,653,346,307
Washington,Skamania County,5,525,276,249
Washington,Skamania County,6,593,293,300
Washington,Skamania County,7,632,326,306
Washington,Skamania County,8,691,331,360
Washington,Skamania County,9,724,371,353
Washington,Skamania County,10,779,389,390
Washington,Skamania County,11,817,395,422
Washington,Skamania County,12,1059,546,513
Washington,Skamania County,13,1157,565,592
Washington,Skamania County,14,885,487,398
Washington,Skamania County,15,697,370,327
Washington,Skamania County,16,412,205,207
Washington,Skamania County,17,251,130,121
Washington,Skamania County,18,262,108,154
Washington,Snohomish County,0,814901,408857,406044
Washington,Snohomish County,1,52083,26942,25141
Washington,Snohomish County,2,50976,26232,24744
Washington,Snohomish County,3,51514,26485,25029
Washington,Snohomish County,4,46683,24161,22522
Washington,Snohomish County,5,46065,23892,22173
Washington,Snohomish County,6,59542,30364,29178
Washington,Snohomish County,7,62582,31868,30714
Washington,Snohomish County,8,62130,31974,30156
Washington,Snohomish County,9,53574,27302,26272
Washington,Snohomish County,10,55728,28378,27350
Washington,Snohomish County,11,54970,27800,27170
Washington,Snohomish County,12,57897,28943,28954
Washington,Snohomish County,13,51389,25276,26113
Washington,Snohomish County,14,39700,18861,20839
Washington,Snohomish County,15,28697,13244,15453
Washington,Snohomish County,16,17977,8207,9770
Washington,Snohomish County,17,11365,4711,6654
Washington,Snohomish County,18,12029,4217,7812
Washington,Spokane County,0,514631,255193,259438
Washington,Spokane County,1,31388,16127,15261
Washington,Spokane County,2,31591,16104,15487
Washington,Spokane County,3,32005,16404,15601
Washington,Spokane County,4,32585,16799,15786
Washington,Spokane County,5,34573,17757,16816
Washington,Spokane County,6,40568,21124,19444
Washington,Spokane County,7,36614,18458,18156
Washington,Spokane County,8,34037,17287,16750
Washington,Spokane County,9,29494,14805,14689
Washington,Spokane County,10,30804,15455,15349
Washington,Spokane County,11,30330,14885,15445
Washington,Spokane County,12,34273,16633,17640
Washington,Spokane County,13,33090,15763,17327
Washington,Spokane County,14,28998,13690,15308
Washington,Spokane County,15,21457,10199,11258
Washington,Spokane County,16,13939,6400,7539
Washington,Spokane County,17,9015,3832,5183
Washington,Spokane County,18,9870,3471,6399
Washington,Stevens County,0,45260,22589,22671
Washington,Stevens County,1,2434,1232,1202
Washington,Stevens County,2,2679,1420,1259
Washington,Stevens County,3,2903,1477,1426
Washington,Stevens County,4,2664,1369,1295
Washington,Stevens County,5,2052,1058,994
Washington,Stevens County,6,2159,1107,1052
Washington,Stevens County,7,2075,1027,1048
Washington,Stevens County,8,2273,1138,1135
Washington,Stevens County,9,2334,1124,1210
Washington,Stevens County,10,2587,1286,1301
Washington,Stevens County,11,2794,1343,1451
Washington,Stevens County,12,3633,1748,1885
Washington,Stevens County,13,4131,1988,2143
Washington,Stevens County,14,3791,1951,1840
Washington,Stevens County,15,2830,1452,1378
Washington,Stevens County,16,1885,944,941
Washington,Stevens County,17,1087,554,533
Washington,Stevens County,18,949,371,578
Washington,Thurston County,0,286419,140136,146283
Washington,Thurston County,1,16690,8623,8067
Washington,Thurston County,2,17363,8962,8401
Washington,Thurston County,3,17049,8696,8353
Washington,Thurston County,4,16425,8426,7999
Washington,Thurston County,5,17035,8666,8369
Washington,Thurston County,6,20958,10833,10125
Washington,Thurston County,7,20664,10227,10437
Washington,Thurston County,8,20686,10290,10396
Washington,Thurston County,9,17947,8861,9086
Washington,Thurston County,10,17817,8759,9058
Washington,Thurston County,11,17073,8266,8807
Washington,Thurston County,12,18600,8760,9840
Washington,Thurston County,13,18598,8610,9988
Washington,Thurston County,14,17480,7965,9515
Washington,Thurston County,15,13287,6214,7073
Washington,Thurston County,16,8294,3852,4442
Washington,Thurston County,17,5151,2285,2866
Washington,Thurston County,18,5302,1841,3461
Washington,Wahkiakum County,0,4426,2222,2204
Washington,Wahkiakum County,1,137,71,66
Washington,Wahkiakum County,2,230,109,121
Washington,Wahkiakum County,3,229,114,115
Washington,Wahkiakum County,4,265,139,126
Washington,Wahkiakum County,5,174,95,79
Washington,Wahkiakum County,6,183,100,83
Washington,Wahkiakum County,7,169,85,84
Washington,Wahkiakum County,8,181,87,94
Washington,Wahkiakum County,9,193,100,93
Washington,Wahkiakum County,10,227,109,118
Washington,Wahkiakum County,11,285,157,128
Washington,Wahkiakum County,12,323,156,167
Washington,Wahkiakum County,13,406,191,215
Washington,Wahkiakum County,14,443,228,215
Washington,Wahkiakum County,15,418,201,217
Washington,Wahkiakum County,16,267,146,121
Washington,Wahkiakum County,17,164,84,80
Washington,Wahkiakum County,18,132,50,82
Washington,Walla Walla County,0,60922,31138,29784
Washington,Walla Walla County,1,3336,1704,1632
Washington,Walla Walla County,2,3493,1823,1670
Washington,Walla Walla County,3,3711,1921,1790
Washington,Walla Walla County,4,4711,2314,2397
Washington,Walla Walla County,5,5399,2900,2499
Washington,Walla Walla County,6,4130,2383,1747
Washington,Walla Walla County,7,3720,2058,1662
Washington,Walla Walla County,8,3727,2066,1661
Washington,Walla Walla County,9,3282,1697,1585
Washington,Walla Walla County,10,3303,1765,1538
Washington,Walla Walla County,11,3462,1770,1692
Washington,Walla Walla County,12,3740,1852,1888
Washington,Walla Walla County,13,3910,1866,2044
Washington,Walla Walla County,14,3453,1710,1743
Washington,Walla Walla County,15,2734,1303,1431
Washington,Walla Walla County,16,1906,880,1026
Washington,Walla Walla County,17,1251,547,704
Washington,Walla Walla County,18,1654,579,1075
Washington,Whatcom County,0,225685,111688,113997
Washington,Whatcom County,1,12067,6251,5816
Washington,Whatcom County,2,12429,6454,5975
Washington,Whatcom County,3,12142,6275,5867
Washington,Whatcom County,4,14908,7404,7504
Washington,Whatcom County,5,23520,11623,11897
Washington,Whatcom County,6,16991,8876,8115
Washington,Whatcom County,7,14047,7119,6928
Washington,Whatcom County,8,14368,7281,7087
Washington,Whatcom County,9,12458,6220,6238
Washington,Whatcom County,10,12959,6532,6427
Washington,Whatcom County,11,12625,6189,6436
Washington,Whatcom County,12,13743,6645,7098
Washington,Whatcom County,13,14270,6765,7505
Washington,Whatcom County,14,13567,6417,7150
Washington,Whatcom County,15,10658,5078,5580
Washington,Whatcom County,16,6659,3153,3506
Washington,Whatcom County,17,4051,1819,2232
Washington,Whatcom County,18,4223,1587,2636
Washington,Whitman County,0,49791,25408,24383
Washington,Whitman County,1,2116,1076,1040
Washington,Whitman County,2,2095,1090,1005
Washington,Whitman County,3,2002,1041,961
Washington,Whitman County,4,6166,2905,3261
Washington,Whitman County,5,12192,6408,5784
Washington,Whitman County,6,4511,2530,1981
Washington,Whitman County,7,2826,1539,1287
Washington,Whitman County,8,2432,1252,1180
Washington,Whitman County,9,2097,1051,1046
Washington,Whitman County,10,1929,985,944
Washington,Whitman County,11,1855,899,956
Washington,Whitman County,12,2253,1144,1109
Washington,Whitman County,13,2136,1037,1099
Washington,Whitman County,14,1704,879,825
Washington,Whitman County,15,1302,619,683
Washington,Whitman County,16,922,415,507
Washington,Whitman County,17,569,265,304
Washington,Whitman County,18,684,273,411
Washington,Yakima County,0,251446,125786,125660
Washington,Yakima County,1,20306,10531,9775
Washington,Yakima County,2,21085,10735,10350
Washington,Yakima County,3,21129,10809,10320
Washington,Yakima County,4,19005,9754,9251
Washington,Yakima County,5,16882,8645,8237
Washington,Yakima County,6,17994,9086,8908
Washington,Yakima County,7,15807,8058,7749
Washington,Yakima County,8,15489,7735,7754
Washington,Yakima County,9,14291,7165,7126
Washington,Yakima County,10,14171,7050,7121
Washington,Yakima County,11,13542,6801,6741
Washington,Yakima County,12,14221,7116,7105
Washington,Yakima County,13,13000,6407,6593
Washington,Yakima County,14,11277,5375,5902
Washington,Yakima County,15,8756,4252,4504
Washington,Yakima County,16,6092,2851,3241
Washington,Yakima County,17,3991,1763,2228
Washington,Yakima County,18,4408,1653,2755
West Virginia,Barbour County,0,16535,8049,8486
West Virginia,Barbour County,1,824,420,404
West Virginia,Barbour County,2,878,443,435
West Virginia,Barbour County,3,984,500,484
West Virginia,Barbour County,4,1187,570,617
West Virginia,Barbour County,5,1282,598,684
West Virginia,Barbour County,6,943,478,465
West Virginia,Barbour County,7,869,423,446
West Virginia,Barbour County,8,885,433,452
West Virginia,Barbour County,9,953,459,494
West Virginia,Barbour County,10,1022,515,507
West Virginia,Barbour County,11,1026,502,524
West Virginia,Barbour County,12,1218,593,625
West Virginia,Barbour County,13,1131,552,579
West Virginia,Barbour County,14,1067,551,516
West Virginia,Barbour County,15,855,401,454
West Virginia,Barbour County,16,654,313,341
West Virginia,Barbour County,17,392,175,217
West Virginia,Barbour County,18,365,123,242
West Virginia,Berkeley County,0,117123,58095,59028
West Virginia,Berkeley County,1,7180,3682,3498
West Virginia,Berkeley County,2,7474,3808,3666
West Virginia,Berkeley County,3,7893,3980,3913
West Virginia,Berkeley County,4,7039,3611,3428
West Virginia,Berkeley County,5,6460,3236,3224
West Virginia,Berkeley County,6,8402,4135,4267
West Virginia,Berkeley County,7,8122,4097,4025
West Virginia,Berkeley County,8,8201,4066,4135
West Virginia,Berkeley County,9,7343,3580,3763
West Virginia,Berkeley County,10,8063,4037,4026
West Virginia,Berkeley County,11,8279,4135,4144
West Virginia,Berkeley County,12,8144,4074,4070
West Virginia,Berkeley County,13,7348,3629,3719
West Virginia,Berkeley County,14,6126,2948,3178
West Virginia,Berkeley County,15,4916,2322,2594
West Virginia,Berkeley County,16,3036,1418,1618
West Virginia,Berkeley County,17,1701,768,933
West Virginia,Berkeley County,18,1396,569,827
West Virginia,Boone County,0,21951,10937,11014
West Virginia,Boone County,1,1117,566,551
West Virginia,Boone County,2,1279,679,600
West Virginia,Boone County,3,1380,725,655
West Virginia,Boone County,4,1357,728,629
West Virginia,Boone County,5,1079,582,497
West Virginia,Boone County,6,1217,663,554
West Virginia,Boone County,7,1012,491,521
West Virginia,Boone County,8,1222,562,660
West Virginia,Boone County,9,1591,804,787
West Virginia,Boone County,10,1559,763,796
West Virginia,Boone County,11,1455,740,715
West Virginia,Boone County,12,1543,758,785
West Virginia,Boone County,13,1737,844,893
West Virginia,Boone County,14,1634,787,847
West Virginia,Boone County,15,1184,554,630
West Virginia,Boone County,16,712,349,363
West Virginia,Boone County,17,491,214,277
West Virginia,Boone County,18,382,128,254
West Virginia,Braxton County,0,14089,7122,6967
West Virginia,Braxton County,1,701,360,341
West Virginia,Braxton County,2,776,392,384
West Virginia,Braxton County,3,767,394,373
West Virginia,Braxton County,4,737,379,358
West Virginia,Braxton County,5,702,369,333
West Virginia,Braxton County,6,893,473,420
West Virginia,Braxton County,7,709,371,338
West Virginia,Braxton County,8,778,399,379
West Virginia,Braxton County,9,790,403,387
West Virginia,Braxton County,10,923,459,464
West Virginia,Braxton County,11,963,483,480
West Virginia,Braxton County,12,1072,568,504
West Virginia,Braxton County,13,1048,515,533
West Virginia,Braxton County,14,1116,558,558
West Virginia,Braxton County,15,821,404,417
West Virginia,Braxton County,16,593,310,283
West Virginia,Braxton County,17,361,165,196
West Virginia,Braxton County,18,339,120,219
West Virginia,Brooke County,0,22203,10902,11301
West Virginia,Brooke County,1,976,504,472
West Virginia,Brooke County,2,997,505,492
West Virginia,Brooke County,3,1224,644,580
West Virginia,Brooke County,4,1358,706,652
West Virginia,Brooke County,5,1422,731,691
West Virginia,Brooke County,6,1244,648,596
West Virginia,Brooke County,7,1010,530,480
West Virginia,Brooke County,8,1118,542,576
West Virginia,Brooke County,9,1279,656,623
West Virginia,Brooke County,10,1356,667,689
West Virginia,Brooke County,11,1446,717,729
West Virginia,Brooke County,12,1733,852,881
West Virginia,Brooke County,13,1750,859,891
West Virginia,Brooke County,14,1760,821,939
West Virginia,Brooke County,15,1288,606,682
West Virginia,Brooke County,16,895,400,495
West Virginia,Brooke County,17,670,288,382
West Virginia,Brooke County,18,677,226,451
West Virginia,Cabell County,0,93224,45585,47639
West Virginia,Cabell County,1,5016,2663,2353
West Virginia,Cabell County,2,5156,2643,2513
West Virginia,Cabell County,3,5111,2690,2421
West Virginia,Cabell County,4,6199,3081,3118
West Virginia,Cabell County,5,9327,4535,4792
West Virginia,Cabell County,6,6082,3111,2971
West Virginia,Cabell County,7,5381,2824,2557
West Virginia,Cabell County,8,5870,3014,2856
West Virginia,Cabell County,9,5113,2541,2572
West Virginia,Cabell County,10,5550,2785,2765
West Virginia,Cabell County,11,5313,2647,2666
West Virginia,Cabell County,12,5731,2709,3022
West Virginia,Cabell County,13,5833,2763,3070
West Virginia,Cabell County,14,5526,2560,2966
West Virginia,Cabell County,15,4531,2053,2478
West Virginia,Cabell County,16,3185,1424,1761
West Virginia,Cabell County,17,2133,816,1317
West Virginia,Cabell County,18,2167,726,1441
West Virginia,Calhoun County,0,7254,3617,3637
West Virginia,Calhoun County,1,347,166,181
West Virginia,Calhoun County,2,387,206,181
West Virginia,Calhoun County,3,392,186,206
West Virginia,Calhoun County,4,350,169,181
West Virginia,Calhoun County,5,316,146,170
West Virginia,Calhoun County,6,333,172,161
West Virginia,Calhoun County,7,352,179,173
West Virginia,Calhoun County,8,391,207,184
West Virginia,Calhoun County,9,430,210,220
West Virginia,Calhoun County,10,438,221,217
West Virginia,Calhoun County,11,541,264,277
West Virginia,Calhoun County,12,563,301,262
West Virginia,Calhoun County,13,635,307,328
West Virginia,Calhoun County,14,577,295,282
West Virginia,Calhoun County,15,495,270,225
West Virginia,Calhoun County,16,290,154,136
West Virginia,Calhoun County,17,225,90,135
West Virginia,Calhoun County,18,192,74,118
West Virginia,Clay County,0,8632,4360,4272
West Virginia,Clay County,1,473,245,228
West Virginia,Clay County,2,526,276,250
West Virginia,Clay County,3,574,314,260
West Virginia,Clay County,4,509,268,241
West Virginia,Clay County,5,421,216,205
West Virginia,Clay County,6,473,248,225
West Virginia,Clay County,7,386,184,202
West Virginia,Clay County,8,500,265,235
West Virginia,Clay County,9,521,237,284
West Virginia,Clay County,10,540,252,288
West Virginia,Clay County,11,596,304,292
West Virginia,Clay County,12,664,313,351
West Virginia,Clay County,13,673,367,306
West Virginia,Clay County,14,582,289,293
West Virginia,Clay County,15,457,235,222
West Virginia,Clay County,16,334,174,160
West Virginia,Clay County,17,213,103,110
West Virginia,Clay County,18,190,70,120
West Virginia,Doddridge County,0,8406,4625,3781
West Virginia,Doddridge County,1,320,158,162
West Virginia,Doddridge County,2,351,190,161
West Virginia,Doddridge County,3,367,188,179
West Virginia,Doddridge County,4,506,325,181
West Virginia,Doddridge County,5,539,356,183
West Virginia,Doddridge County,6,539,332,207
West Virginia,Doddridge County,7,451,260,191
West Virginia,Doddridge County,8,514,294,220
West Virginia,Doddridge County,9,521,296,225
West Virginia,Doddridge County,10,599,328,271
West Virginia,Doddridge County,11,610,337,273
West Virginia,Doddridge County,12,668,334,334
West Virginia,Doddridge County,13,600,304,296
West Virginia,Doddridge County,14,593,286,307
West Virginia,Doddridge County,15,498,274,224
West Virginia,Doddridge County,16,336,162,174
West Virginia,Doddridge County,17,217,111,106
West Virginia,Doddridge County,18,177,90,87
West Virginia,Fayette County,0,43018,21658,21360
West Virginia,Fayette County,1,2276,1173,1103
West Virginia,Fayette County,2,2612,1320,1292
West Virginia,Fayette County,3,2495,1275,1220
West Virginia,Fayette County,4,2431,1298,1133
West Virginia,Fayette County,5,2152,1225,927
West Virginia,Fayette County,6,2495,1288,1207
West Virginia,Fayette County,7,2249,1192,1057
West Virginia,Fayette County,8,2583,1343,1240
West Virginia,Fayette County,9,2672,1377,1295
West Virginia,Fayette County,10,2738,1433,1305
West Virginia,Fayette County,11,2784,1439,1345
West Virginia,Fayette County,12,3046,1497,1549
West Virginia,Fayette County,13,3433,1703,1730
West Virginia,Fayette County,14,3060,1501,1559
West Virginia,Fayette County,15,2268,1100,1168
West Virginia,Fayette County,16,1581,708,873
West Virginia,Fayette County,17,1131,484,647
West Virginia,Fayette County,18,1012,302,710
West Virginia,Gilmer County,0,8026,4798,3228
West Virginia,Gilmer County,1,295,164,131
West Virginia,Gilmer County,2,354,181,173
West Virginia,Gilmer County,3,324,180,144
West Virginia,Gilmer County,4,507,270,237
West Virginia,Gilmer County,5,864,522,342
West Virginia,Gilmer County,6,558,409,149
West Virginia,Gilmer County,7,621,477,144
West Virginia,Gilmer County,8,615,440,175
West Virginia,Gilmer County,9,479,314,165
West Virginia,Gilmer County,10,536,370,166
West Virginia,Gilmer County,11,525,305,220
West Virginia,Gilmer County,12,486,273,213
West Virginia,Gilmer County,13,457,227,230
West Virginia,Gilmer County,14,429,231,198
West Virginia,Gilmer County,15,318,151,167
West Virginia,Gilmer County,16,244,120,124
West Virginia,Gilmer County,17,201,88,113
West Virginia,Gilmer County,18,213,76,137
West Virginia,Grant County,0,11626,5796,5830
West Virginia,Grant County,1,638,320,318
West Virginia,Grant County,2,617,295,322
West Virginia,Grant County,3,604,323,281
West Virginia,Grant County,4,631,345,286
West Virginia,Grant County,5,577,290,287
West Virginia,Grant County,6,672,359,313
West Virginia,Grant County,7,534,265,269
West Virginia,Grant County,8,580,305,275
West Virginia,Grant County,9,655,310,345
West Virginia,Grant County,10,772,402,370
West Virginia,Grant County,11,816,403,413
West Virginia,Grant County,12,851,424,427
West Virginia,Grant County,13,842,427,415
West Virginia,Grant County,14,825,396,429
West Virginia,Grant County,15,785,372,413
West Virginia,Grant County,16,551,278,273
West Virginia,Grant County,17,350,156,194
West Virginia,Grant County,18,326,126,200
West Virginia,Greenbrier County,0,34786,17035,17751
West Virginia,Greenbrier County,1,1799,928,871
West Virginia,Greenbrier County,2,1845,943,902
West Virginia,Greenbrier County,3,1940,965,975
West Virginia,Greenbrier County,4,1793,933,860
West Virginia,Greenbrier County,5,1737,966,771
West Virginia,Greenbrier County,6,1955,942,1013
West Virginia,Greenbrier County,7,1794,905,889
West Virginia,Greenbrier County,8,2017,1017,1000
West Virginia,Greenbrier County,9,2073,1015,1058
West Virginia,Greenbrier County,10,2085,952,1133
West Virginia,Greenbrier County,11,2323,1171,1152
West Virginia,Greenbrier County,12,2611,1296,1315
West Virginia,Greenbrier County,13,2715,1293,1422
West Virginia,Greenbrier County,14,2631,1257,1374
West Virginia,Greenbrier County,15,2090,1023,1067
West Virginia,Greenbrier County,16,1450,655,795
West Virginia,Greenbrier County,17,988,434,554
West Virginia,Greenbrier County,18,940,340,600
West Virginia,Hampshire County,0,23347,11915,11432
West Virginia,Hampshire County,1,1108,561,547
West Virginia,Hampshire County,2,1111,611,500
West Virginia,Hampshire County,3,1287,674,613
West Virginia,Hampshire County,4,1331,695,636
West Virginia,Hampshire County,5,1158,614,544
West Virginia,Hampshire County,6,1298,687,611
West Virginia,Hampshire County,7,1120,581,539
West Virginia,Hampshire County,8,1281,619,662
West Virginia,Hampshire County,9,1327,673,654
West Virginia,Hampshire County,10,1642,817,825
West Virginia,Hampshire County,11,1732,913,819
West Virginia,Hampshire County,12,1861,936,925
West Virginia,Hampshire County,13,1862,943,919
West Virginia,Hampshire County,14,1746,899,847
West Virginia,Hampshire County,15,1498,767,731
West Virginia,Hampshire County,16,947,479,468
West Virginia,Hampshire County,17,546,245,301
West Virginia,Hampshire County,18,492,201,291
West Virginia,Hancock County,0,29094,14177,14917
West Virginia,Hancock County,1,1301,664,637
West Virginia,Hancock County,2,1528,770,758
West Virginia,Hancock County,3,1631,852,779
West Virginia,Hancock County,4,1579,830,749
West Virginia,Hancock County,5,1384,699,685
West Virginia,Hancock County,6,1594,814,780
West Virginia,Hancock County,7,1441,744,697
West Virginia,Hancock County,8,1654,832,822
West Virginia,Hancock County,9,1685,815,870
West Virginia,Hancock County,10,2058,1067,991
West Virginia,Hancock County,11,1896,923,973
West Virginia,Hancock County,12,2318,1142,1176
West Virginia,Hancock County,13,2303,1099,1204
West Virginia,Hancock County,14,2255,1068,1187
West Virginia,Hancock County,15,1557,753,804
West Virginia,Hancock County,16,1132,490,642
West Virginia,Hancock County,17,850,317,533
West Virginia,Hancock County,18,928,298,630
West Virginia,Hardy County,0,13775,6932,6843
West Virginia,Hardy County,1,722,364,358
West Virginia,Hardy County,2,801,399,402
West Virginia,Hardy County,3,823,430,393
West Virginia,Hardy County,4,709,383,326
West Virginia,Hardy County,5,659,326,333
West Virginia,Hardy County,6,754,395,359
West Virginia,Hardy County,7,707,368,339
West Virginia,Hardy County,8,726,379,347
West Virginia,Hardy County,9,837,423,414
West Virginia,Hardy County,10,921,482,439
West Virginia,Hardy County,11,990,497,493
West Virginia,Hardy County,12,1065,522,543
West Virginia,Hardy County,13,1046,515,531
West Virginia,Hardy County,14,976,480,496
West Virginia,Hardy County,15,829,420,409
West Virginia,Hardy County,16,581,275,306
West Virginia,Hardy County,17,375,185,190
West Virginia,Hardy County,18,254,89,165
West Virginia,Harrison County,0,67554,33182,34372
West Virginia,Harrison County,1,3717,1910,1807
West Virginia,Harrison County,2,4084,2156,1928
West Virginia,Harrison County,3,4171,2166,2005
West Virginia,Harrison County,4,3788,1960,1828
West Virginia,Harrison County,5,3606,1825,1781
West Virginia,Harrison County,6,4114,2017,2097
West Virginia,Harrison County,7,3926,1985,1941
West Virginia,Harrison County,8,4282,2128,2154
West Virginia,Harrison County,9,4036,2034,2002
West Virginia,Harrison County,10,4461,2223,2238
West Virginia,Harrison County,11,4473,2243,2230
West Virginia,Harrison County,12,4910,2395,2515
West Virginia,Harrison County,13,4846,2388,2458
West Virginia,Harrison County,14,4164,1958,2206
West Virginia,Harrison County,15,3356,1585,1771
West Virginia,Harrison County,16,2378,1026,1352
West Virginia,Harrison County,17,1576,635,941
West Virginia,Harrison County,18,1666,548,1118
West Virginia,Jackson County,0,28706,14266,14440
West Virginia,Jackson County,1,1536,770,766
West Virginia,Jackson County,2,1645,895,750
West Virginia,Jackson County,3,1824,962,862
West Virginia,Jackson County,4,1653,875,778
West Virginia,Jackson County,5,1519,797,722
West Virginia,Jackson County,6,1603,858,745
West Virginia,Jackson County,7,1495,745,750
West Virginia,Jackson County,8,1674,827,847
West Virginia,Jackson County,9,1646,826,820
West Virginia,Jackson County,10,1924,946,978
West Virginia,Jackson County,11,1990,970,1020
West Virginia,Jackson County,12,2203,1040,1163
West Virginia,Jackson County,13,2138,1081,1057
West Virginia,Jackson County,14,1796,870,926
West Virginia,Jackson County,15,1432,691,741
West Virginia,Jackson County,16,1083,472,611
West Virginia,Jackson County,17,865,382,483
West Virginia,Jackson County,18,680,259,421
West Virginia,Jefferson County,0,56811,28187,28624
West Virginia,Jefferson County,1,3033,1583,1450
West Virginia,Jefferson County,2,3439,1770,1669
West Virginia,Jefferson County,3,3800,1930,1870
West Virginia,Jefferson County,4,3899,2029,1870
West Virginia,Jefferson County,5,3026,1523,1503
West Virginia,Jefferson County,6,3141,1565,1576
West Virginia,Jefferson County,7,3340,1659,1681
West Virginia,Jefferson County,8,3758,1841,1917
West Virginia,Jefferson County,9,3566,1779,1787
West Virginia,Jefferson County,10,4187,2083,2104
West Virginia,Jefferson County,11,4432,2190,2242
West Virginia,Jefferson County,12,4223,2109,2114
West Virginia,Jefferson County,13,3769,1842,1927
West Virginia,Jefferson County,14,3257,1542,1715
West Virginia,Jefferson County,15,2583,1278,1305
West Virginia,Jefferson County,16,1595,753,842
West Virginia,Jefferson County,17,951,407,544
West Virginia,Jefferson County,18,812,304,508
West Virginia,Kanawha County,0,180454,86916,93538
West Virginia,Kanawha County,1,9554,4783,4771
West Virginia,Kanawha County,2,9920,5061,4859
West Virginia,Kanawha County,3,10339,5283,5056
West Virginia,Kanawha County,4,9997,5031,4966
West Virginia,Kanawha County,5,9919,5066,4853
West Virginia,Kanawha County,6,11611,5774,5837
West Virginia,Kanawha County,7,10398,5121,5277
West Virginia,Kanawha County,8,10991,5466,5525
West Virginia,Kanawha County,9,10853,5362,5491
West Virginia,Kanawha County,10,11210,5501,5709
West Virginia,Kanawha County,11,11386,5531,5855
West Virginia,Kanawha County,12,13251,6266,6985
West Virginia,Kanawha County,13,13753,6468,7285
West Virginia,Kanawha County,14,12571,5821,6750
West Virginia,Kanawha County,15,9260,4272,4988
West Virginia,Kanawha County,16,6485,2761,3724
West Virginia,Kanawha County,17,4497,1815,2682
West Virginia,Kanawha County,18,4459,1534,2925
West Virginia,Lewis County,0,16024,7966,8058
West Virginia,Lewis County,1,889,475,414
West Virginia,Lewis County,2,971,476,495
West Virginia,Lewis County,3,976,489,487
West Virginia,Lewis County,4,854,452,402
West Virginia,Lewis County,5,802,425,377
West Virginia,Lewis County,6,960,496,464
West Virginia,Lewis County,7,843,410,433
West Virginia,Lewis County,8,962,469,493
West Virginia,Lewis County,9,968,523,445
West Virginia,Lewis County,10,1055,518,537
West Virginia,Lewis County,11,1130,576,554
West Virginia,Lewis County,12,1170,577,593
West Virginia,Lewis County,13,1138,564,574
West Virginia,Lewis County,14,1064,521,543
West Virginia,Lewis County,15,892,419,473
West Virginia,Lewis County,16,620,273,347
West Virginia,Lewis County,17,400,170,230
West Virginia,Lewis County,18,330,133,197
West Virginia,Lincoln County,0,20599,10205,10394
West Virginia,Lincoln County,1,1169,579,590
West Virginia,Lincoln County,2,1259,614,645
West Virginia,Lincoln County,3,1348,715,633
West Virginia,Lincoln County,4,1163,618,545
West Virginia,Lincoln County,5,1005,504,501
West Virginia,Lincoln County,6,1158,561,597
West Virginia,Lincoln County,7,977,521,456
West Virginia,Lincoln County,8,1247,602,645
West Virginia,Lincoln County,9,1321,659,662
West Virginia,Lincoln County,10,1395,703,692
West Virginia,Lincoln County,11,1458,742,716
West Virginia,Lincoln County,12,1488,725,763
West Virginia,Lincoln County,13,1596,790,806
West Virginia,Lincoln County,14,1380,647,733
West Virginia,Lincoln County,15,1023,517,506
West Virginia,Lincoln County,16,755,361,394
West Virginia,Lincoln County,17,507,214,293
West Virginia,Lincoln County,18,350,133,217
West Virginia,Logan County,0,32607,16105,16502
West Virginia,Logan County,1,1760,876,884
West Virginia,Logan County,2,1889,991,898
West Virginia,Logan County,3,1830,941,889
West Virginia,Logan County,4,1823,919,904
West Virginia,Logan County,5,1693,885,808
West Virginia,Logan County,6,1966,1039,927
West Virginia,Logan County,7,1684,860,824
West Virginia,Logan County,8,1956,997,959
West Virginia,Logan County,9,2235,1142,1093
West Virginia,Logan County,10,2228,1133,1095
West Virginia,Logan County,11,2095,1049,1046
West Virginia,Logan County,12,2169,1023,1146
West Virginia,Logan County,13,2678,1282,1396
West Virginia,Logan County,14,2487,1202,1285
West Virginia,Logan County,15,1706,792,914
West Virginia,Logan County,16,1060,479,581
West Virginia,Logan County,17,766,280,486
West Virginia,Logan County,18,582,215,367
West Virginia,McDowell County,0,18223,8917,9306
West Virginia,McDowell County,1,980,484,496
West Virginia,McDowell County,2,1110,538,572
West Virginia,McDowell County,3,1035,567,468
West Virginia,McDowell County,4,926,469,457
West Virginia,McDowell County,5,804,416,388
West Virginia,McDowell County,6,1044,525,519
West Virginia,McDowell County,7,951,502,449
West Virginia,McDowell County,8,935,451,484
West Virginia,McDowell County,9,1128,595,533
West Virginia,McDowell County,10,1137,562,575
West Virginia,McDowell County,11,1201,593,608
West Virginia,McDowell County,12,1367,612,755
West Virginia,McDowell County,13,1641,783,858
West Virginia,McDowell County,14,1352,673,679
West Virginia,McDowell County,15,1027,506,521
West Virginia,McDowell County,16,656,297,359
West Virginia,McDowell County,17,510,197,313
West Virginia,McDowell County,18,419,147,272
West Virginia,Marion County,0,56097,27692,28405
West Virginia,Marion County,1,3107,1592,1515
West Virginia,Marion County,2,3168,1560,1608
West Virginia,Marion County,3,3039,1589,1450
West Virginia,Marion County,4,3672,1945,1727
West Virginia,Marion County,5,4544,2289,2255
West Virginia,Marion County,6,3477,1759,1718
West Virginia,Marion County,7,3070,1582,1488
West Virginia,Marion County,8,3411,1712,1699
West Virginia,Marion County,9,3230,1643,1587
West Virginia,Marion County,10,3544,1732,1812
West Virginia,Marion County,11,3469,1762,1707
West Virginia,Marion County,12,3507,1663,1844
West Virginia,Marion County,13,3896,1954,1942
West Virginia,Marion County,14,3508,1742,1766
West Virginia,Marion County,15,2792,1243,1549
West Virginia,Marion County,16,1964,886,1078
West Virginia,Marion County,17,1364,577,787
West Virginia,Marion County,18,1335,462,873
West Virginia,Marshall County,0,30785,15262,15523
West Virginia,Marshall County,1,1505,757,748
West Virginia,Marshall County,2,1660,872,788
West Virginia,Marshall County,3,1682,853,829
West Virginia,Marshall County,4,1660,829,831
West Virginia,Marshall County,5,1560,822,738
West Virginia,Marshall County,6,1936,1011,925
West Virginia,Marshall County,7,1577,825,752
West Virginia,Marshall County,8,1631,825,806
West Virginia,Marshall County,9,1786,927,859
West Virginia,Marshall County,10,2031,1023,1008
West Virginia,Marshall County,11,2075,1054,1021
West Virginia,Marshall County,12,2338,1128,1210
West Virginia,Marshall County,13,2458,1221,1237
West Virginia,Marshall County,14,2329,1116,1213
West Virginia,Marshall County,15,1825,879,946
West Virginia,Marshall County,16,1165,508,657
West Virginia,Marshall County,17,792,332,460
West Virginia,Marshall County,18,775,280,495
West Virginia,Mason County,0,26718,12925,13793
West Virginia,Mason County,1,1429,756,673
West Virginia,Mason County,2,1507,797,710
West Virginia,Mason County,3,1699,865,834
West Virginia,Mason County,4,1438,755,683
West Virginia,Mason County,5,1363,699,664
West Virginia,Mason County,6,1572,728,844
West Virginia,Mason County,7,1364,600,764
West Virginia,Mason County,8,1667,795,872
West Virginia,Mason County,9,1574,748,826
West Virginia,Mason County,10,1697,849,848
West Virginia,Mason County,11,1680,808,872
West Virginia,Mason County,12,2032,992,1040
West Virginia,Mason County,13,2113,992,1121
West Virginia,Mason County,14,1760,859,901
West Virginia,Mason County,15,1442,694,748
West Virginia,Mason County,16,1011,466,545
West Virginia,Mason County,17,725,296,429
West Virginia,Mason County,18,645,226,419
West Virginia,Mercer County,0,59131,28395,30736
West Virginia,Mercer County,1,3383,1729,1654
West Virginia,Mercer County,2,3505,1838,1667
West Virginia,Mercer County,3,3283,1682,1601
West Virginia,Mercer County,4,3379,1700,1679
West Virginia,Mercer County,5,3434,1780,1654
West Virginia,Mercer County,6,3815,1846,1969
West Virginia,Mercer County,7,3096,1554,1542
West Virginia,Mercer County,8,3308,1558,1750
West Virginia,Mercer County,9,3427,1663,1764
West Virginia,Mercer County,10,3685,1792,1893
West Virginia,Mercer County,11,3561,1729,1832
West Virginia,Mercer County,12,3882,1803,2079
West Virginia,Mercer County,13,4367,1992,2375
West Virginia,Mercer County,14,4278,1963,2315
West Virginia,Mercer County,15,3344,1588,1756
West Virginia,Mercer County,16,2337,1077,1260
West Virginia,Mercer County,17,1522,631,891
West Virginia,Mercer County,18,1525,470,1055
West Virginia,Mineral County,0,26940,13403,13537
West Virginia,Mineral County,1,1406,698,708
West Virginia,Mineral County,2,1493,775,718
West Virginia,Mineral County,3,1494,807,687
West Virginia,Mineral County,4,1779,958,821
West Virginia,Mineral County,5,1451,751,700
West Virginia,Mineral County,6,1688,903,785
West Virginia,Mineral County,7,1413,726,687
West Virginia,Mineral County,8,1480,756,724
West Virginia,Mineral County,9,1445,718,727
West Virginia,Mineral County,10,1805,900,905
West Virginia,Mineral County,11,1885,945,940
West Virginia,Mineral County,12,1928,922,1006
West Virginia,Mineral County,13,1832,847,985
West Virginia,Mineral County,14,1830,850,980
West Virginia,Mineral County,15,1635,785,850
West Virginia,Mineral County,16,1156,542,614
West Virginia,Mineral County,17,703,317,386
West Virginia,Mineral County,18,517,203,314
West Virginia,Mingo County,0,23785,11724,12061
West Virginia,Mingo County,1,1424,716,708
West Virginia,Mingo County,2,1468,771,697
West Virginia,Mingo County,3,1476,764,712
West Virginia,Mingo County,4,1389,743,646
West Virginia,Mingo County,5,1090,553,537
West Virginia,Mingo County,6,1364,662,702
West Virginia,Mingo County,7,1265,603,662
West Virginia,Mingo County,8,1476,695,781
West Virginia,Mingo County,9,1501,771,730
West Virginia,Mingo County,10,1562,785,777
West Virginia,Mingo County,11,1659,793,866
West Virginia,Mingo County,12,1745,848,897
West Virginia,Mingo County,13,1864,910,954
West Virginia,Mingo County,14,1720,820,900
West Virginia,Mingo County,15,1200,597,603
West Virginia,Mingo County,16,742,376,366
West Virginia,Mingo County,17,467,181,286
West Virginia,Mingo County,18,373,136,237
West Virginia,Monongalia County,0,106420,54938,51482
West Virginia,Monongalia County,1,5301,2752,2549
West Virginia,Monongalia County,2,4902,2559,2343
West Virginia,Monongalia County,3,4520,2346,2174
West Virginia,Monongalia County,4,8620,4557,4063
West Virginia,Monongalia County,5,16274,8547,7727
West Virginia,Monongalia County,6,10018,5496,4522
West Virginia,Monongalia County,7,8143,4462,3681
West Virginia,Monongalia County,8,7171,3888,3283
West Virginia,Monongalia County,9,5669,2977,2692
West Virginia,Monongalia County,10,5591,2927,2664
West Virginia,Monongalia County,11,5498,2735,2763
West Virginia,Monongalia County,12,5721,2828,2893
West Virginia,Monongalia County,13,5544,2692,2852
West Virginia,Monongalia County,14,4919,2458,2461
West Virginia,Monongalia County,15,3328,1614,1714
West Virginia,Monongalia County,16,2159,992,1167
West Virginia,Monongalia County,17,1406,562,844
West Virginia,Monongalia County,18,1636,546,1090
West Virginia,Monroe County,0,13280,6638,6642
West Virginia,Monroe County,1,608,309,299
West Virginia,Monroe County,2,732,372,360
West Virginia,Monroe County,3,789,429,360
West Virginia,Monroe County,4,737,380,357
West Virginia,Monroe County,5,566,298,268
West Virginia,Monroe County,6,673,332,341
West Virginia,Monroe County,7,670,361,309
West Virginia,Monroe County,8,705,360,345
West Virginia,Monroe County,9,719,362,357
West Virginia,Monroe County,10,847,415,432
West Virginia,Monroe County,11,936,460,476
West Virginia,Monroe County,12,978,469,509
West Virginia,Monroe County,13,1001,538,463
West Virginia,Monroe County,14,967,447,520
West Virginia,Monroe County,15,924,442,482
West Virginia,Monroe County,16,701,353,348
West Virginia,Monroe County,17,359,170,189
West Virginia,Monroe County,18,368,141,227
West Virginia,Morgan County,0,17787,8914,8873
West Virginia,Morgan County,1,727,378,349
West Virginia,Morgan County,2,883,442,441
West Virginia,Morgan County,3,940,504,436
West Virginia,Morgan County,4,1001,525,476
West Virginia,Morgan County,5,900,469,431
West Virginia,Morgan County,6,945,471,474
West Virginia,Morgan County,7,849,420,429
West Virginia,Morgan County,8,937,477,460
West Virginia,Morgan County,9,985,493,492
West Virginia,Morgan County,10,1198,631,567
West Virginia,Morgan County,11,1394,724,670
West Virginia,Morgan County,12,1458,742,716
West Virginia,Morgan County,13,1463,691,772
West Virginia,Morgan County,14,1440,708,732
West Virginia,Morgan County,15,1039,514,525
West Virginia,Morgan County,16,764,357,407
West Virginia,Morgan County,17,488,222,266
West Virginia,Morgan County,18,376,146,230
West Virginia,Nicholas County,0,24842,12215,12627
West Virginia,Nicholas County,1,1311,647,664
West Virginia,Nicholas County,2,1467,757,710
West Virginia,Nicholas County,3,1510,766,744
West Virginia,Nicholas County,4,1254,661,593
West Virginia,Nicholas County,5,1154,611,543
West Virginia,Nicholas County,6,1462,734,728
West Virginia,Nicholas County,7,1290,653,637
West Virginia,Nicholas County,8,1379,663,716
West Virginia,Nicholas County,9,1431,686,745
West Virginia,Nicholas County,10,1630,800,830
West Virginia,Nicholas County,11,1663,809,854
West Virginia,Nicholas County,12,1832,892,940
West Virginia,Nicholas County,13,1906,902,1004
West Virginia,Nicholas County,14,1860,906,954
West Virginia,Nicholas County,15,1484,764,720
West Virginia,Nicholas County,16,1023,463,560
West Virginia,Nicholas County,17,669,317,352
West Virginia,Nicholas County,18,517,184,333
West Virginia,Ohio County,0,41755,20148,21607
West Virginia,Ohio County,1,2091,1064,1027
West Virginia,Ohio County,2,2198,1119,1079
West Virginia,Ohio County,3,2288,1161,1127
West Virginia,Ohio County,4,2750,1345,1405
West Virginia,Ohio County,5,2854,1400,1454
West Virginia,Ohio County,6,2445,1281,1164
West Virginia,Ohio County,7,2336,1176,1160
West Virginia,Ohio County,8,2364,1201,1163
West Virginia,Ohio County,9,2221,1153,1068
West Virginia,Ohio County,10,2447,1197,1250
West Virginia,Ohio County,11,2470,1211,1259
West Virginia,Ohio County,12,2975,1397,1578
West Virginia,Ohio County,13,3211,1577,1634
West Virginia,Ohio County,14,2930,1342,1588
West Virginia,Ohio County,15,2112,1013,1099
West Virginia,Ohio County,16,1540,668,872
West Virginia,Ohio County,17,1090,427,663
West Virginia,Ohio County,18,1433,416,1017
West Virginia,Pendleton County,0,6997,3539,3458
West Virginia,Pendleton County,1,341,183,158
West Virginia,Pendleton County,2,361,179,182
West Virginia,Pendleton County,3,345,170,175
West Virginia,Pendleton County,4,346,173,173
West Virginia,Pendleton County,5,299,161,138
West Virginia,Pendleton County,6,377,199,178
West Virginia,Pendleton County,7,303,155,148
West Virginia,Pendleton County,8,355,191,164
West Virginia,Pendleton County,9,340,182,158
West Virginia,Pendleton County,10,375,196,179
West Virginia,Pendleton County,11,474,237,237
West Virginia,Pendleton County,12,556,285,271
West Virginia,Pendleton County,13,631,318,313
West Virginia,Pendleton County,14,540,257,283
West Virginia,Pendleton County,15,463,246,217
West Virginia,Pendleton County,16,358,149,209
West Virginia,Pendleton County,17,247,118,129
West Virginia,Pendleton County,18,286,140,146
West Virginia,Pleasants County,0,7507,4083,3424
West Virginia,Pleasants County,1,373,207,166
West Virginia,Pleasants County,2,353,191,162
West Virginia,Pleasants County,3,417,215,202
West Virginia,Pleasants County,4,412,214,198
West Virginia,Pleasants County,5,451,270,181
West Virginia,Pleasants County,6,498,307,191
West Virginia,Pleasants County,7,431,269,162
West Virginia,Pleasants County,8,493,288,205
West Virginia,Pleasants County,9,488,290,198
West Virginia,Pleasants County,10,523,283,240
West Virginia,Pleasants County,11,574,314,260
West Virginia,Pleasants County,12,563,299,264
West Virginia,Pleasants County,13,495,252,243
West Virginia,Pleasants County,14,451,225,226
West Virginia,Pleasants County,15,399,200,199
West Virginia,Pleasants County,16,275,138,137
West Virginia,Pleasants County,17,168,80,88
West Virginia,Pleasants County,18,143,41,102
West Virginia,Pocahontas County,0,8414,4313,4101
West Virginia,Pocahontas County,1,411,199,212
West Virginia,Pocahontas County,2,421,206,215
West Virginia,Pocahontas County,3,394,190,204
West Virginia,Pocahontas County,4,376,207,169
West Virginia,Pocahontas County,5,384,200,184
West Virginia,Pocahontas County,6,483,253,230
West Virginia,Pocahontas County,7,442,254,188
West Virginia,Pocahontas County,8,443,238,205
West Virginia,Pocahontas County,9,464,241,223
West Virginia,Pocahontas County,10,480,259,221
West Virginia,Pocahontas County,11,582,299,283
West Virginia,Pocahontas County,12,704,365,339
West Virginia,Pocahontas County,13,708,373,335
West Virginia,Pocahontas County,14,670,325,345
West Virginia,Pocahontas County,15,551,279,272
West Virginia,Pocahontas County,16,412,222,190
West Virginia,Pocahontas County,17,268,136,132
West Virginia,Pocahontas County,18,221,67,154
West Virginia,Preston County,0,33839,17367,16472
West Virginia,Preston County,1,1712,847,865
West Virginia,Preston County,2,1861,1021,840
West Virginia,Preston County,3,1854,958,896
West Virginia,Preston County,4,1609,794,815
West Virginia,Preston County,5,1786,957,829
West Virginia,Preston County,6,2341,1291,1050
West Virginia,Preston County,7,2212,1189,1023
West Virginia,Preston County,8,2145,1106,1039
West Virginia,Preston County,9,2177,1187,990
West Virginia,Preston County,10,2218,1186,1032
West Virginia,Preston County,11,2364,1237,1127
West Virginia,Preston County,12,2417,1275,1142
West Virginia,Preston County,13,2365,1155,1210
West Virginia,Preston County,14,2381,1149,1232
West Virginia,Preston County,15,1716,845,871
West Virginia,Preston County,16,1244,580,664
West Virginia,Preston County,17,764,352,412
West Virginia,Preston County,18,673,238,435
West Virginia,Putnam County,0,56682,27871,28811
West Virginia,Putnam County,1,3032,1576,1456
West Virginia,Putnam County,2,3446,1750,1696
West Virginia,Putnam County,3,3757,1925,1832
West Virginia,Putnam County,4,3562,1829,1733
West Virginia,Putnam County,5,2799,1435,1364
West Virginia,Putnam County,6,3065,1540,1525
West Virginia,Putnam County,7,3242,1636,1606
West Virginia,Putnam County,8,3747,1828,1919
West Virginia,Putnam County,9,3791,1845,1946
West Virginia,Putnam County,10,4027,1997,2030
West Virginia,Putnam County,11,3856,1935,1921
West Virginia,Putnam County,12,3986,1929,2057
West Virginia,Putnam County,13,3984,1971,2013
West Virginia,Putnam County,14,3474,1637,1837
West Virginia,Putnam County,15,2731,1283,1448
West Virginia,Putnam County,16,1983,912,1071
West Virginia,Putnam County,17,1241,516,725
West Virginia,Putnam County,18,959,327,632
West Virginia,Raleigh County,0,74254,37223,37031
West Virginia,Raleigh County,1,3991,2046,1945
West Virginia,Raleigh County,2,4474,2264,2210
West Virginia,Raleigh County,3,4475,2262,2213
West Virginia,Raleigh County,4,3964,2074,1890
West Virginia,Raleigh County,5,3995,2151,1844
West Virginia,Raleigh County,6,4712,2557,2155
West Virginia,Raleigh County,7,4412,2415,1997
West Virginia,Raleigh County,8,4618,2375,2243
West Virginia,Raleigh County,9,4860,2547,2313
West Virginia,Raleigh County,10,4852,2557,2295
West Virginia,Raleigh County,11,4311,2202,2109
West Virginia,Raleigh County,12,4771,2246,2525
West Virginia,Raleigh County,13,5502,2615,2887
West Virginia,Raleigh County,14,5146,2535,2611
West Virginia,Raleigh County,15,4054,1894,2160
West Virginia,Raleigh County,16,2529,1158,1371
West Virginia,Raleigh County,17,1763,706,1057
West Virginia,Raleigh County,18,1825,619,1206
West Virginia,Randolph County,0,28823,14916,13907
West Virginia,Randolph County,1,1455,756,699
West Virginia,Randolph County,2,1487,721,766
West Virginia,Randolph County,3,1528,795,733
West Virginia,Randolph County,4,1612,867,745
West Virginia,Randolph County,5,1702,971,731
West Virginia,Randolph County,6,1884,1061,823
West Virginia,Randolph County,7,1662,931,731
West Virginia,Randolph County,8,1678,953,725
West Virginia,Randolph County,9,1586,822,764
West Virginia,Randolph County,10,1835,977,858
West Virginia,Randolph County,11,1935,1020,915
West Virginia,Randolph County,12,2116,1071,1045
West Virginia,Randolph County,13,2036,1045,991
West Virginia,Randolph County,14,1965,917,1048
West Virginia,Randolph County,15,1655,828,827
West Virginia,Randolph County,16,1228,562,666
West Virginia,Randolph County,17,732,369,363
West Virginia,Randolph County,18,727,250,477
West Virginia,Ritchie County,0,9721,4862,4859
West Virginia,Ritchie County,1,489,245,244
West Virginia,Ritchie County,2,510,264,246
West Virginia,Ritchie County,3,572,288,284
West Virginia,Ritchie County,4,521,275,246
West Virginia,Ritchie County,5,457,231,226
West Virginia,Ritchie County,6,556,297,259
West Virginia,Ritchie County,7,408,203,205
West Virginia,Ritchie County,8,567,287,280
West Virginia,Ritchie County,9,529,246,283
West Virginia,Ritchie County,10,650,318,332
West Virginia,Ritchie County,11,704,351,353
West Virginia,Ritchie County,12,796,420,376
West Virginia,Ritchie County,13,767,402,365
West Virginia,Ritchie County,14,711,353,358
West Virginia,Ritchie County,15,575,282,293
West Virginia,Ritchie County,16,382,174,208
West Virginia,Ritchie County,17,286,139,147
West Virginia,Ritchie County,18,241,87,154
West Virginia,Roane County,0,13932,6874,7058
West Virginia,Roane County,1,657,327,330
West Virginia,Roane County,2,779,367,412
West Virginia,Roane County,3,904,446,458
West Virginia,Roane County,4,834,423,411
West Virginia,Roane County,5,606,337,269
West Virginia,Roane County,6,765,398,367
West Virginia,Roane County,7,645,313,332
West Virginia,Roane County,8,747,385,362
West Virginia,Roane County,9,863,414,449
West Virginia,Roane County,10,926,450,476
West Virginia,Roane County,11,910,467,443
West Virginia,Roane County,12,1104,538,566
West Virginia,Roane County,13,1138,578,560
West Virginia,Roane County,14,1032,492,540
West Virginia,Roane County,15,794,421,373
West Virginia,Roane County,16,555,250,305
West Virginia,Roane County,17,354,166,188
West Virginia,Roane County,18,319,102,217
West Virginia,Summers County,0,12760,5759,7001
West Virginia,Summers County,1,515,266,249
West Virginia,Summers County,2,545,238,307
West Virginia,Summers County,3,616,320,296
West Virginia,Summers County,4,627,294,333
West Virginia,Summers County,5,576,271,305
West Virginia,Summers County,6,742,293,449
West Virginia,Summers County,7,627,235,392
West Virginia,Summers County,8,753,297,456
West Virginia,Summers County,9,825,357,468
West Virginia,Summers County,10,847,384,463
West Virginia,Summers County,11,836,366,470
West Virginia,Summers County,12,992,427,565
West Virginia,Summers County,13,1082,511,571
West Virginia,Summers County,14,1077,563,514
West Virginia,Summers County,15,792,392,400
West Virginia,Summers County,16,546,229,317
West Virginia,Summers County,17,397,173,224
West Virginia,Summers County,18,365,143,222
West Virginia,Taylor County,0,16862,8556,8306
West Virginia,Taylor County,1,889,422,467
West Virginia,Taylor County,2,966,511,455
West Virginia,Taylor County,3,948,505,443
West Virginia,Taylor County,4,887,466,421
West Virginia,Taylor County,5,796,425,371
West Virginia,Taylor County,6,1076,592,484
West Virginia,Taylor County,7,992,553,439
West Virginia,Taylor County,8,1049,546,503
West Virginia,Taylor County,9,1066,544,522
West Virginia,Taylor County,10,1114,565,549
West Virginia,Taylor County,11,1225,616,609
West Virginia,Taylor County,12,1236,650,586
West Virginia,Taylor County,13,1207,591,616
West Virginia,Taylor County,14,1135,559,576
West Virginia,Taylor County,15,835,412,423
West Virginia,Taylor County,16,630,284,346
West Virginia,Taylor County,17,411,174,237
West Virginia,Taylor County,18,400,141,259
West Virginia,Tucker County,0,6955,3554,3401
West Virginia,Tucker County,1,294,157,137
West Virginia,Tucker County,2,273,148,125
West Virginia,Tucker County,3,272,129,143
West Virginia,Tucker County,4,398,261,137
West Virginia,Tucker County,5,296,155,141
West Virginia,Tucker County,6,411,216,195
West Virginia,Tucker County,7,309,150,159
West Virginia,Tucker County,8,405,195,210
West Virginia,Tucker County,9,372,189,183
West Virginia,Tucker County,10,446,228,218
West Virginia,Tucker County,11,548,272,276
West Virginia,Tucker County,12,555,277,278
West Virginia,Tucker County,13,555,282,273
West Virginia,Tucker County,14,575,289,286
West Virginia,Tucker County,15,475,239,236
West Virginia,Tucker County,16,336,169,167
West Virginia,Tucker County,17,240,120,120
West Virginia,Tucker County,18,195,78,117
West Virginia,Tyler County,0,8746,4398,4348
West Virginia,Tyler County,1,444,234,210
West Virginia,Tyler County,2,462,245,217
West Virginia,Tyler County,3,506,247,259
West Virginia,Tyler County,4,493,262,231
West Virginia,Tyler County,5,402,212,190
West Virginia,Tyler County,6,490,236,254
West Virginia,Tyler County,7,383,197,186
West Virginia,Tyler County,8,444,225,219
West Virginia,Tyler County,9,483,241,242
West Virginia,Tyler County,10,635,331,304
West Virginia,Tyler County,11,612,323,289
West Virginia,Tyler County,12,678,323,355
West Virginia,Tyler County,13,733,354,379
West Virginia,Tyler County,14,649,349,300
West Virginia,Tyler County,15,505,244,261
West Virginia,Tyler County,16,349,171,178
West Virginia,Tyler County,17,244,103,141
West Virginia,Tyler County,18,234,101,133
West Virginia,Upshur County,0,24415,12106,12309
West Virginia,Upshur County,1,1311,670,641
West Virginia,Upshur County,2,1405,735,670
West Virginia,Upshur County,3,1459,726,733
West Virginia,Upshur County,4,1660,826,834
West Virginia,Upshur County,5,1784,849,935
West Virginia,Upshur County,6,1446,743,703
West Virginia,Upshur County,7,1324,664,660
West Virginia,Upshur County,8,1384,678,706
West Virginia,Upshur County,9,1303,685,618
West Virginia,Upshur County,10,1516,781,735
West Virginia,Upshur County,11,1551,755,796
West Virginia,Upshur County,12,1594,780,814
West Virginia,Upshur County,13,1712,846,866
West Virginia,Upshur County,14,1607,790,817
West Virginia,Upshur County,15,1272,647,625
West Virginia,Upshur County,16,985,462,523
West Virginia,Upshur County,17,600,284,316
West Virginia,Upshur County,18,502,185,317
West Virginia,Wayne County,0,39944,19527,20417
West Virginia,Wayne County,1,2075,1066,1009
West Virginia,Wayne County,2,2163,1070,1093
West Virginia,Wayne County,3,2422,1254,1168
West Virginia,Wayne County,4,2355,1188,1167
West Virginia,Wayne County,5,2108,1129,979
West Virginia,Wayne County,6,2475,1255,1220
West Virginia,Wayne County,7,1933,946,987
West Virginia,Wayne County,8,2386,1134,1252
West Virginia,Wayne County,9,2385,1132,1253
West Virginia,Wayne County,10,2762,1362,1400
West Virginia,Wayne County,11,2683,1335,1348
West Virginia,Wayne County,12,2892,1376,1516
West Virginia,Wayne County,13,2891,1404,1487
West Virginia,Wayne County,14,2641,1250,1391
West Virginia,Wayne County,15,2224,1056,1168
West Virginia,Wayne County,16,1549,713,836
West Virginia,Wayne County,17,1048,494,554
West Virginia,Wayne County,18,952,363,589
West Virginia,Webster County,0,8285,4145,4140
West Virginia,Webster County,1,393,204,189
West Virginia,Webster County,2,482,233,249
West Virginia,Webster County,3,465,248,217
West Virginia,Webster County,4,471,253,218
West Virginia,Webster County,5,366,192,174
West Virginia,Webster County,6,456,226,230
West Virginia,Webster County,7,379,201,178
West Virginia,Webster County,8,423,208,215
West Virginia,Webster County,9,463,236,227
West Virginia,Webster County,10,553,278,275
West Virginia,Webster County,11,574,294,280
West Virginia,Webster County,12,636,305,331
West Virginia,Webster County,13,700,340,360
West Virginia,Webster County,14,649,313,336
West Virginia,Webster County,15,519,272,247
West Virginia,Webster County,16,329,168,161
West Virginia,Webster County,17,223,105,118
West Virginia,Webster County,18,204,69,135
West Virginia,Wetzel County,0,15270,7498,7772
West Virginia,Wetzel County,1,814,420,394
West Virginia,Wetzel County,2,785,391,394
West Virginia,Wetzel County,3,911,465,446
West Virginia,Wetzel County,4,825,431,394
West Virginia,Wetzel County,5,857,441,416
West Virginia,Wetzel County,6,872,448,424
West Virginia,Wetzel County,7,708,375,333
West Virginia,Wetzel County,8,819,404,415
West Virginia,Wetzel County,9,807,386,421
West Virginia,Wetzel County,10,1034,503,531
West Virginia,Wetzel County,11,1009,499,510
West Virginia,Wetzel County,12,1204,607,597
West Virginia,Wetzel County,13,1105,536,569
West Virginia,Wetzel County,14,1019,517,502
West Virginia,Wetzel County,15,885,412,473
West Virginia,Wetzel County,16,712,291,421
West Virginia,Wetzel County,17,491,243,248
West Virginia,Wetzel County,18,413,129,284
West Virginia,Wirt County,0,5830,2969,2861
West Virginia,Wirt County,1,290,143,147
West Virginia,Wirt County,2,361,185,176
West Virginia,Wirt County,3,388,217,171
West Virginia,Wirt County,4,309,164,145
West Virginia,Wirt County,5,261,146,115
West Virginia,Wirt County,6,287,139,148
West Virginia,Wirt County,7,318,161,157
West Virginia,Wirt County,8,317,151,166
West Virginia,Wirt County,9,352,170,182
West Virginia,Wirt County,10,368,176,192
West Virginia,Wirt County,11,409,203,206
West Virginia,Wirt County,12,490,233,257
West Virginia,Wirt County,13,500,265,235
West Virginia,Wirt County,14,381,189,192
West Virginia,Wirt County,15,328,191,137
West Virginia,Wirt County,16,230,118,112
West Virginia,Wirt County,17,148,86,62
West Virginia,Wirt County,18,93,32,61
West Virginia,Wood County,0,84203,40905,43298
West Virginia,Wood County,1,4756,2422,2334
West Virginia,Wood County,2,4756,2416,2340
West Virginia,Wood County,3,5055,2571,2484
West Virginia,Wood County,4,4742,2462,2280
West Virginia,Wood County,5,4467,2222,2245
West Virginia,Wood County,6,5075,2532,2543
West Virginia,Wood County,7,4560,2269,2291
West Virginia,Wood County,8,5085,2496,2589
West Virginia,Wood County,9,4920,2448,2472
West Virginia,Wood County,10,5508,2766,2742
West Virginia,Wood County,11,5709,2808,2901
West Virginia,Wood County,12,6254,3000,3254
West Virginia,Wood County,13,6107,2924,3183
West Virginia,Wood County,14,5384,2482,2902
West Virginia,Wood County,15,4435,2059,2376
West Virginia,Wood County,16,3316,1469,1847
West Virginia,Wood County,17,2164,919,1245
West Virginia,Wood County,18,1910,640,1270
West Virginia,Wyoming County,0,20786,10274,10512
West Virginia,Wyoming County,1,992,509,483
West Virginia,Wyoming County,2,1161,609,552
West Virginia,Wyoming County,3,1261,649,612
West Virginia,Wyoming County,4,1219,614,605
West Virginia,Wyoming County,5,1059,541,518
West Virginia,Wyoming County,6,1159,578,581
West Virginia,Wyoming County,7,1013,513,500
West Virginia,Wyoming County,8,1103,537,566
West Virginia,Wyoming County,9,1446,677,769
West Virginia,Wyoming County,10,1383,710,673
West Virginia,Wyoming County,11,1349,665,684
West Virginia,Wyoming County,12,1463,720,743
West Virginia,Wyoming County,13,1767,864,903
West Virginia,Wyoming County,14,1698,830,868
West Virginia,Wyoming County,15,1135,578,557
West Virginia,Wyoming County,16,710,332,378
West Virginia,Wyoming County,17,478,204,274
West Virginia,Wyoming County,18,390,144,246
Wisconsin,Adams County,0,20348,10925,9423
Wisconsin,Adams County,1,693,355,338
Wisconsin,Adams County,2,768,387,381
Wisconsin,Adams County,3,924,468,456
Wisconsin,Adams County,4,871,466,405
Wisconsin,Adams County,5,805,470,335
Wisconsin,Adams County,6,952,604,348
Wisconsin,Adams County,7,1006,653,353
Wisconsin,Adams County,8,971,577,394
Wisconsin,Adams County,9,986,584,402
Wisconsin,Adams County,10,1099,608,491
Wisconsin,Adams County,11,1414,742,672
Wisconsin,Adams County,12,1893,953,940
Wisconsin,Adams County,13,2043,1084,959
Wisconsin,Adams County,14,1942,974,968
Wisconsin,Adams County,15,1579,818,761
Wisconsin,Adams County,16,1200,630,570
Wisconsin,Adams County,17,683,326,357
Wisconsin,Adams County,18,519,226,293
Wisconsin,Ashland County,0,15600,7818,7782
Wisconsin,Ashland County,1,880,430,450
Wisconsin,Ashland County,2,906,480,426
Wisconsin,Ashland County,3,1021,527,494
Wisconsin,Ashland County,4,1083,560,523
Wisconsin,Ashland County,5,1011,535,476
Wisconsin,Ashland County,6,796,439,357
Wisconsin,Ashland County,7,832,421,411
Wisconsin,Ashland County,8,932,463,469
Wisconsin,Ashland County,9,821,421,400
Wisconsin,Ashland County,10,822,402,420
Wisconsin,Ashland County,11,974,512,462
Wisconsin,Ashland County,12,1244,576,668
Wisconsin,Ashland County,13,1223,618,605
Wisconsin,Ashland County,14,1078,546,532
Wisconsin,Ashland County,15,753,358,395
Wisconsin,Ashland County,16,506,253,253
Wisconsin,Ashland County,17,348,165,183
Wisconsin,Ashland County,18,370,112,258
Wisconsin,Barron County,0,45164,22628,22536
Wisconsin,Barron County,1,2462,1240,1222
Wisconsin,Barron County,2,2739,1409,1330
Wisconsin,Barron County,3,2857,1423,1434
Wisconsin,Barron County,4,2566,1323,1243
Wisconsin,Barron County,5,2264,1189,1075
Wisconsin,Barron County,6,2442,1303,1139
Wisconsin,Barron County,7,2393,1231,1162
Wisconsin,Barron County,8,2676,1371,1305
Wisconsin,Barron County,9,2328,1216,1112
Wisconsin,Barron County,10,2684,1368,1316
Wisconsin,Barron County,11,2809,1406,1403
Wisconsin,Barron County,12,3615,1855,1760
Wisconsin,Barron County,13,3421,1714,1707
Wisconsin,Barron County,14,3086,1534,1552
Wisconsin,Barron County,15,2573,1276,1297
Wisconsin,Barron County,16,1793,831,962
Wisconsin,Barron County,17,1213,519,694
Wisconsin,Barron County,18,1243,420,823
Wisconsin,Bayfield County,0,15042,7660,7382
Wisconsin,Bayfield County,1,677,341,336
Wisconsin,Bayfield County,2,666,359,307
Wisconsin,Bayfield County,3,750,384,366
Wisconsin,Bayfield County,4,764,402,362
Wisconsin,Bayfield County,5,613,333,280
Wisconsin,Bayfield County,6,587,305,282
Wisconsin,Bayfield County,7,651,334,317
Wisconsin,Bayfield County,8,694,344,350
Wisconsin,Bayfield County,9,708,360,348
Wisconsin,Bayfield County,10,823,404,419
Wisconsin,Bayfield County,11,1075,550,525
Wisconsin,Bayfield County,12,1295,636,659
Wisconsin,Bayfield County,13,1570,778,792
Wisconsin,Bayfield County,14,1448,735,713
Wisconsin,Bayfield County,15,1130,590,540
Wisconsin,Bayfield County,16,752,378,374
Wisconsin,Bayfield County,17,444,236,208
Wisconsin,Bayfield County,18,395,191,204
Wisconsin,Brown County,0,263378,130577,132801
Wisconsin,Brown County,1,16897,8511,8386
Wisconsin,Brown County,2,17403,8927,8476
Wisconsin,Brown County,3,17820,9075,8745
Wisconsin,Brown County,4,17544,8746,8798
Wisconsin,Brown County,5,17104,8573,8531
Wisconsin,Brown County,6,17995,9263,8732
Wisconsin,Brown County,7,17791,9079,8712
Wisconsin,Brown County,8,17672,9057,8615
Wisconsin,Brown County,9,15548,7817,7731
Wisconsin,Brown County,10,15991,8018,7973
Wisconsin,Brown County,11,17669,8816,8853
Wisconsin,Brown County,12,18579,9193,9386
Wisconsin,Brown County,13,16232,7904,8328
Wisconsin,Brown County,14,13584,6605,6979
Wisconsin,Brown County,15,9651,4466,5185
Wisconsin,Brown County,16,6595,2926,3669
Wisconsin,Brown County,17,4562,1953,2609
Wisconsin,Brown County,18,4741,1648,3093
Wisconsin,Buffalo County,0,13125,6677,6448
Wisconsin,Buffalo County,1,707,363,344
Wisconsin,Buffalo County,2,740,350,390
Wisconsin,Buffalo County,3,804,385,419
Wisconsin,Buffalo County,4,745,385,360
Wisconsin,Buffalo County,5,643,323,320
Wisconsin,Buffalo County,6,698,366,332
Wisconsin,Buffalo County,7,686,377,309
Wisconsin,Buffalo County,8,731,366,365
Wisconsin,Buffalo County,9,671,350,321
Wisconsin,Buffalo County,10,779,388,391
Wisconsin,Buffalo County,11,921,473,448
Wisconsin,Buffalo County,12,1096,547,549
Wisconsin,Buffalo County,13,1002,539,463
Wisconsin,Buffalo County,14,966,528,438
Wisconsin,Buffalo County,15,690,371,319
Wisconsin,Buffalo County,16,523,253,270
Wisconsin,Buffalo County,17,377,169,208
Wisconsin,Buffalo County,18,346,144,202
Wisconsin,Burnett County,0,15392,7884,7508
Wisconsin,Burnett County,1,673,366,307
Wisconsin,Burnett County,2,749,419,330
Wisconsin,Burnett County,3,798,430,368
Wisconsin,Burnett County,4,765,399,366
Wisconsin,Burnett County,5,604,297,307
Wisconsin,Burnett County,6,646,330,316
Wisconsin,Burnett County,7,594,296,298
Wisconsin,Burnett County,8,738,371,367
Wisconsin,Burnett County,9,689,327,362
Wisconsin,Burnett County,10,835,438,397
Wisconsin,Burnett County,11,1037,527,510
Wisconsin,Burnett County,12,1366,696,670
Wisconsin,Burnett County,13,1502,763,739
Wisconsin,Burnett County,14,1440,726,714
Wisconsin,Burnett County,15,1175,647,528
Wisconsin,Burnett County,16,817,396,421
Wisconsin,Burnett County,17,513,262,251
Wisconsin,Burnett County,18,451,194,257
Wisconsin,Calumet County,0,50159,25262,24897
Wisconsin,Calumet County,1,2685,1391,1294
Wisconsin,Calumet County,2,3301,1702,1599
Wisconsin,Calumet County,3,3732,1920,1812
Wisconsin,Calumet County,4,3371,1720,1651
Wisconsin,Calumet County,5,2624,1334,1290
Wisconsin,Calumet County,6,2638,1403,1235
Wisconsin,Calumet County,7,2915,1459,1456
Wisconsin,Calumet County,8,3391,1692,1699
Wisconsin,Calumet County,9,3272,1662,1610
Wisconsin,Calumet County,10,3469,1739,1730
Wisconsin,Calumet County,11,3955,1986,1969
Wisconsin,Calumet County,12,3866,2020,1846
Wisconsin,Calumet County,13,3369,1672,1697
Wisconsin,Calumet County,14,2647,1313,1334
Wisconsin,Calumet County,15,1893,916,977
Wisconsin,Calumet County,16,1336,632,704
Wisconsin,Calumet County,17,864,370,494
Wisconsin,Calumet County,18,831,331,500
Wisconsin,Chippewa County,0,64135,33239,30896
Wisconsin,Chippewa County,1,3508,1765,1743
Wisconsin,Chippewa County,2,3919,2042,1877
Wisconsin,Chippewa County,3,4237,2156,2081
Wisconsin,Chippewa County,4,3757,1938,1819
Wisconsin,Chippewa County,5,3266,1836,1430
Wisconsin,Chippewa County,6,3763,2066,1697
Wisconsin,Chippewa County,7,4127,2251,1876
Wisconsin,Chippewa County,8,4346,2397,1949
Wisconsin,Chippewa County,9,3730,2042,1688
Wisconsin,Chippewa County,10,4074,2167,1907
Wisconsin,Chippewa County,11,4366,2330,2036
Wisconsin,Chippewa County,12,4957,2536,2421
Wisconsin,Chippewa County,13,4560,2328,2232
Wisconsin,Chippewa County,14,3909,1928,1981
Wisconsin,Chippewa County,15,2891,1484,1407
Wisconsin,Chippewa County,16,1952,902,1050
Wisconsin,Chippewa County,17,1342,569,773
Wisconsin,Chippewa County,18,1431,502,929
Wisconsin,Clark County,0,34709,17523,17186
Wisconsin,Clark County,1,2832,1470,1362
Wisconsin,Clark County,2,2822,1420,1402
Wisconsin,Clark County,3,2874,1441,1433
Wisconsin,Clark County,4,2550,1304,1246
Wisconsin,Clark County,5,1937,1004,933
Wisconsin,Clark County,6,1720,889,831
Wisconsin,Clark County,7,1667,842,825
Wisconsin,Clark County,8,1902,1002,900
Wisconsin,Clark County,9,1790,925,865
Wisconsin,Clark County,10,1910,947,963
Wisconsin,Clark County,11,2139,1119,1020
Wisconsin,Clark County,12,2426,1224,1202
Wisconsin,Clark County,13,2379,1242,1137
Wisconsin,Clark County,14,1777,904,873
Wisconsin,Clark County,15,1330,669,661
Wisconsin,Clark County,16,1038,481,557
Wisconsin,Clark County,17,755,349,406
Wisconsin,Clark County,18,861,291,570
Wisconsin,Columbia County,0,57358,29321,28037
Wisconsin,Columbia County,1,3068,1575,1493
Wisconsin,Columbia County,2,3224,1636,1588
Wisconsin,Columbia County,3,3651,1897,1754
Wisconsin,Columbia County,4,3454,1787,1667
Wisconsin,Columbia County,5,3060,1657,1403
Wisconsin,Columbia County,6,3265,1761,1504
Wisconsin,Columbia County,7,3527,1839,1688
Wisconsin,Columbia County,8,3699,1984,1715
Wisconsin,Columbia County,9,3423,1770,1653
Wisconsin,Columbia County,10,3786,2011,1775
Wisconsin,Columbia County,11,4202,2163,2039
Wisconsin,Columbia County,12,4517,2275,2242
Wisconsin,Columbia County,13,4232,2129,2103
Wisconsin,Columbia County,14,3478,1798,1680
Wisconsin,Columbia County,15,2584,1260,1324
Wisconsin,Columbia County,16,1797,858,939
Wisconsin,Columbia County,17,1193,517,676
Wisconsin,Columbia County,18,1198,404,794
Wisconsin,Crawford County,0,16291,8461,7830
Wisconsin,Crawford County,1,774,396,378
Wisconsin,Crawford County,2,881,439,442
Wisconsin,Crawford County,3,1005,534,471
Wisconsin,Crawford County,4,1011,543,468
Wisconsin,Crawford County,5,849,500,349
Wisconsin,Crawford County,6,837,487,350
Wisconsin,Crawford County,7,839,448,391
Wisconsin,Crawford County,8,891,467,424
Wisconsin,Crawford County,9,839,441,398
Wisconsin,Crawford County,10,923,506,417
Wisconsin,Crawford County,11,1099,566,533
Wisconsin,Crawford County,12,1314,668,646
Wisconsin,Crawford County,13,1243,608,635
Wisconsin,Crawford County,14,1261,673,588
Wisconsin,Crawford County,15,915,435,480
Wisconsin,Crawford County,16,748,357,391
Wisconsin,Crawford County,17,400,208,192
Wisconsin,Crawford County,18,462,185,277
Wisconsin,Dane County,0,542364,269692,272672
Wisconsin,Dane County,1,30571,15726,14845
Wisconsin,Dane County,2,30904,15649,15255
Wisconsin,Dane County,3,30996,16022,14974
Wisconsin,Dane County,4,35387,17843,17544
Wisconsin,Dane County,5,55759,28146,27613
Wisconsin,Dane County,6,45161,23852,21309
Wisconsin,Dane County,7,40519,20897,19622
Wisconsin,Dane County,8,39160,19978,19182
Wisconsin,Dane County,9,32741,16454,16287
Wisconsin,Dane County,10,31818,15936,15882
Wisconsin,Dane County,11,31659,15549,16110
Wisconsin,Dane County,12,32882,15795,17087
Wisconsin,Dane County,13,30374,14516,15858
Wisconsin,Dane County,14,26630,12630,14000
Wisconsin,Dane County,15,19040,9040,10000
Wisconsin,Dane County,16,11853,5257,6596
Wisconsin,Dane County,17,7686,3252,4434
Wisconsin,Dane County,18,9224,3150,6074
Wisconsin,Dodge County,0,87847,46444,41403
Wisconsin,Dodge County,1,4067,2100,1967
Wisconsin,Dodge County,2,4710,2466,2244
Wisconsin,Dodge County,3,5310,2752,2558
Wisconsin,Dodge County,4,5171,2613,2558
Wisconsin,Dodge County,5,4991,2917,2074
Wisconsin,Dodge County,6,5620,3377,2243
Wisconsin,Dodge County,7,5595,3275,2320
Wisconsin,Dodge County,8,5750,3321,2429
Wisconsin,Dodge County,9,5350,3006,2344
Wisconsin,Dodge County,10,5788,3087,2701
Wisconsin,Dodge County,11,6448,3422,3026
Wisconsin,Dodge County,12,7281,3812,3469
Wisconsin,Dodge County,13,6269,3211,3058
Wisconsin,Dodge County,14,4971,2421,2550
Wisconsin,Dodge County,15,3645,1805,1840
Wisconsin,Dodge County,16,2685,1229,1456
Wisconsin,Dodge County,17,2004,878,1126
Wisconsin,Dodge County,18,2192,752,1440
Wisconsin,Door County,0,27610,13625,13985
Wisconsin,Door County,1,1072,542,530
Wisconsin,Door County,2,1144,576,568
Wisconsin,Door County,3,1408,739,669
Wisconsin,Door County,4,1328,667,661
Wisconsin,Door County,5,1170,592,578
Wisconsin,Door County,6,1204,635,569
Wisconsin,Door County,7,1167,593,574
Wisconsin,Door County,8,1384,690,694
Wisconsin,Door County,9,1317,700,617
Wisconsin,Door County,10,1473,739,734
Wisconsin,Door County,11,1722,837,885
Wisconsin,Door County,12,2375,1185,1190
Wisconsin,Door County,13,2631,1268,1363
Wisconsin,Door County,14,2808,1366,1442
Wisconsin,Door County,15,2112,1018,1094
Wisconsin,Door County,16,1457,708,749
Wisconsin,Door County,17,932,449,483
Wisconsin,Door County,18,906,321,585
Wisconsin,Douglas County,0,43208,21627,21581
Wisconsin,Douglas County,1,2088,1059,1029
Wisconsin,Douglas County,2,2451,1260,1191
Wisconsin,Douglas County,3,2497,1270,1227
Wisconsin,Douglas County,4,2582,1315,1267
Wisconsin,Douglas County,5,2658,1360,1298
Wisconsin,Douglas County,6,2635,1357,1278
Wisconsin,Douglas County,7,2741,1392,1349
Wisconsin,Douglas County,8,2797,1361,1436
Wisconsin,Douglas County,9,2450,1263,1187
Wisconsin,Douglas County,10,2638,1351,1287
Wisconsin,Douglas County,11,2857,1413,1444
Wisconsin,Douglas County,12,3409,1618,1791
Wisconsin,Douglas County,13,3366,1729,1637
Wisconsin,Douglas County,14,2826,1469,1357
Wisconsin,Douglas County,15,1941,1005,936
Wisconsin,Douglas County,16,1392,659,733
Wisconsin,Douglas County,17,919,401,518
Wisconsin,Douglas County,18,961,345,616
Wisconsin,Dunn County,0,45131,22651,22480
Wisconsin,Dunn County,1,2350,1198,1152
Wisconsin,Dunn County,2,2411,1215,1196
Wisconsin,Dunn County,3,2584,1346,1238
Wisconsin,Dunn County,4,4125,2009,2116
Wisconsin,Dunn County,5,5881,3015,2866
Wisconsin,Dunn County,6,2642,1401,1241
Wisconsin,Dunn County,7,2456,1254,1202
Wisconsin,Dunn County,8,2590,1319,1271
Wisconsin,Dunn County,9,2332,1211,1121
Wisconsin,Dunn County,10,2549,1305,1244
Wisconsin,Dunn County,11,2502,1278,1224
Wisconsin,Dunn County,12,2935,1497,1438
Wisconsin,Dunn County,13,2697,1375,1322
Wisconsin,Dunn County,14,2333,1168,1165
Wisconsin,Dunn County,15,1821,877,944
Wisconsin,Dunn County,16,1146,542,604
Wisconsin,Dunn County,17,790,327,463
Wisconsin,Dunn County,18,987,314,673
Wisconsin,Eau Claire County,0,104534,51647,52887
Wisconsin,Eau Claire County,1,6031,3076,2955
Wisconsin,Eau Claire County,2,5856,3045,2811
Wisconsin,Eau Claire County,3,5961,3122,2839
Wisconsin,Eau Claire County,4,7845,3764,4081
Wisconsin,Eau Claire County,5,12423,5909,6514
Wisconsin,Eau Claire County,6,7430,3867,3563
Wisconsin,Eau Claire County,7,6957,3594,3363
Wisconsin,Eau Claire County,8,6638,3417,3221
Wisconsin,Eau Claire County,9,5347,2754,2593
Wisconsin,Eau Claire County,10,5521,2779,2742
Wisconsin,Eau Claire County,11,5709,2857,2852
Wisconsin,Eau Claire County,12,6388,3178,3210
Wisconsin,Eau Claire County,13,6054,2904,3150
Wisconsin,Eau Claire County,14,5541,2614,2927
Wisconsin,Eau Claire County,15,4125,1991,2134
Wisconsin,Eau Claire County,16,2727,1263,1464
Wisconsin,Eau Claire County,17,1884,805,1079
Wisconsin,Eau Claire County,18,2097,708,1389
Wisconsin,Florence County,0,4321,2226,2095
Wisconsin,Florence County,1,167,102,65
Wisconsin,Florence County,2,174,92,82
Wisconsin,Florence County,3,187,94,93
Wisconsin,Florence County,4,165,91,74
Wisconsin,Florence County,5,166,86,80
Wisconsin,Florence County,6,178,85,93
Wisconsin,Florence County,7,201,108,93
Wisconsin,Florence County,8,210,108,102
Wisconsin,Florence County,9,194,101,93
Wisconsin,Florence County,10,234,130,104
Wisconsin,Florence County,11,367,177,190
Wisconsin,Florence County,12,461,231,230
Wisconsin,Florence County,13,492,250,242
Wisconsin,Florence County,14,377,197,180
Wisconsin,Florence County,15,302,169,133
Wisconsin,Florence County,16,196,92,104
Wisconsin,Florence County,17,132,65,67
Wisconsin,Florence County,18,118,48,70
Wisconsin,Fond du Lac County,0,103066,50694,52372
Wisconsin,Fond du Lac County,1,5436,2690,2746
Wisconsin,Fond du Lac County,2,6156,3089,3067
Wisconsin,Fond du Lac County,3,6497,3298,3199
Wisconsin,Fond du Lac County,4,6463,3356,3107
Wisconsin,Fond du Lac County,5,6136,3095,3041
Wisconsin,Fond du Lac County,6,6114,2998,3116
Wisconsin,Fond du Lac County,7,6113,3060,3053
Wisconsin,Fond du Lac County,8,6594,3314,3280
Wisconsin,Fond du Lac County,9,5896,2953,2943
Wisconsin,Fond du Lac County,10,6262,3202,3060
Wisconsin,Fond du Lac County,11,7134,3484,3650
Wisconsin,Fond du Lac County,12,7837,3924,3913
Wisconsin,Fond du Lac County,13,7345,3667,3678
Wisconsin,Fond du Lac County,14,6153,3025,3128
Wisconsin,Fond du Lac County,15,4627,2218,2409
Wisconsin,Fond du Lac County,16,3298,1519,1779
Wisconsin,Fond du Lac County,17,2294,952,1342
Wisconsin,Fond du Lac County,18,2711,850,1861
Wisconsin,Forest County,0,8991,4556,4435
Wisconsin,Forest County,1,511,263,248
Wisconsin,Forest County,2,480,245,235
Wisconsin,Forest County,3,454,225,229
Wisconsin,Forest County,4,547,313,234
Wisconsin,Forest County,5,525,293,232
Wisconsin,Forest County,6,472,230,242
Wisconsin,Forest County,7,443,231,212
Wisconsin,Forest County,8,412,211,201
Wisconsin,Forest County,9,439,212,227
Wisconsin,Forest County,10,538,275,263
Wisconsin,Forest County,11,591,312,279
Wisconsin,Forest County,12,722,344,378
Wisconsin,Forest County,13,793,389,404
Wisconsin,Forest County,14,663,328,335
Wisconsin,Forest County,15,516,255,261
Wisconsin,Forest County,16,383,193,190
Wisconsin,Forest County,17,256,137,119
Wisconsin,Forest County,18,246,100,146
Wisconsin,Grant County,0,51554,26737,24817
Wisconsin,Grant County,1,2939,1504,1435
Wisconsin,Grant County,2,2902,1479,1423
Wisconsin,Grant County,3,3096,1507,1589
Wisconsin,Grant County,4,4780,2777,2003
Wisconsin,Grant County,5,5922,3501,2421
Wisconsin,Grant County,6,3031,1665,1366
Wisconsin,Grant County,7,2573,1418,1155
Wisconsin,Grant County,8,2774,1472,1302
Wisconsin,Grant County,9,2474,1287,1187
Wisconsin,Grant County,10,2544,1321,1223
Wisconsin,Grant County,11,2851,1424,1427
Wisconsin,Grant County,12,3434,1724,1710
Wisconsin,Grant County,13,3339,1670,1669
Wisconsin,Grant County,14,2757,1356,1401
Wisconsin,Grant County,15,1992,963,1029
Wisconsin,Grant County,16,1594,735,859
Wisconsin,Grant County,17,1233,517,716
Wisconsin,Grant County,18,1319,417,902
Wisconsin,Green County,0,36929,18350,18579
Wisconsin,Green County,1,1922,971,951
Wisconsin,Green County,2,2164,1085,1079
Wisconsin,Green County,3,2582,1294,1288
Wisconsin,Green County,4,2211,1138,1073
Wisconsin,Green County,5,1870,938,932
Wisconsin,Green County,6,1948,968,980
Wisconsin,Green County,7,2035,1039,996
Wisconsin,Green County,8,2284,1172,1112
Wisconsin,Green County,9,2145,1055,1090
Wisconsin,Green County,10,2457,1289,1168
Wisconsin,Green County,11,2570,1280,1290
Wisconsin,Green County,12,2998,1500,1498
Wisconsin,Green County,13,2832,1434,1398
Wisconsin,Green County,14,2280,1146,1134
Wisconsin,Green County,15,1664,810,854
Wisconsin,Green County,16,1166,537,629
Wisconsin,Green County,17,818,362,456
Wisconsin,Green County,18,983,332,651
Wisconsin,Green Lake County,0,18918,9506,9412
Wisconsin,Green Lake County,1,1096,541,555
Wisconsin,Green Lake County,2,1137,574,563
Wisconsin,Green Lake County,3,1211,623,588
Wisconsin,Green Lake County,4,1224,651,573
Wisconsin,Green Lake County,5,940,487,453
Wisconsin,Green Lake County,6,866,431,435
Wisconsin,Green Lake County,7,909,460,449
Wisconsin,Green Lake County,8,1029,524,505
Wisconsin,Green Lake County,9,958,514,444
Wisconsin,Green Lake County,10,1045,531,514
Wisconsin,Green Lake County,11,1241,637,604
Wisconsin,Green Lake County,12,1530,768,762
Wisconsin,Green Lake County,13,1531,785,746
Wisconsin,Green Lake County,14,1344,696,648
Wisconsin,Green Lake County,15,1081,521,560
Wisconsin,Green Lake County,16,768,349,419
Wisconsin,Green Lake County,17,505,231,274
Wisconsin,Green Lake County,18,503,183,320
Wisconsin,Iowa County,0,23771,11904,11867
Wisconsin,Iowa County,1,1349,654,695
Wisconsin,Iowa County,2,1529,789,740
Wisconsin,Iowa County,3,1605,815,790
Wisconsin,Iowa County,4,1429,746,683
Wisconsin,Iowa County,5,1126,575,551
Wisconsin,Iowa County,6,1200,601,599
Wisconsin,Iowa County,7,1341,672,669
Wisconsin,Iowa County,8,1482,764,718
Wisconsin,Iowa County,9,1317,666,651
Wisconsin,Iowa County,10,1422,711,711
Wisconsin,Iowa County,11,1737,856,881
Wisconsin,Iowa County,12,1943,976,967
Wisconsin,Iowa County,13,1833,921,912
Wisconsin,Iowa County,14,1615,816,799
Wisconsin,Iowa County,15,1153,603,550
Wisconsin,Iowa County,16,714,354,360
Wisconsin,Iowa County,17,483,203,280
Wisconsin,Iowa County,18,493,182,311
Wisconsin,Iron County,0,5676,2857,2819
Wisconsin,Iron County,1,173,91,82
Wisconsin,Iron County,2,233,126,107
Wisconsin,Iron County,3,289,140,149
Wisconsin,Iron County,4,252,126,126
Wisconsin,Iron County,5,210,113,97
Wisconsin,Iron County,6,198,108,90
Wisconsin,Iron County,7,203,86,117
Wisconsin,Iron County,8,262,131,131
Wisconsin,Iron County,9,279,143,136
Wisconsin,Iron County,10,330,177,153
Wisconsin,Iron County,11,391,182,209
Wisconsin,Iron County,12,521,272,249
Wisconsin,Iron County,13,583,309,274
Wisconsin,Iron County,14,527,278,249
Wisconsin,Iron County,15,469,236,233
Wisconsin,Iron County,16,284,149,135
Wisconsin,Iron County,17,205,91,114
Wisconsin,Iron County,18,267,99,168
Wisconsin,Jackson County,0,20478,10969,9509
Wisconsin,Jackson County,1,1205,637,568
Wisconsin,Jackson County,2,1190,641,549
Wisconsin,Jackson County,3,1260,639,621
Wisconsin,Jackson County,4,1207,621,586
Wisconsin,Jackson County,5,1102,645,457
Wisconsin,Jackson County,6,1311,795,516
Wisconsin,Jackson County,7,1192,726,466
Wisconsin,Jackson County,8,1263,684,579
Wisconsin,Jackson County,9,1108,621,487
Wisconsin,Jackson County,10,1276,703,573
Wisconsin,Jackson County,11,1411,747,664
Wisconsin,Jackson County,12,1586,821,765
Wisconsin,Jackson County,13,1482,797,685
Wisconsin,Jackson County,14,1279,652,627
Wisconsin,Jackson County,15,993,511,482
Wisconsin,Jackson County,16,691,341,350
Wisconsin,Jackson County,17,493,224,269
Wisconsin,Jackson County,18,429,164,265
Wisconsin,Jefferson County,0,85129,42546,42583
Wisconsin,Jefferson County,1,4377,2218,2159
Wisconsin,Jefferson County,2,4739,2445,2294
Wisconsin,Jefferson County,3,5381,2857,2524
Wisconsin,Jefferson County,4,6238,3125,3113
Wisconsin,Jefferson County,5,5129,2613,2516
Wisconsin,Jefferson County,6,4741,2463,2278
Wisconsin,Jefferson County,7,5140,2527,2613
Wisconsin,Jefferson County,8,5550,2774,2776
Wisconsin,Jefferson County,9,5189,2701,2488
Wisconsin,Jefferson County,10,5639,2887,2752
Wisconsin,Jefferson County,11,6136,3081,3055
Wisconsin,Jefferson County,12,6509,3215,3294
Wisconsin,Jefferson County,13,5925,2950,2975
Wisconsin,Jefferson County,14,4887,2425,2462
Wisconsin,Jefferson County,15,3746,1757,1989
Wisconsin,Jefferson County,16,2588,1182,1406
Wisconsin,Jefferson County,17,1657,763,894
Wisconsin,Jefferson County,18,1558,563,995
Wisconsin,Juneau County,0,26617,14165,12452
Wisconsin,Juneau County,1,1442,729,713
Wisconsin,Juneau County,2,1483,778,705
Wisconsin,Juneau County,3,1541,793,748
Wisconsin,Juneau County,4,1394,720,674
Wisconsin,Juneau County,5,1270,680,590
Wisconsin,Juneau County,6,1549,906,643
Wisconsin,Juneau County,7,1464,867,597
Wisconsin,Juneau County,8,1583,901,682
Wisconsin,Juneau County,9,1565,902,663
Wisconsin,Juneau County,10,1744,999,745
Wisconsin,Juneau County,11,1926,1048,878
Wisconsin,Juneau County,12,2216,1183,1033
Wisconsin,Juneau County,13,2050,1056,994
Wisconsin,Juneau County,14,1742,921,821
Wisconsin,Juneau County,15,1396,683,713
Wisconsin,Juneau County,16,1025,488,537
Wisconsin,Juneau County,17,637,300,337
Wisconsin,Juneau County,18,590,211,379
Wisconsin,Kenosha County,0,169290,83836,85454
Wisconsin,Kenosha County,1,9710,5021,4689
Wisconsin,Kenosha County,2,10468,5414,5054
Wisconsin,Kenosha County,3,11302,5693,5609
Wisconsin,Kenosha County,4,12323,6281,6042
Wisconsin,Kenosha County,5,11233,5695,5538
Wisconsin,Kenosha County,6,11263,5754,5509
Wisconsin,Kenosha County,7,10621,5342,5279
Wisconsin,Kenosha County,8,10864,5358,5506
Wisconsin,Kenosha County,9,10291,5075,5216
Wisconsin,Kenosha County,10,11245,5623,5622
Wisconsin,Kenosha County,11,12343,6118,6225
Wisconsin,Kenosha County,12,12903,6390,6513
Wisconsin,Kenosha County,13,10799,5316,5483
Wisconsin,Kenosha County,14,8104,3962,4142
Wisconsin,Kenosha County,15,5793,2698,3095
Wisconsin,Kenosha County,16,4226,1897,2329
Wisconsin,Kenosha County,17,2773,1196,1577
Wisconsin,Kenosha County,18,3029,1003,2026
Wisconsin,Kewaunee County,0,20383,10334,10049
Wisconsin,Kewaunee County,1,1063,531,532
Wisconsin,Kewaunee County,2,1200,610,590
Wisconsin,Kewaunee County,3,1272,665,607
Wisconsin,Kewaunee County,4,1295,662,633
Wisconsin,Kewaunee County,5,1041,552,489
Wisconsin,Kewaunee County,6,984,520,464
Wisconsin,Kewaunee County,7,1121,562,559
Wisconsin,Kewaunee County,8,1201,639,562
Wisconsin,Kewaunee County,9,1167,611,556
Wisconsin,Kewaunee County,10,1245,638,607
Wisconsin,Kewaunee County,11,1462,721,741
Wisconsin,Kewaunee County,12,1645,841,804
Wisconsin,Kewaunee County,13,1519,810,709
Wisconsin,Kewaunee County,14,1367,704,663
Wisconsin,Kewaunee County,15,971,497,474
Wisconsin,Kewaunee County,16,726,348,378
Wisconsin,Kewaunee County,17,502,217,285
Wisconsin,Kewaunee County,18,602,206,396
Wisconsin,La Crosse County,0,118230,57659,60571
Wisconsin,La Crosse County,1,6014,2996,3018
Wisconsin,La Crosse County,2,6479,3311,3168
Wisconsin,La Crosse County,3,6924,3580,3344
Wisconsin,La Crosse County,4,9213,4274,4939
Wisconsin,La Crosse County,5,13718,6396,7322
Wisconsin,La Crosse County,6,8087,4189,3898
Wisconsin,La Crosse County,7,6965,3617,3348
Wisconsin,La Crosse County,8,7171,3670,3501
Wisconsin,La Crosse County,9,6032,3049,2983
Wisconsin,La Crosse County,10,6440,3261,3179
Wisconsin,La Crosse County,11,6732,3380,3352
Wisconsin,La Crosse County,12,7644,3675,3969
Wisconsin,La Crosse County,13,7412,3603,3809
Wisconsin,La Crosse County,14,6328,3046,3282
Wisconsin,La Crosse County,15,4729,2259,2470
Wisconsin,La Crosse County,16,3203,1436,1767
Wisconsin,La Crosse County,17,2369,969,1400
Wisconsin,La Crosse County,18,2770,948,1822
Wisconsin,Lafayette County,0,16665,8435,8230
Wisconsin,Lafayette County,1,1040,528,512
Wisconsin,Lafayette County,2,1136,565,571
Wisconsin,Lafayette County,3,1176,594,582
Wisconsin,Lafayette County,4,1112,573,539
Wisconsin,Lafayette County,5,888,465,423
Wisconsin,Lafayette County,6,863,446,417
Wisconsin,Lafayette County,7,879,466,413
Wisconsin,Lafayette County,8,955,477,478
Wisconsin,Lafayette County,9,830,425,405
Wisconsin,Lafayette County,10,945,470,475
Wisconsin,Lafayette County,11,1091,550,541
Wisconsin,Lafayette County,12,1328,669,659
Wisconsin,Lafayette County,13,1310,684,626
Wisconsin,Lafayette County,14,1005,533,472
Wisconsin,Lafayette County,15,682,362,320
Wisconsin,Lafayette County,16,553,264,289
Wisconsin,Lafayette County,17,429,190,239
Wisconsin,Lafayette County,18,443,174,269
Wisconsin,Langlade County,0,19268,9717,9551
Wisconsin,Langlade County,1,980,491,489
Wisconsin,Langlade County,2,1022,537,485
Wisconsin,Langlade County,3,1062,551,511
Wisconsin,Langlade County,4,1093,588,505
Wisconsin,Langlade County,5,909,476,433
Wisconsin,Langlade County,6,869,460,409
Wisconsin,Langlade County,7,946,488,458
Wisconsin,Langlade County,8,1037,534,503
Wisconsin,Langlade County,9,941,461,480
Wisconsin,Langlade County,10,1061,535,526
Wisconsin,Langlade County,11,1383,717,666
Wisconsin,Langlade County,12,1679,849,830
Wisconsin,Langlade County,13,1670,854,816
Wisconsin,Langlade County,14,1434,720,714
Wisconsin,Langlade County,15,1104,537,567
Wisconsin,Langlade County,16,826,397,429
Wisconsin,Langlade County,17,624,295,329
Wisconsin,Langlade County,18,628,227,401
Wisconsin,Lincoln County,0,27689,14029,13660
Wisconsin,Lincoln County,1,1264,658,606
Wisconsin,Lincoln County,2,1344,657,687
Wisconsin,Lincoln County,3,1421,734,687
Wisconsin,Lincoln County,4,1502,863,639
Wisconsin,Lincoln County,5,1436,753,683
Wisconsin,Lincoln County,6,1375,732,643
Wisconsin,Lincoln County,7,1296,656,640
Wisconsin,Lincoln County,8,1580,812,768
Wisconsin,Lincoln County,9,1500,765,735
Wisconsin,Lincoln County,10,1832,920,912
Wisconsin,Lincoln County,11,2234,1154,1080
Wisconsin,Lincoln County,12,2498,1276,1222
Wisconsin,Lincoln County,13,2458,1242,1216
Wisconsin,Lincoln County,14,1844,945,899
Wisconsin,Lincoln County,15,1459,708,751
Wisconsin,Lincoln County,16,1076,508,568
Wisconsin,Lincoln County,17,782,373,409
Wisconsin,Lincoln County,18,788,273,515
Wisconsin,Manitowoc County,0,79074,39507,39567
Wisconsin,Manitowoc County,1,4054,2096,1958
Wisconsin,Manitowoc County,2,4361,2275,2086
Wisconsin,Manitowoc County,3,4854,2485,2369
Wisconsin,Manitowoc County,4,4652,2414,2238
Wisconsin,Manitowoc County,5,4234,2091,2143
Wisconsin,Manitowoc County,6,4253,2201,2052
Wisconsin,Manitowoc County,7,4093,2109,1984
Wisconsin,Manitowoc County,8,4571,2353,2218
Wisconsin,Manitowoc County,9,4372,2258,2114
Wisconsin,Manitowoc County,10,4752,2404,2348
Wisconsin,Manitowoc County,11,5749,2924,2825
Wisconsin,Manitowoc County,12,6603,3325,3278
Wisconsin,Manitowoc County,13,6333,3178,3155
Wisconsin,Manitowoc County,14,5247,2646,2601
Wisconsin,Manitowoc County,15,3842,1876,1966
Wisconsin,Manitowoc County,16,2936,1348,1588
Wisconsin,Manitowoc County,17,1935,798,1137
Wisconsin,Manitowoc County,18,2233,726,1507
Wisconsin,Marathon County,0,135428,68084,67344
Wisconsin,Marathon County,1,8001,4109,3892
Wisconsin,Marathon County,2,8429,4310,4119
Wisconsin,Marathon County,3,9046,4662,4384
Wisconsin,Marathon County,4,8244,4298,3946
Wisconsin,Marathon County,5,7446,3836,3610
Wisconsin,Marathon County,6,8344,4370,3974
Wisconsin,Marathon County,7,7941,4071,3870
Wisconsin,Marathon County,8,8691,4387,4304
Wisconsin,Marathon County,9,7922,4095,3827
Wisconsin,Marathon County,10,8394,4212,4182
Wisconsin,Marathon County,11,9378,4763,4615
Wisconsin,Marathon County,12,10331,5164,5167
Wisconsin,Marathon County,13,9281,4724,4557
Wisconsin,Marathon County,14,7770,3832,3938
Wisconsin,Marathon County,15,5757,2824,2933
Wisconsin,Marathon County,16,4273,2019,2254
Wisconsin,Marathon County,17,2975,1283,1692
Wisconsin,Marathon County,18,3205,1125,2080
Wisconsin,Marinette County,0,40434,20297,20137
Wisconsin,Marinette County,1,1937,1014,923
Wisconsin,Marinette County,2,2050,1058,992
Wisconsin,Marinette County,3,2349,1211,1138
Wisconsin,Marinette County,4,2210,1115,1095
Wisconsin,Marinette County,5,1825,914,911
Wisconsin,Marinette County,6,1914,998,916
Wisconsin,Marinette County,7,2046,1080,966
Wisconsin,Marinette County,8,2192,1093,1099
Wisconsin,Marinette County,9,2014,1016,998
Wisconsin,Marinette County,10,2274,1167,1107
Wisconsin,Marinette County,11,2823,1426,1397
Wisconsin,Marinette County,12,3641,1801,1840
Wisconsin,Marinette County,13,3537,1823,1714
Wisconsin,Marinette County,14,3052,1553,1499
Wisconsin,Marinette County,15,2364,1205,1159
Wisconsin,Marinette County,16,1730,857,873
Wisconsin,Marinette County,17,1202,517,685
Wisconsin,Marinette County,18,1274,449,825
Wisconsin,Marquette County,0,15434,7877,7557
Wisconsin,Marquette County,1,749,376,373
Wisconsin,Marquette County,2,828,442,386
Wisconsin,Marquette County,3,888,457,431
Wisconsin,Marquette County,4,772,425,347
Wisconsin,Marquette County,5,638,351,287
Wisconsin,Marquette County,6,663,337,326
Wisconsin,Marquette County,7,743,368,375
Wisconsin,Marquette County,8,750,375,375
Wisconsin,Marquette County,9,765,397,368
Wisconsin,Marquette County,10,878,445,433
Wisconsin,Marquette County,11,1113,588,525
Wisconsin,Marquette County,12,1450,754,696
Wisconsin,Marquette County,13,1410,734,676
Wisconsin,Marquette County,14,1275,671,604
Wisconsin,Marquette County,15,948,444,504
Wisconsin,Marquette County,16,699,338,361
Wisconsin,Marquette County,17,438,202,236
Wisconsin,Marquette County,18,427,173,254
Wisconsin,Menominee County,0,4658,2320,2338
Wisconsin,Menominee County,1,465,239,226
Wisconsin,Menominee County,2,434,253,181
Wisconsin,Menominee County,3,429,218,211
Wisconsin,Menominee County,4,392,203,189
Wisconsin,Menominee County,5,263,147,116
Wisconsin,Menominee County,6,287,145,142
Wisconsin,Menominee County,7,255,121,134
Wisconsin,Menominee County,8,222,105,117
Wisconsin,Menominee County,9,190,78,112
Wisconsin,Menominee County,10,233,107,126
Wisconsin,Menominee County,11,260,122,138
Wisconsin,Menominee County,12,320,152,168
Wisconsin,Menominee County,13,293,149,144
Wisconsin,Menominee County,14,213,95,118
Wisconsin,Menominee County,15,165,78,87
Wisconsin,Menominee County,16,112,46,66
Wisconsin,Menominee County,17,62,30,32
Wisconsin,Menominee County,18,63,32,31
Wisconsin,Milwaukee County,0,948201,459121,489080
Wisconsin,Milwaukee County,1,64975,33173,31802
Wisconsin,Milwaukee County,2,63814,32622,31192
Wisconsin,Milwaukee County,3,62830,31951,30879
Wisconsin,Milwaukee County,4,62046,31627,30419
Wisconsin,Milwaukee County,5,64267,31921,32346
Wisconsin,Milwaukee County,6,81680,39951,41729
Wisconsin,Milwaukee County,7,73257,35740,37517
Wisconsin,Milwaukee County,8,66044,32103,33941
Wisconsin,Milwaukee County,9,55601,26812,28789
Wisconsin,Milwaukee County,10,54888,26924,27964
Wisconsin,Milwaukee County,11,55292,26745,28547
Wisconsin,Milwaukee County,12,58787,28195,30592
Wisconsin,Milwaukee County,13,55717,26323,29394
Wisconsin,Milwaukee County,14,44363,20628,23735
Wisconsin,Milwaukee County,15,30368,13831,16537
Wisconsin,Milwaukee County,16,20216,8380,11836
Wisconsin,Milwaukee County,17,14966,5942,9024
Wisconsin,Milwaukee County,18,19090,6253,12837
Wisconsin,Monroe County,0,46051,23301,22750
Wisconsin,Monroe County,1,3134,1544,1590
Wisconsin,Monroe County,2,3264,1641,1623
Wisconsin,Monroe County,3,3358,1710,1648
Wisconsin,Monroe County,4,2901,1509,1392
Wisconsin,Monroe County,5,2308,1186,1122
Wisconsin,Monroe County,6,2496,1275,1221
Wisconsin,Monroe County,7,2824,1425,1399
Wisconsin,Monroe County,8,3040,1551,1489
Wisconsin,Monroe County,9,2597,1376,1221
Wisconsin,Monroe County,10,2702,1404,1298
Wisconsin,Monroe County,11,2996,1570,1426
Wisconsin,Monroe County,12,3419,1776,1643
Wisconsin,Monroe County,13,3180,1590,1590
Wisconsin,Monroe County,14,2595,1296,1299
Wisconsin,Monroe County,15,1975,1029,946
Wisconsin,Monroe County,16,1412,661,751
Wisconsin,Monroe County,17,919,425,494
Wisconsin,Monroe County,18,931,333,598
Wisconsin,Oconto County,0,37830,19383,18447
Wisconsin,Oconto County,1,1848,980,868
Wisconsin,Oconto County,2,2086,1058,1028
Wisconsin,Oconto County,3,2371,1223,1148
Wisconsin,Oconto County,4,2079,1082,997
Wisconsin,Oconto County,5,1689,895,794
Wisconsin,Oconto County,6,1836,932,904
Wisconsin,Oconto County,7,1913,986,927
Wisconsin,Oconto County,8,2141,1103,1038
Wisconsin,Oconto County,9,2130,1113,1017
Wisconsin,Oconto County,10,2407,1179,1228
Wisconsin,Oconto County,11,2968,1522,1446
Wisconsin,Oconto County,12,3475,1815,1660
Wisconsin,Oconto County,13,3174,1636,1538
Wisconsin,Oconto County,14,2739,1472,1267
Wisconsin,Oconto County,15,1957,994,963
Wisconsin,Oconto County,16,1422,703,719
Wisconsin,Oconto County,17,861,416,445
Wisconsin,Oconto County,18,734,274,460
Wisconsin,Oneida County,0,35470,17794,17676
Wisconsin,Oneida County,1,1565,822,743
Wisconsin,Oneida County,2,1682,868,814
Wisconsin,Oneida County,3,1778,925,853
Wisconsin,Oneida County,4,1571,783,788
Wisconsin,Oneida County,5,1641,835,806
Wisconsin,Oneida County,6,1755,929,826
Wisconsin,Oneida County,7,1633,854,779
Wisconsin,Oneida County,8,1807,936,871
Wisconsin,Oneida County,9,1681,862,819
Wisconsin,Oneida County,10,1966,1016,950
Wisconsin,Oneida County,11,2560,1243,1317
Wisconsin,Oneida County,12,3256,1604,1652
Wisconsin,Oneida County,13,3341,1654,1687
Wisconsin,Oneida County,14,3062,1578,1484
Wisconsin,Oneida County,15,2262,1150,1112
Wisconsin,Oneida County,16,1760,852,908
Wisconsin,Oneida County,17,1097,478,619
Wisconsin,Oneida County,18,1053,405,648
Wisconsin,Outagamie County,0,187365,93674,93691
Wisconsin,Outagamie County,1,11725,6143,5582
Wisconsin,Outagamie County,2,12114,6252,5862
Wisconsin,Outagamie County,3,12543,6396,6147
Wisconsin,Outagamie County,4,12165,6253,5912
Wisconsin,Outagamie County,5,11419,5874,5545
Wisconsin,Outagamie County,6,12389,6444,5945
Wisconsin,Outagamie County,7,12774,6543,6231
Wisconsin,Outagamie County,8,12935,6568,6367
Wisconsin,Outagamie County,9,11332,5830,5502
Wisconsin,Outagamie County,10,11621,5796,5825
Wisconsin,Outagamie County,11,13095,6480,6615
Wisconsin,Outagamie County,12,13948,6857,7091
Wisconsin,Outagamie County,13,11716,5795,5921
Wisconsin,Outagamie County,14,9299,4543,4756
Wisconsin,Outagamie County,15,6837,3182,3655
Wisconsin,Outagamie County,16,4839,2155,2684
Wisconsin,Outagamie County,17,3250,1374,1876
Wisconsin,Outagamie County,18,3364,1189,2175
Wisconsin,Ozaukee County,0,89147,43841,45306
Wisconsin,Ozaukee County,1,4583,2337,2246
Wisconsin,Ozaukee County,2,5181,2670,2511
Wisconsin,Ozaukee County,3,5592,2878,2714
Wisconsin,Ozaukee County,4,6145,3126,3019
Wisconsin,Ozaukee County,5,5296,2734,2562
Wisconsin,Ozaukee County,6,4045,2069,1976
Wisconsin,Ozaukee County,7,4640,2329,2311
Wisconsin,Ozaukee County,8,5294,2664,2630
Wisconsin,Ozaukee County,9,4933,2468,2465
Wisconsin,Ozaukee County,10,5646,2769,2877
Wisconsin,Ozaukee County,11,6399,3178,3221
Wisconsin,Ozaukee County,12,7027,3387,3640
Wisconsin,Ozaukee County,13,6763,3319,3444
Wisconsin,Ozaukee County,14,5576,2677,2899
Wisconsin,Ozaukee County,15,4380,2066,2314
Wisconsin,Ozaukee County,16,3113,1392,1721
Wisconsin,Ozaukee County,17,2068,885,1183
Wisconsin,Ozaukee County,18,2466,893,1573
Wisconsin,Pepin County,0,7289,3725,3564
Wisconsin,Pepin County,1,398,210,188
Wisconsin,Pepin County,2,437,233,204
Wisconsin,Pepin County,3,463,249,214
Wisconsin,Pepin County,4,354,187,167
Wisconsin,Pepin County,5,370,199,171
Wisconsin,Pepin County,6,367,190,177
Wisconsin,Pepin County,7,328,163,165
Wisconsin,Pepin County,8,435,227,208
Wisconsin,Pepin County,9,356,183,173
Wisconsin,Pepin County,10,441,216,225
Wisconsin,Pepin County,11,504,266,238
Wisconsin,Pepin County,12,565,290,275
Wisconsin,Pepin County,13,640,311,329
Wisconsin,Pepin County,14,531,272,259
Wisconsin,Pepin County,15,371,194,177
Wisconsin,Pepin County,16,299,147,152
Wisconsin,Pepin County,17,198,103,95
Wisconsin,Pepin County,18,232,85,147
Wisconsin,Pierce County,0,42555,21199,21356
Wisconsin,Pierce County,1,2060,1101,959
Wisconsin,Pierce County,2,2418,1253,1165
Wisconsin,Pierce County,3,2743,1444,1299
Wisconsin,Pierce County,4,3777,1689,2088
Wisconsin,Pierce County,5,4655,2126,2529
Wisconsin,Pierce County,6,2334,1235,1099
Wisconsin,Pierce County,7,2297,1158,1139
Wisconsin,Pierce County,8,2525,1295,1230
Wisconsin,Pierce County,9,2279,1156,1123
Wisconsin,Pierce County,10,2600,1320,1280
Wisconsin,Pierce County,11,2778,1416,1362
Wisconsin,Pierce County,12,3058,1563,1495
Wisconsin,Pierce County,13,2817,1387,1430
Wisconsin,Pierce County,14,2245,1136,1109
Wisconsin,Pierce County,15,1573,814,759
Wisconsin,Pierce County,16,1068,540,528
Wisconsin,Pierce County,17,664,321,343
Wisconsin,Pierce County,18,664,245,419
Wisconsin,Polk County,0,43598,21976,21622
Wisconsin,Polk County,1,2180,1051,1129
Wisconsin,Polk County,2,2441,1294,1147
Wisconsin,Polk County,3,2783,1423,1360
Wisconsin,Polk County,4,2552,1339,1213
Wisconsin,Polk County,5,2148,1092,1056
Wisconsin,Polk County,6,2064,1084,980
Wisconsin,Polk County,7,2175,1090,1085
Wisconsin,Polk County,8,2540,1290,1250
Wisconsin,Polk County,9,2434,1246,1188
Wisconsin,Polk County,10,2748,1387,1361
Wisconsin,Polk County,11,3202,1632,1570
Wisconsin,Polk County,12,3778,1909,1869
Wisconsin,Polk County,13,3564,1786,1778
Wisconsin,Polk County,14,3045,1562,1483
Wisconsin,Polk County,15,2182,1088,1094
Wisconsin,Polk County,16,1683,807,876
Wisconsin,Polk County,17,1081,524,557
Wisconsin,Polk County,18,998,372,626
Wisconsin,Portage County,0,70942,35759,35183
Wisconsin,Portage County,1,3535,1810,1725
Wisconsin,Portage County,2,3718,1928,1790
Wisconsin,Portage County,3,3992,2104,1888
Wisconsin,Portage County,4,5688,2825,2863
Wisconsin,Portage County,5,8350,4351,3999
Wisconsin,Portage County,6,4424,2334,2090
Wisconsin,Portage County,7,3916,2038,1878
Wisconsin,Portage County,8,4080,2123,1957
Wisconsin,Portage County,9,3730,1878,1852
Wisconsin,Portage County,10,3783,1953,1830
Wisconsin,Portage County,11,4397,2207,2190
Wisconsin,Portage County,12,4890,2445,2445
Wisconsin,Portage County,13,4609,2278,2331
Wisconsin,Portage County,14,4010,1980,2030
Wisconsin,Portage County,15,2891,1418,1473
Wisconsin,Portage County,16,2103,956,1147
Wisconsin,Portage County,17,1407,647,760
Wisconsin,Portage County,18,1419,484,935
Wisconsin,Price County,0,13397,6820,6577
Wisconsin,Price County,1,601,298,303
Wisconsin,Price County,2,605,323,282
Wisconsin,Price County,3,717,357,360
Wisconsin,Price County,4,755,409,346
Wisconsin,Price County,5,570,286,284
Wisconsin,Price County,6,507,261,246
Wisconsin,Price County,7,498,264,234
Wisconsin,Price County,8,622,312,310
Wisconsin,Price County,9,725,355,370
Wisconsin,Price County,10,805,421,384
Wisconsin,Price County,11,1003,517,486
Wisconsin,Price County,12,1217,643,574
Wisconsin,Price County,13,1335,691,644
Wisconsin,Price County,14,1144,577,567
Wisconsin,Price County,15,824,449,375
Wisconsin,Price County,16,640,316,324
Wisconsin,Price County,17,435,206,229
Wisconsin,Price County,18,394,135,259
Wisconsin,Racine County,0,196584,97314,99270
Wisconsin,Racine County,1,12010,6249,5761
Wisconsin,Racine County,2,12539,6369,6170
Wisconsin,Racine County,3,12852,6552,6300
Wisconsin,Racine County,4,12512,6458,6054
Wisconsin,Racine County,5,11982,6377,5605
Wisconsin,Racine County,6,11802,6033,5769
Wisconsin,Racine County,7,11789,5856,5933
Wisconsin,Racine County,8,12371,6145,6226
Wisconsin,Racine County,9,11233,5632,5601
Wisconsin,Racine County,10,12419,6127,6292
Wisconsin,Racine County,11,13972,6916,7056
Wisconsin,Racine County,12,14973,7383,7590
Wisconsin,Racine County,13,13670,6678,6992
Wisconsin,Racine County,14,10832,5285,5547
Wisconsin,Racine County,15,8110,3756,4354
Wisconsin,Racine County,16,5623,2512,3111
Wisconsin,Racine County,17,3741,1562,2179
Wisconsin,Racine County,18,4154,1424,2730
Wisconsin,Richland County,0,17377,8740,8637
Wisconsin,Richland County,1,910,456,454
Wisconsin,Richland County,2,1008,509,499
Wisconsin,Richland County,3,1211,639,572
Wisconsin,Richland County,4,1027,531,496
Wisconsin,Richland County,5,876,454,422
Wisconsin,Richland County,6,817,435,382
Wisconsin,Richland County,7,841,427,414
Wisconsin,Richland County,8,889,452,437
Wisconsin,Richland County,9,974,538,436
Wisconsin,Richland County,10,1024,510,514
Wisconsin,Richland County,11,1058,517,541
Wisconsin,Richland County,12,1361,665,696
Wisconsin,Richland County,13,1409,704,705
Wisconsin,Richland County,14,1331,699,632
Wisconsin,Richland County,15,898,450,448
Wisconsin,Richland County,16,698,332,366
Wisconsin,Richland County,17,468,215,253
Wisconsin,Richland County,18,577,207,370
Wisconsin,Rock County,0,163129,80393,82736
Wisconsin,Rock County,1,9945,5228,4717
Wisconsin,Rock County,2,10036,5180,4856
Wisconsin,Rock County,3,11056,5613,5443
Wisconsin,Rock County,4,10793,5543,5250
Wisconsin,Rock County,5,9913,5032,4881
Wisconsin,Rock County,6,10069,5178,4891
Wisconsin,Rock County,7,9986,4893,5093
Wisconsin,Rock County,8,10367,5120,5247
Wisconsin,Rock County,9,9609,4813,4796
Wisconsin,Rock County,10,10349,5065,5284
Wisconsin,Rock County,11,11149,5484,5665
Wisconsin,Rock County,12,11914,5873,6041
Wisconsin,Rock County,13,10921,5324,5597
Wisconsin,Rock County,14,8804,4219,4585
Wisconsin,Rock County,15,6746,3109,3637
Wisconsin,Rock County,16,4811,2159,2652
Wisconsin,Rock County,17,3309,1441,1868
Wisconsin,Rock County,18,3352,1119,2233
Wisconsin,Rusk County,0,14147,7180,6967
Wisconsin,Rusk County,1,739,382,357
Wisconsin,Rusk County,2,753,407,346
Wisconsin,Rusk County,3,828,425,403
Wisconsin,Rusk County,4,824,424,400
Wisconsin,Rusk County,5,673,361,312
Wisconsin,Rusk County,6,646,339,307
Wisconsin,Rusk County,7,583,280,303
Wisconsin,Rusk County,8,691,371,320
Wisconsin,Rusk County,9,745,376,369
Wisconsin,Rusk County,10,785,395,390
Wisconsin,Rusk County,11,990,502,488
Wisconsin,Rusk County,12,1225,644,581
Wisconsin,Rusk County,13,1241,633,608
Wisconsin,Rusk County,14,1121,574,547
Wisconsin,Rusk County,15,850,447,403
Wisconsin,Rusk County,16,566,280,286
Wisconsin,Rusk County,17,422,184,238
Wisconsin,Rusk County,18,465,156,309
Wisconsin,St. Croix County,0,89694,44793,44901
Wisconsin,St. Croix County,1,5519,2764,2755
Wisconsin,St. Croix County,2,5971,3036,2935
Wisconsin,St. Croix County,3,6823,3479,3344
Wisconsin,St. Croix County,4,5881,3072,2809
Wisconsin,St. Croix County,5,4752,2384,2368
Wisconsin,St. Croix County,6,4881,2479,2402
Wisconsin,St. Croix County,7,5472,2765,2707
Wisconsin,St. Croix County,8,6351,3114,3237
Wisconsin,St. Croix County,9,6096,3071,3025
Wisconsin,St. Croix County,10,6265,3166,3099
Wisconsin,St. Croix County,11,6358,3248,3110
Wisconsin,St. Croix County,12,6867,3365,3502
Wisconsin,St. Croix County,13,5830,2925,2905
Wisconsin,St. Croix County,14,4499,2234,2265
Wisconsin,St. Croix County,15,3277,1617,1660
Wisconsin,St. Croix County,16,2118,983,1135
Wisconsin,St. Croix County,17,1356,613,743
Wisconsin,St. Croix County,18,1378,478,900
Wisconsin,Sauk County,0,64249,32060,32189
Wisconsin,Sauk County,1,3912,1992,1920
Wisconsin,Sauk County,2,3987,2074,1913
Wisconsin,Sauk County,3,4180,2157,2023
Wisconsin,Sauk County,4,3855,2021,1834
Wisconsin,Sauk County,5,3535,1789,1746
Wisconsin,Sauk County,6,3604,1863,1741
Wisconsin,Sauk County,7,3951,2011,1940
Wisconsin,Sauk County,8,4197,2187,2010
Wisconsin,Sauk County,9,3615,1810,1805
Wisconsin,Sauk County,10,4041,2072,1969
Wisconsin,Sauk County,11,4239,2099,2140
Wisconsin,Sauk County,12,4777,2344,2433
Wisconsin,Sauk County,13,4456,2262,2194
Wisconsin,Sauk County,14,3934,1917,2017
Wisconsin,Sauk County,15,3000,1436,1564
Wisconsin,Sauk County,16,2050,936,1114
Wisconsin,Sauk County,17,1346,595,751
Wisconsin,Sauk County,18,1570,495,1075
Wisconsin,Sawyer County,0,16489,8421,8068
Wisconsin,Sawyer County,1,834,424,410
Wisconsin,Sawyer County,2,900,465,435
Wisconsin,Sawyer County,3,946,481,465
Wisconsin,Sawyer County,4,829,441,388
Wisconsin,Sawyer County,5,731,386,345
Wisconsin,Sawyer County,6,725,397,328
Wisconsin,Sawyer County,7,712,381,331
Wisconsin,Sawyer County,8,787,395,392
Wisconsin,Sawyer County,9,716,366,350
Wisconsin,Sawyer County,10,896,450,446
Wisconsin,Sawyer County,11,1092,553,539
Wisconsin,Sawyer County,12,1421,733,688
Wisconsin,Sawyer County,13,1625,797,828
Wisconsin,Sawyer County,14,1481,774,707
Wisconsin,Sawyer County,15,1115,568,547
Wisconsin,Sawyer County,16,798,402,396
Wisconsin,Sawyer County,17,467,242,225
Wisconsin,Sawyer County,18,414,166,248
Wisconsin,Shawano County,0,40796,20414,20382
Wisconsin,Shawano County,1,2180,1127,1053
Wisconsin,Shawano County,2,2334,1146,1188
Wisconsin,Shawano County,3,2621,1340,1281
Wisconsin,Shawano County,4,2385,1226,1159
Wisconsin,Shawano County,5,1981,1023,958
Wisconsin,Shawano County,6,2156,1070,1086
Wisconsin,Shawano County,7,2059,1040,1019
Wisconsin,Shawano County,8,2279,1157,1122
Wisconsin,Shawano County,9,2146,1073,1073
Wisconsin,Shawano County,10,2563,1318,1245
Wisconsin,Shawano County,11,3026,1514,1512
Wisconsin,Shawano County,12,3351,1730,1621
Wisconsin,Shawano County,13,3094,1557,1537
Wisconsin,Shawano County,14,2682,1415,1267
Wisconsin,Shawano County,15,2121,1008,1113
Wisconsin,Shawano County,16,1689,796,893
Wisconsin,Shawano County,17,1076,471,605
Wisconsin,Shawano County,18,1053,403,650
Wisconsin,Sheboygan County,0,115456,58114,57342
Wisconsin,Sheboygan County,1,6304,3213,3091
Wisconsin,Sheboygan County,2,6949,3517,3432
Wisconsin,Sheboygan County,3,7624,3885,3739
Wisconsin,Sheboygan County,4,7220,3802,3418
Wisconsin,Sheboygan County,5,6967,3642,3325
Wisconsin,Sheboygan County,6,6796,3619,3177
Wisconsin,Sheboygan County,7,6644,3436,3208
Wisconsin,Sheboygan County,8,7168,3744,3424
Wisconsin,Sheboygan County,9,6672,3422,3250
Wisconsin,Sheboygan County,10,7154,3723,3431
Wisconsin,Sheboygan County,11,8117,4152,3965
Wisconsin,Sheboygan County,12,8731,4351,4380
Wisconsin,Sheboygan County,13,8321,4208,4113
Wisconsin,Sheboygan County,14,6868,3336,3532
Wisconsin,Sheboygan County,15,5089,2388,2701
Wisconsin,Sheboygan County,16,3563,1663,1900
Wisconsin,Sheboygan County,17,2458,1031,1427
Wisconsin,Sheboygan County,18,2811,982,1829
Wisconsin,Taylor County,0,20412,10374,10038
Wisconsin,Taylor County,1,1182,599,583
Wisconsin,Taylor County,2,1283,669,614
Wisconsin,Taylor County,3,1439,733,706
Wisconsin,Taylor County,4,1281,671,610
Wisconsin,Taylor County,5,977,503,474
Wisconsin,Taylor County,6,973,519,454
Wisconsin,Taylor County,7,1036,517,519
Wisconsin,Taylor County,8,1187,605,582
Wisconsin,Taylor County,9,1196,615,581
Wisconsin,Taylor County,10,1205,638,567
Wisconsin,Taylor County,11,1392,713,679
Wisconsin,Taylor County,12,1748,894,854
Wisconsin,Taylor County,13,1608,830,778
Wisconsin,Taylor County,14,1234,644,590
Wisconsin,Taylor County,15,852,431,421
Wisconsin,Taylor County,16,718,344,374
Wisconsin,Taylor County,17,536,262,274
Wisconsin,Taylor County,18,565,187,378
Wisconsin,Trempealeau County,0,29442,14964,14478
Wisconsin,Trempealeau County,1,2069,1085,984
Wisconsin,Trempealeau County,2,2040,1044,996
Wisconsin,Trempealeau County,3,2044,1065,979
Wisconsin,Trempealeau County,4,1793,932,861
Wisconsin,Trempealeau County,5,1444,718,726
Wisconsin,Trempealeau County,6,1607,819,788
Wisconsin,Trempealeau County,7,1614,831,783
Wisconsin,Trempealeau County,8,1771,887,884
Wisconsin,Trempealeau County,9,1598,845,753
Wisconsin,Trempealeau County,10,1892,972,920
Wisconsin,Trempealeau County,11,2057,1063,994
Wisconsin,Trempealeau County,12,2156,1125,1031
Wisconsin,Trempealeau County,13,2027,1043,984
Wisconsin,Trempealeau County,14,1757,919,838
Wisconsin,Trempealeau County,15,1293,643,650
Wisconsin,Trempealeau County,16,953,450,503
Wisconsin,Trempealeau County,17,652,280,372
Wisconsin,Trempealeau County,18,675,243,432
Wisconsin,Vernon County,0,30785,15498,15287
Wisconsin,Vernon County,1,2132,1104,1028
Wisconsin,Vernon County,2,2229,1124,1105
Wisconsin,Vernon County,3,2275,1174,1101
Wisconsin,Vernon County,4,2072,1089,983
Wisconsin,Vernon County,5,1448,759,689
Wisconsin,Vernon County,6,1393,717,676
Wisconsin,Vernon County,7,1512,752,760
Wisconsin,Vernon County,8,1685,845,840
Wisconsin,Vernon County,9,1581,817,764
Wisconsin,Vernon County,10,1688,819,869
Wisconsin,Vernon County,11,1972,972,1000
Wisconsin,Vernon County,12,2397,1212,1185
Wisconsin,Vernon County,13,2390,1238,1152
Wisconsin,Vernon County,14,1999,1032,967
Wisconsin,Vernon County,15,1450,723,727
Wisconsin,Vernon County,16,1034,488,546
Wisconsin,Vernon County,17,691,334,357
Wisconsin,Vernon County,18,837,299,538
Wisconsin,Vilas County,0,21938,11134,10804
Wisconsin,Vilas County,1,978,470,508
Wisconsin,Vilas County,2,955,507,448
Wisconsin,Vilas County,3,1076,567,509
Wisconsin,Vilas County,4,1043,553,490
Wisconsin,Vilas County,5,827,457,370
Wisconsin,Vilas County,6,838,459,379
Wisconsin,Vilas County,7,891,462,429
Wisconsin,Vilas County,8,859,441,418
Wisconsin,Vilas County,9,879,451,428
Wisconsin,Vilas County,10,1135,579,556
Wisconsin,Vilas County,11,1569,786,783
Wisconsin,Vilas County,12,2010,1007,1003
Wisconsin,Vilas County,13,2120,1074,1046
Wisconsin,Vilas County,14,2099,1049,1050
Wisconsin,Vilas County,15,1737,889,848
Wisconsin,Vilas County,16,1351,628,723
Wisconsin,Vilas County,17,838,428,410
Wisconsin,Vilas County,18,733,327,406
Wisconsin,Walworth County,0,103718,51797,51921
Wisconsin,Walworth County,1,5071,2580,2491
Wisconsin,Walworth County,2,5697,2924,2773
Wisconsin,Walworth County,3,6537,3376,3161
Wisconsin,Walworth County,4,7824,4069,3755
Wisconsin,Walworth County,5,9663,4805,4858
Wisconsin,Walworth County,6,5483,2959,2524
Wisconsin,Walworth County,7,5324,2740,2584
Wisconsin,Walworth County,8,5738,2907,2831
Wisconsin,Walworth County,9,5646,2791,2855
Wisconsin,Walworth County,10,6245,3158,3087
Wisconsin,Walworth County,11,6915,3384,3531
Wisconsin,Walworth County,12,7914,3908,4006
Wisconsin,Walworth County,13,7327,3639,3688
Wisconsin,Walworth County,14,6167,3018,3149
Wisconsin,Walworth County,15,4721,2329,2392
Wisconsin,Walworth County,16,3200,1523,1677
Wisconsin,Walworth County,17,2069,878,1191
Wisconsin,Walworth County,18,2177,809,1368
Wisconsin,Washburn County,0,15878,7861,8017
Wisconsin,Washburn County,1,748,383,365
Wisconsin,Washburn County,2,820,427,393
Wisconsin,Washburn County,3,938,486,452
Wisconsin,Washburn County,4,790,385,405
Wisconsin,Washburn County,5,642,321,321
Wisconsin,Washburn County,6,643,316,327
Wisconsin,Washburn County,7,735,331,404
Wisconsin,Washburn County,8,791,407,384
Wisconsin,Washburn County,9,719,365,354
Wisconsin,Washburn County,10,899,449,450
Wisconsin,Washburn County,11,1065,533,532
Wisconsin,Washburn County,12,1445,699,746
Wisconsin,Washburn County,13,1474,714,760
Wisconsin,Washburn County,14,1397,726,671
Wisconsin,Washburn County,15,1117,597,520
Wisconsin,Washburn County,16,698,347,351
Wisconsin,Washburn County,17,469,211,258
Wisconsin,Washburn County,18,488,164,324
Wisconsin,Washington County,0,135693,67452,68241
Wisconsin,Washington County,1,7133,3610,3523
Wisconsin,Washington County,2,8028,3966,4062
Wisconsin,Washington County,3,8932,4521,4411
Wisconsin,Washington County,4,8592,4402,4190
Wisconsin,Washington County,5,6932,3584,3348
Wisconsin,Washington County,6,6875,3593,3282
Wisconsin,Washington County,7,7471,3803,3668
Wisconsin,Washington County,8,8598,4359,4239
Wisconsin,Washington County,9,7983,4034,3949
Wisconsin,Washington County,10,9107,4590,4517
Wisconsin,Washington County,11,10686,5372,5314
Wisconsin,Washington County,12,11291,5676,5615
Wisconsin,Washington County,13,9660,4782,4878
Wisconsin,Washington County,14,8085,3945,4140
Wisconsin,Washington County,15,5980,2853,3127
Wisconsin,Washington County,16,4311,1962,2349
Wisconsin,Washington County,17,2896,1265,1631
Wisconsin,Washington County,18,3133,1135,1998
Wisconsin,Waukesha County,0,403072,198189,204883
Wisconsin,Waukesha County,1,20853,10735,10118
Wisconsin,Waukesha County,2,23057,11620,11437
Wisconsin,Waukesha County,3,25949,13271,12678
Wisconsin,Waukesha County,4,26237,13639,12598
Wisconsin,Waukesha County,5,21968,10972,10996
Wisconsin,Waukesha County,6,19958,10292,9666
Wisconsin,Waukesha County,7,22232,11155,11077
Wisconsin,Waukesha County,8,25733,12934,12799
Wisconsin,Waukesha County,9,24011,12082,11929
Wisconsin,Waukesha County,10,25996,12800,13196
Wisconsin,Waukesha County,11,29226,14287,14939
Wisconsin,Waukesha County,12,32900,16097,16803
Wisconsin,Waukesha County,13,29762,14663,15099
Wisconsin,Waukesha County,14,24451,11778,12673
Wisconsin,Waukesha County,15,18560,8803,9757
Wisconsin,Waukesha County,16,12675,5660,7015
Wisconsin,Waukesha County,17,8992,3793,5199
Wisconsin,Waukesha County,18,10512,3608,6904
Wisconsin,Waupaca County,0,51128,25940,25188
Wisconsin,Waupaca County,1,2575,1330,1245
Wisconsin,Waupaca County,2,2742,1402,1340
Wisconsin,Waupaca County,3,3057,1604,1453
Wisconsin,Waupaca County,4,2998,1578,1420
Wisconsin,Waupaca County,5,2571,1346,1225
Wisconsin,Waupaca County,6,2703,1357,1346
Wisconsin,Waupaca County,7,2673,1377,1296
Wisconsin,Waupaca County,8,2938,1507,1431
Wisconsin,Waupaca County,9,2871,1463,1408
Wisconsin,Waupaca County,10,3158,1605,1553
Wisconsin,Waupaca County,11,3720,1873,1847
Wisconsin,Waupaca County,12,4392,2252,2140
Wisconsin,Waupaca County,13,4061,2085,1976
Wisconsin,Waupaca County,14,3304,1652,1652
Wisconsin,Waupaca County,15,2479,1258,1221
Wisconsin,Waupaca County,16,1841,887,954
Wisconsin,Waupaca County,17,1360,649,711
Wisconsin,Waupaca County,18,1685,715,970
Wisconsin,Waushara County,0,24263,12764,11499
Wisconsin,Waushara County,1,1152,594,558
Wisconsin,Waushara County,2,1178,594,584
Wisconsin,Waushara County,3,1264,599,665
Wisconsin,Waushara County,4,1270,661,609
Wisconsin,Waushara County,5,1073,594,479
Wisconsin,Waushara County,6,1162,694,468
Wisconsin,Waushara County,7,1200,702,498
Wisconsin,Waushara County,8,1276,734,542
Wisconsin,Waushara County,9,1263,733,530
Wisconsin,Waushara County,10,1439,781,658
Wisconsin,Waushara County,11,1788,982,806
Wisconsin,Waushara County,12,2151,1081,1070
Wisconsin,Waushara County,13,2135,1118,1017
Wisconsin,Waushara County,14,1926,986,940
Wisconsin,Waushara County,15,1515,767,748
Wisconsin,Waushara County,16,1054,515,539
Wisconsin,Waushara County,17,745,369,376
Wisconsin,Waushara County,18,672,260,412
Wisconsin,Winnebago County,0,171020,86063,84957
Wisconsin,Winnebago County,1,9464,4802,4662
Wisconsin,Winnebago County,2,9639,4992,4647
Wisconsin,Winnebago County,3,9923,5045,4878
Wisconsin,Winnebago County,4,11378,5631,5747
Wisconsin,Winnebago County,5,14775,7386,7389
Wisconsin,Winnebago County,6,11823,6418,5405
Wisconsin,Winnebago County,7,10867,5816,5051
Wisconsin,Winnebago County,8,10803,5682,5121
Wisconsin,Winnebago County,9,9782,5191,4591
Wisconsin,Winnebago County,10,10381,5423,4958
Wisconsin,Winnebago County,11,11153,5712,5441
Wisconsin,Winnebago County,12,12093,6026,6067
Wisconsin,Winnebago County,13,10917,5395,5522
Wisconsin,Winnebago County,14,9023,4398,4625
Wisconsin,Winnebago County,15,6726,3162,3564
Wisconsin,Winnebago County,16,4765,2161,2604
Wisconsin,Winnebago County,17,3549,1438,2111
Wisconsin,Winnebago County,18,3959,1385,2574
Wisconsin,Wood County,0,73055,35949,37106
Wisconsin,Wood County,1,4139,2077,2062
Wisconsin,Wood County,2,4362,2247,2115
Wisconsin,Wood County,3,4548,2258,2290
Wisconsin,Wood County,4,4144,2129,2015
Wisconsin,Wood County,5,3789,1929,1860
Wisconsin,Wood County,6,4043,2053,1990
Wisconsin,Wood County,7,4112,2110,2002
Wisconsin,Wood County,8,4216,2115,2101
Wisconsin,Wood County,9,3856,1946,1910
Wisconsin,Wood County,10,4324,2159,2165
Wisconsin,Wood County,11,4995,2481,2514
Wisconsin,Wood County,12,5983,2976,3007
Wisconsin,Wood County,13,5522,2699,2823
Wisconsin,Wood County,14,4590,2217,2373
Wisconsin,Wood County,15,3585,1716,1869
Wisconsin,Wood County,16,2665,1215,1450
Wisconsin,Wood County,17,1995,841,1154
Wisconsin,Wood County,18,2187,781,1406
Wyoming,Albany County,0,38601,20145,18456
Wyoming,Albany County,1,1843,954,889
Wyoming,Albany County,2,1761,934,827
Wyoming,Albany County,3,1715,882,833
Wyoming,Albany County,4,3216,1660,1556
Wyoming,Albany County,5,8491,4549,3942
Wyoming,Albany County,6,3794,2129,1665
Wyoming,Albany County,7,2374,1313,1061
Wyoming,Albany County,8,2178,1129,1049
Wyoming,Albany County,9,1825,984,841
Wyoming,Albany County,10,1580,820,760
Wyoming,Albany County,11,1523,782,741
Wyoming,Albany County,12,1797,890,907
Wyoming,Albany County,13,1974,975,999
Wyoming,Albany County,14,1736,876,860
Wyoming,Albany County,15,1115,546,569
Wyoming,Albany County,16,763,361,402
Wyoming,Albany County,17,466,201,265
Wyoming,Albany County,18,450,160,290
Wyoming,Big Horn County,0,11881,5982,5899
Wyoming,Big Horn County,1,746,379,367
Wyoming,Big Horn County,2,812,406,406
Wyoming,Big Horn County,3,916,450,466
Wyoming,Big Horn County,4,797,400,397
Wyoming,Big Horn County,5,597,314,283
Wyoming,Big Horn County,6,576,303,273
Wyoming,Big Horn County,7,662,349,313
Wyoming,Big Horn County,8,678,347,331
Wyoming,Big Horn County,9,636,329,307
Wyoming,Big Horn County,10,638,328,310
Wyoming,Big Horn County,11,690,347,343
Wyoming,Big Horn County,12,785,400,385
Wyoming,Big Horn County,13,853,423,430
Wyoming,Big Horn County,14,795,385,410
Wyoming,Big Horn County,15,641,331,310
Wyoming,Big Horn County,16,485,242,243
Wyoming,Big Horn County,17,292,133,159
Wyoming,Big Horn County,18,282,116,166
Wyoming,Campbell County,0,46140,23779,22361
Wyoming,Campbell County,1,3412,1768,1644
Wyoming,Campbell County,2,3576,1815,1761
Wyoming,Campbell County,3,3675,1852,1823
Wyoming,Campbell County,4,3026,1659,1367
Wyoming,Campbell County,5,2560,1373,1187
Wyoming,Campbell County,6,3331,1652,1679
Wyoming,Campbell County,7,3639,1938,1701
Wyoming,Campbell County,8,3591,1857,1734
Wyoming,Campbell County,9,3012,1553,1459
Wyoming,Campbell County,10,2669,1415,1254
Wyoming,Campbell County,11,2539,1277,1262
Wyoming,Campbell County,12,3403,1737,1666
Wyoming,Campbell County,13,3065,1657,1408
Wyoming,Campbell County,14,2007,1033,974
Wyoming,Campbell County,15,1189,586,603
Wyoming,Campbell County,16,676,312,364
Wyoming,Campbell County,17,404,157,247
Wyoming,Campbell County,18,366,138,228
Wyoming,Carbon County,0,14971,8081,6890
Wyoming,Carbon County,1,949,497,452
Wyoming,Carbon County,2,968,513,455
Wyoming,Carbon County,3,949,495,454
Wyoming,Carbon County,4,881,463,418
Wyoming,Carbon County,5,768,463,305
Wyoming,Carbon County,6,1066,621,445
Wyoming,Carbon County,7,1091,620,471
Wyoming,Carbon County,8,1029,574,455
Wyoming,Carbon County,9,895,500,395
Wyoming,Carbon County,10,828,466,362
Wyoming,Carbon County,11,819,440,379
Wyoming,Carbon County,12,1036,552,484
Wyoming,Carbon County,13,1129,590,539
Wyoming,Carbon County,14,939,469,470
Wyoming,Carbon County,15,646,359,287
Wyoming,Carbon County,16,445,217,228
Wyoming,Carbon County,17,276,132,144
Wyoming,Carbon County,18,257,110,147
Wyoming,Converse County,0,13640,6927,6713
Wyoming,Converse County,1,873,469,404
Wyoming,Converse County,2,938,456,482
Wyoming,Converse County,3,985,520,465
Wyoming,Converse County,4,872,429,443
Wyoming,Converse County,5,658,340,318
Wyoming,Converse County,6,781,382,399
Wyoming,Converse County,7,887,448,439
Wyoming,Converse County,8,849,453,396
Wyoming,Converse County,9,825,412,413
Wyoming,Converse County,10,822,443,379
Wyoming,Converse County,11,867,433,434
Wyoming,Converse County,12,985,498,487
Wyoming,Converse County,13,1031,551,480
Wyoming,Converse County,14,774,407,367
Wyoming,Converse County,15,605,292,313
Wyoming,Converse County,16,377,178,199
Wyoming,Converse County,17,283,123,160
Wyoming,Converse County,18,228,93,135
Wyoming,Crook County,0,7450,3785,3665
Wyoming,Crook County,1,536,279,257
Wyoming,Crook County,2,500,241,259
Wyoming,Crook County,3,494,250,244
Wyoming,Crook County,4,410,221,189
Wyoming,Crook County,5,289,145,144
Wyoming,Crook County,6,378,197,181
Wyoming,Crook County,7,391,199,192
Wyoming,Crook County,8,398,221,177
Wyoming,Crook County,9,347,198,149
Wyoming,Crook County,10,408,186,222
Wyoming,Crook County,11,493,245,248
Wyoming,Crook County,12,599,282,317
Wyoming,Crook County,13,670,343,327
Wyoming,Crook County,14,567,296,271
Wyoming,Crook County,15,373,192,181
Wyoming,Crook County,16,282,146,136
Wyoming,Crook County,17,156,79,77
Wyoming,Crook County,18,159,65,94
Wyoming,Fremont County,0,39531,19826,19705
Wyoming,Fremont County,1,2668,1362,1306
Wyoming,Fremont County,2,2917,1504,1413
Wyoming,Fremont County,3,2921,1507,1414
Wyoming,Fremont County,4,2531,1320,1211
Wyoming,Fremont County,5,2093,1135,958
Wyoming,Fremont County,6,2333,1169,1164
Wyoming,Fremont County,7,2458,1251,1207
Wyoming,Fremont County,8,2444,1203,1241
Wyoming,Fremont County,9,2049,1069,980
Wyoming,Fremont County,10,2118,1082,1036
Wyoming,Fremont County,11,2195,1091,1104
Wyoming,Fremont County,12,2742,1350,1392
Wyoming,Fremont County,13,2840,1388,1452
Wyoming,Fremont County,14,2504,1224,1280
Wyoming,Fremont County,15,1890,934,956
Wyoming,Fremont County,16,1241,581,660
Wyoming,Fremont County,17,782,349,433
Wyoming,Fremont County,18,805,307,498
Wyoming,Goshen County,0,13376,6983,6393
Wyoming,Goshen County,1,771,384,387
Wyoming,Goshen County,2,691,356,335
Wyoming,Goshen County,3,745,390,355
Wyoming,Goshen County,4,891,424,467
Wyoming,Goshen County,5,824,474,350
Wyoming,Goshen County,6,773,423,350
Wyoming,Goshen County,7,787,461,326
Wyoming,Goshen County,8,810,441,369
Wyoming,Goshen County,9,689,397,292
Wyoming,Goshen County,10,755,444,311
Wyoming,Goshen County,11,764,428,336
Wyoming,Goshen County,12,927,468,459
Wyoming,Goshen County,13,1015,522,493
Wyoming,Goshen County,14,851,449,402
Wyoming,Goshen County,15,719,342,377
Wyoming,Goshen County,16,560,261,299
Wyoming,Goshen County,17,360,166,194
Wyoming,Goshen County,18,444,153,291
Wyoming,Hot Springs County,0,4555,2298,2257
Wyoming,Hot Springs County,1,232,123,109
Wyoming,Hot Springs County,2,267,159,108
Wyoming,Hot Springs County,3,303,155,148
Wyoming,Hot Springs County,4,245,127,118
Wyoming,Hot Springs County,5,178,89,89
Wyoming,Hot Springs County,6,200,96,104
Wyoming,Hot Springs County,7,247,137,110
Wyoming,Hot Springs County,8,244,131,113
Wyoming,Hot Springs County,9,219,113,106
Wyoming,Hot Springs County,10,238,112,126
Wyoming,Hot Springs County,11,248,131,117
Wyoming,Hot Springs County,12,348,181,167
Wyoming,Hot Springs County,13,392,177,215
Wyoming,Hot Springs County,14,341,166,175
Wyoming,Hot Springs County,15,301,149,152
Wyoming,Hot Springs County,16,220,102,118
Wyoming,Hot Springs County,17,183,92,91
Wyoming,Hot Springs County,18,149,58,91
Wyoming,Johnson County,0,8460,4265,4195
Wyoming,Johnson County,1,410,214,196
Wyoming,Johnson County,2,544,305,239
Wyoming,Johnson County,3,610,322,288
Wyoming,Johnson County,4,432,232,200
Wyoming,Johnson County,5,355,184,171
Wyoming,Johnson County,6,351,175,176
Wyoming,Johnson County,7,468,208,260
Wyoming,Johnson County,8,536,268,268
Wyoming,Johnson County,9,442,222,220
Wyoming,Johnson County,10,489,247,242
Wyoming,Johnson County,11,469,211,258
Wyoming,Johnson County,12,603,299,304
Wyoming,Johnson County,13,747,360,387
Wyoming,Johnson County,14,659,345,314
Wyoming,Johnson County,15,519,276,243
Wyoming,Johnson County,16,346,178,168
Wyoming,Johnson County,17,243,120,123
Wyoming,Johnson County,18,237,99,138
Wyoming,Laramie County,0,98976,50170,48806
Wyoming,Laramie County,1,6239,3276,2963
Wyoming,Laramie County,2,6495,3318,3177
Wyoming,Laramie County,3,6586,3377,3209
Wyoming,Laramie County,4,5904,3029,2875
Wyoming,Laramie County,5,6578,3644,2934
Wyoming,Laramie County,6,7603,3992,3611
Wyoming,Laramie County,7,7096,3655,3441
Wyoming,Laramie County,8,6681,3511,3170
Wyoming,Laramie County,9,5511,2845,2666
Wyoming,Laramie County,10,5746,2896,2850
Wyoming,Laramie County,11,5782,2985,2797
Wyoming,Laramie County,12,6672,3302,3370
Wyoming,Laramie County,13,6219,2961,3258
Wyoming,Laramie County,14,5388,2656,2732
Wyoming,Laramie County,15,4111,2013,2098
Wyoming,Laramie County,16,2716,1262,1454
Wyoming,Laramie County,17,1741,766,975
Wyoming,Laramie County,18,1908,682,1226
Wyoming,Lincoln County,0,19434,9930,9504
Wyoming,Lincoln County,1,1312,661,651
Wyoming,Lincoln County,2,1422,772,650
Wyoming,Lincoln County,3,1549,787,762
Wyoming,Lincoln County,4,1269,667,602
Wyoming,Lincoln County,5,893,460,433
Wyoming,Lincoln County,6,840,411,429
Wyoming,Lincoln County,7,1061,534,527
Wyoming,Lincoln County,8,1266,657,609
Wyoming,Lincoln County,9,1263,653,610
Wyoming,Lincoln County,10,1149,579,570
Wyoming,Lincoln County,11,1078,543,535
Wyoming,Lincoln County,12,1366,687,679
Wyoming,Lincoln County,13,1590,814,776
Wyoming,Lincoln County,14,1243,641,602
Wyoming,Lincoln County,15,946,485,461
Wyoming,Lincoln County,16,573,290,283
Wyoming,Lincoln County,17,338,173,165
Wyoming,Lincoln County,18,276,116,160
Wyoming,Natrona County,0,79115,39860,39255
Wyoming,Natrona County,1,5236,2738,2498
Wyoming,Natrona County,2,5307,2690,2617
Wyoming,Natrona County,3,5470,2797,2673
Wyoming,Natrona County,4,4788,2525,2263
Wyoming,Natrona County,5,4375,2261,2114
Wyoming,Natrona County,6,5831,2954,2877
Wyoming,Natrona County,7,5740,3040,2700
Wyoming,Natrona County,8,5737,2903,2834
Wyoming,Natrona County,9,4741,2418,2323
Wyoming,Natrona County,10,4492,2305,2187
Wyoming,Natrona County,11,4376,2213,2163
Wyoming,Natrona County,12,5427,2720,2707
Wyoming,Natrona County,13,5415,2707,2708
Wyoming,Natrona County,14,4274,2141,2133
Wyoming,Natrona County,15,3046,1488,1558
Wyoming,Natrona County,16,1896,838,1058
Wyoming,Natrona County,17,1362,569,793
Wyoming,Natrona County,18,1602,553,1049
Wyoming,Niobrara County,0,2388,1091,1297
Wyoming,Niobrara County,1,133,61,72
Wyoming,Niobrara County,2,116,69,47
Wyoming,Niobrara County,3,98,57,41
Wyoming,Niobrara County,4,119,67,52
Wyoming,Niobrara County,5,134,44,90
Wyoming,Niobrara County,6,153,54,99
Wyoming,Niobrara County,7,163,53,110
Wyoming,Niobrara County,8,159,69,90
Wyoming,Niobrara County,9,135,55,80
Wyoming,Niobrara County,10,154,59,95
Wyoming,Niobrara County,11,117,49,68
Wyoming,Niobrara County,12,141,66,75
Wyoming,Niobrara County,13,226,108,118
Wyoming,Niobrara County,14,179,95,84
Wyoming,Niobrara County,15,118,72,46
Wyoming,Niobrara County,16,93,38,55
Wyoming,Niobrara County,17,98,48,50
Wyoming,Niobrara County,18,52,27,25
Wyoming,Park County,0,29324,14605,14719
Wyoming,Park County,1,1570,801,769
Wyoming,Park County,2,1720,887,833
Wyoming,Park County,3,1745,912,833
Wyoming,Park County,4,1733,913,820
Wyoming,Park County,5,1503,752,751
Wyoming,Park County,6,1579,806,773
Wyoming,Park County,7,1687,848,839
Wyoming,Park County,8,1756,913,843
Wyoming,Park County,9,1488,740,748
Wyoming,Park County,10,1479,724,755
Wyoming,Park County,11,1688,835,853
Wyoming,Park County,12,2202,1034,1168
Wyoming,Park County,13,2369,1156,1213
Wyoming,Park County,14,2272,1145,1127
Wyoming,Park County,15,1778,896,882
Wyoming,Park County,16,1191,607,584
Wyoming,Park County,17,777,365,412
Wyoming,Park County,18,787,271,516
Wyoming,Platte County,0,8566,4310,4256
Wyoming,Platte County,1,457,229,228
Wyoming,Platte County,2,490,248,242
Wyoming,Platte County,3,494,251,243
Wyoming,Platte County,4,437,221,216
Wyoming,Platte County,5,361,193,168
Wyoming,Platte County,6,445,244,201
Wyoming,Platte County,7,463,225,238
Wyoming,Platte County,8,440,237,203
Wyoming,Platte County,9,442,219,223
Wyoming,Platte County,10,446,206,240
Wyoming,Platte County,11,539,284,255
Wyoming,Platte County,12,692,328,364
Wyoming,Platte County,13,665,347,318
Wyoming,Platte County,14,656,349,307
Wyoming,Platte County,15,581,286,295
Wyoming,Platte County,16,420,214,206
Wyoming,Platte County,17,285,121,164
Wyoming,Platte County,18,253,108,145
Wyoming,Sheridan County,0,30233,15179,15054
Wyoming,Sheridan County,1,1661,868,793
Wyoming,Sheridan County,2,1783,913,870
Wyoming,Sheridan County,3,1923,1013,910
Wyoming,Sheridan County,4,1845,931,914
Wyoming,Sheridan County,5,1636,815,821
Wyoming,Sheridan County,6,1716,901,815
Wyoming,Sheridan County,7,1779,879,900
Wyoming,Sheridan County,8,1831,929,902
Wyoming,Sheridan County,9,1759,915,844
Wyoming,Sheridan County,10,1755,899,856
Wyoming,Sheridan County,11,1699,838,861
Wyoming,Sheridan County,12,2097,1016,1081
Wyoming,Sheridan County,13,2402,1163,1239
Wyoming,Sheridan County,14,2244,1159,1085
Wyoming,Sheridan County,15,1601,797,804
Wyoming,Sheridan County,16,1119,552,567
Wyoming,Sheridan County,17,630,300,330
Wyoming,Sheridan County,18,753,291,462
Wyoming,Sublette County,0,9813,5295,4518
Wyoming,Sublette County,1,532,274,258
Wyoming,Sublette County,2,625,330,295
Wyoming,Sublette County,3,682,372,310
Wyoming,Sublette County,4,553,307,246
Wyoming,Sublette County,5,405,214,191
Wyoming,Sublette County,6,522,288,234
Wyoming,Sublette County,7,599,317,282
Wyoming,Sublette County,8,657,349,308
Wyoming,Sublette County,9,640,344,296
Wyoming,Sublette County,10,630,347,283
Wyoming,Sublette County,11,624,353,271
Wyoming,Sublette County,12,708,392,316
Wyoming,Sublette County,13,725,372,353
Wyoming,Sublette County,14,647,358,289
Wyoming,Sublette County,15,536,286,250
Wyoming,Sublette County,16,369,185,184
Wyoming,Sublette County,17,179,100,79
Wyoming,Sublette County,18,180,107,73
Wyoming,Sweetwater County,0,43051,22152,20899
Wyoming,Sweetwater County,1,2949,1541,1408
Wyoming,Sweetwater County,2,3155,1619,1536
Wyoming,Sweetwater County,3,3311,1664,1647
Wyoming,Sweetwater County,4,3015,1548,1467
Wyoming,Sweetwater County,5,2527,1320,1207
Wyoming,Sweetwater County,6,2832,1460,1372
Wyoming,Sweetwater County,7,3191,1623,1568
Wyoming,Sweetwater County,8,3386,1748,1638
Wyoming,Sweetwater County,9,2838,1489,1349
Wyoming,Sweetwater County,10,2496,1300,1196
Wyoming,Sweetwater County,11,2382,1242,1140
Wyoming,Sweetwater County,12,2879,1506,1373
Wyoming,Sweetwater County,13,2876,1546,1330
Wyoming,Sweetwater County,14,2067,1061,1006
Wyoming,Sweetwater County,15,1365,688,677
Wyoming,Sweetwater County,16,833,423,410
Wyoming,Sweetwater County,17,478,214,264
Wyoming,Sweetwater County,18,471,160,311
Wyoming,Teton County,0,23081,11909,11172
Wyoming,Teton County,1,1132,591,541
Wyoming,Teton County,2,1252,601,651
Wyoming,Teton County,3,1202,641,561
Wyoming,Teton County,4,983,501,482
Wyoming,Teton County,5,1078,465,613
Wyoming,Teton County,6,1889,1011,878
Wyoming,Teton County,7,2028,1061,967
Wyoming,Teton County,8,2065,1125,940
Wyoming,Teton County,9,1736,960,776
Wyoming,Teton County,10,1687,923,764
Wyoming,Teton County,11,1423,699,724
Wyoming,Teton County,12,1505,744,761
Wyoming,Teton County,13,1543,791,752
Wyoming,Teton County,14,1332,716,616
Wyoming,Teton County,15,983,500,483
Wyoming,Teton County,16,586,294,292
Wyoming,Teton County,17,332,154,178
Wyoming,Teton County,18,325,132,193
Wyoming,Uinta County,0,20299,10285,10014
Wyoming,Uinta County,1,1486,760,726
Wyoming,Uinta County,2,1635,846,789
Wyoming,Uinta County,3,1747,878,869
Wyoming,Uinta County,4,1458,799,659
Wyoming,Uinta County,5,999,501,498
Wyoming,Uinta County,6,1154,560,594
Wyoming,Uinta County,7,1242,617,625
Wyoming,Uinta County,8,1460,739,721
Wyoming,Uinta County,9,1258,630,628
Wyoming,Uinta County,10,1132,577,555
Wyoming,Uinta County,11,1068,546,522
Wyoming,Uinta County,12,1366,691,675
Wyoming,Uinta County,13,1436,724,712
Wyoming,Uinta County,14,1118,581,537
Wyoming,Uinta County,15,766,398,368
Wyoming,Uinta County,16,467,235,232
Wyoming,Uinta County,17,252,114,138
Wyoming,Uinta County,18,255,89,166
Wyoming,Washakie County,0,7885,3988,3897
Wyoming,Washakie County,1,406,219,187
Wyoming,Washakie County,2,452,220,232
Wyoming,Washakie County,3,560,280,280
Wyoming,Washakie County,4,553,298,255
Wyoming,Washakie County,5,352,177,175
Wyoming,Washakie County,6,363,183,180
Wyoming,Washakie County,7,416,230,186
Wyoming,Washakie County,8,487,232,255
Wyoming,Washakie County,9,440,220,220
Wyoming,Washakie County,10,460,243,217
Wyoming,Washakie County,11,518,271,247
Wyoming,Washakie County,12,567,278,289
Wyoming,Washakie County,13,601,309,292
Wyoming,Washakie County,14,517,268,249
Wyoming,Washakie County,15,420,204,216
Wyoming,Washakie County,16,321,175,146
Wyoming,Washakie County,17,210,84,126
Wyoming,Washakie County,18,242,97,145
Wyoming,Weston County,0,6967,3689,3278
Wyoming,Weston County,1,359,185,174
Wyoming,Weston County,2,421,205,216
Wyoming,Weston County,3,424,226,198
Wyoming,Weston County,4,355,193,162
Wyoming,Weston County,5,312,192,120
Wyoming,Weston County,6,369,211,158
Wyoming,Weston County,7,430,234,196
Wyoming,Weston County,8,476,259,217
Wyoming,Weston County,9,365,205,160
Wyoming,Weston County,10,369,214,155
Wyoming,Weston County,11,439,231,208
Wyoming,Weston County,12,547,293,254
Wyoming,Weston County,13,672,345,327
Wyoming,Weston County,14,473,267,206
Wyoming,Weston County,15,336,168,168
Wyoming,Weston County,16,224,104,120
Wyoming,Weston County,17,196,88,108
Wyoming,Weston County,18,200,69,131